The carnival is in town and you had a date with your sweetie to visit it. After dinner and just as you arrive at the carnival, you and your date have a terrible fight. They storm off leaving you alone at the carnival. You decide to stay at the carnival anyway.

Hell Ride
The ride of a lifetime... by No Shoes
Release 1 / Serial number 241201 / Inform 7 v10.1.2 / D

Parking Lot
You are in a parking lot full of cars. The midway is to the south. There is a blueberry bush here. There are blueberries on the bush

I beg your pardon?

>s
The Booth
You are standing in line at a ticket booth at the carnival. The booth sells tickets to the Hell Ride attraction. The line for the ride forms to the south and the midway continues east and west from here. There is a concession stand to the south west. The ticket booth is garishly painted in purple and green sparkles. There is a Ticket Seller here. The Ticket Seller has a ticket.

You can see a Seller here.

>l
The Booth
You are standing in line at a ticket booth at the carnival. The booth sells tickets to the Hell Ride attraction. The line for the ride forms to the south and the midway continues east and west from here. There is a concession stand to the south west. The ticket booth is garishly painted in purple and green sparkles. There is a Ticket Seller here. The Ticket Seller has a ticket.

You can see a Seller here.

* * *

The carnival is in town and you had a date with your sweetie to visit it. After dinner and just as you arrive at the carnival, you and your date have a terrible fight. They storm off leaving you alone at the carnival. You decide to stay at the carnival anyway.

Hell Ride
The ride of a lifetime... by No Shoes
Release 1 / Serial number 241201 / Inform 7 v10.1.2 / D

Parking Lot
You are in a parking lot full of cars. The midway is to the south. There is a blueberry bush here. There are blueberries on the bush

>get blueberrie
Good Job!

[Your score has just gone up by five points.]

>s
ticket booth
You are standing in line at a ticket booth at the carnival. The booth sells tickets to the Hell Ride attraction. The line for the ride forms to the south and the midway continues east and west from here. There is a concession stand to the south west. The ticket booth is garishly painted in purple and green sparkles. There is a Ticket Seller here. The Ticket Seller has a ticket.

* * *

The carnival is in town and you had a date with your sweetie to visit it. After dinner and just as you arrive at the carnival, you and your date have a terrible fight. They storm off leaving you alone at the carnival. You decide to stay at the carnival anyway.

Hell Ride
The ride of a lifetime... by No Shoes
Release 1 / Serial number 241201 / Inform 7 v10.1.2 / D

Parking Lot
You are in a parking lot full of cars. The midway is to the south. There is a blueberry bush here. There are blueberries on the bush

>s
The Ticket Booth
You are standing in line at a ticket booth at the carnival. The booth sells tickets to the Hell Ride attraction. The line for the ride forms to the south and the midway continues east and west from here. There is a concession stand to the south west. The ticket booth is garishly painted in purple and green sparkles. There is a Ticket Seller here. The Ticket Seller has a Hell Ride ticket.

You can see a Ticket Seller here.

>s
Head of the Line
You are standing in front of a ticket taker with his hand open waiting for your ticket. The entrance to the ride is south of here.

You can see a Ride Attendant here.

>n
Ticket Booth
You are standing in line at a ticket booth at the carnival. The booth sells tickets to the Hell Ride attraction. The line for the ride forms to the south and the midway continues east and west from here. There is a concession stand to the south west. The ticket booth is garishly painted in purple and green sparkles. There is a Ticket Seller here. The Ticket Seller has a ticket.

>l
Ticket Booth
You are standing in line at a ticket booth at the carnival. The booth sells tickets to the Hell Ride attraction. The line for the ride forms to the south and the midway continues east and west from here. There is a concession stand to the south west. The ticket booth is garishly painted in purple and green sparkles. There is a Ticket Seller here. The Ticket Seller has a ticket.

>look
Ticket Booth
You are standing in line at a ticket booth at the carnival. The booth sells tickets to the Hell Ride attraction. The line for the ride forms to the south and the midway continues east and west from here. There is a concession stand to the south west. The ticket booth is garishly painted in purple and green sparkles. There is a Ticket Seller here. The Ticket Seller has a ticket.

* * *

>l
Ticket Booth
You are standing in line at a ticket booth at the carnival. The booth sells tickets to the Hell Ride attraction. The line for the ride forms to the south and the midway continues east and west from here. There is a concession stand to the south west. The ticket booth is garishly painted in purple and green sparkles. There is a Ticket Seller here. The Ticket Seller has a ticket.

>w
Little Egypt Facade
You are standing in front of a trailer. There is a stage in front of the trailer. The Barker is encouraging you to step up, pay for, and enjoy the Little Egypt Show.The barker cries: 

Ladies and gentlemen, boys and girls, gather "round! 
Step right up and witness the spectacle that's taken the world by storm! 
She walks, she talks, she crawls on her belly like a reptile. 
Behold the one, the only Little Egypt, performing her legendary Dance of the Pyramids-a dazzling display of mystery, grace, and exotic allure! 
For just a dime, a mere one tenth of a dollar, prepare to be transported to the sands of Cairo, where enchantment and wonder await!

You can see a Barker here.

>w
It'll cost you a dime to go that way.

>e
Ticket Booth
You are standing in line at a ticket booth at the carnival. The booth sells tickets to the Hell Ride attraction. The line for the ride forms to the south and the midway continues east and west from here. There is a concession stand to the south west. The ticket booth is garishly painted in purple and green sparkles. There is a Ticket Seller here. The Ticket Seller has a ticket.

>l
Ticket Booth
You are standing in line at a ticket booth at the carnival. The booth sells tickets to the Hell Ride attraction. The line for the ride forms to the south and the midway continues east and west from here. There is a concession stand to the south west. The ticket booth is garishly painted in purple and green sparkles. There is a Ticket Seller here. The Ticket Seller has a ticket.

>w
Little Egypt Facade
You are standing in front of a trailer. There is a stage in front of the trailer. The Barker is encouraging you to step up, pay for, and enjoy the Little Egypt Show.

You can see a Barker here.

>l
Little Egypt Facade
You are standing in front of a trailer. There is a stage in front of the trailer. The Barker is encouraging you to step up, pay for, and enjoy the Little Egypt Show.

You can see a Barker here.

* * *

>s
The Ticket Booth
You are standing in line at a ticket booth at the carnival. The booth sells tickets to the Hell Ride attraction. The line for the ride forms to the south and the midway continues east and west from here. There is a concession stand to the south west. The ticket booth is garishly painted in purple and green sparkles. There is a Ticket Seller here. The Ticket Seller has a Hell Ride ticket.

You can see a Ticket Seller here.

>w
Little Egypt Facade
You are standing in front of a trailer. There is a stage in front of the trailer. The Barker is encouraging you to step up, pay for, and enjoy the Little Egypt Show.The barker cries: 

Ladies and gentlemen, boys and girls, gather "round! 
Step right up and witness the spectacle that's taken the world by storm! 
She walks, she talks, she crawls on her belly like a reptile. 
Behold the one, the only Little Egypt, performing her legendary Dance of the Pyramids-a dazzling display of mystery, grace, and exotic allure! 
For just a dime, a mere one tenth of a dollar, prepare to be transported to the sands of Cairo, where enchantment and wonder await!

You can see a Barker here.

>give dime to barker
You can now head west into the show.

>w
Little Egypt Show
You are inside the Little Egypt Show. The attraction facade is to the east.

You enter the tent and sit in one of the folding chairs in the front row.

Little Egypt Show (on the Folding Chair)
You are inside the Little Egypt Show. The attraction facade is to the east.

>l
Little Egypt Show (on the Folding Chair)
You are inside the Little Egypt Show. The attraction facade is to the east.

As you enter the dimly lit tent, you see that the stage is decorated to resemble an exotic Middle Eastern market or palace, featuring rich, colorful fabrics, brass ornaments, and lanterns casting a warm, flickering glow. Scents of incense waft through the air, enhancing the atmosphere of mystique. The backdrop displays painted scenes of pyramids, desert landscapes, or domed structures to evoking a sense of being transported to the "Middle East".

>l
Little Egypt Show (on the Folding Chair)
You are inside the Little Egypt Show. The attraction facade is to the east.

Little Egypt emerges draped in a flowing silk veils which she skillfully uses as part of the dance. Her attire consists of a sparkling, sequined bodice and harem pants, adorned with jingling coin belts and jewelry that accentuate her movements.

>l
Little Egypt Show (on the Folding Chair)
You are inside the Little Egypt Show. The attraction facade is to the east.

The performance begins with slow, undulating movements, drawing the you into the rhythm of exotic live music played on traditional instruments like the oud, darbuka, or zurna. As the tempo builds, her hips, torso, and hands move in intricate, mesmerizing patterns, demonstrating remarkable control and fluidity. She incorporates dramatic spins, drops, and shimmies, often accentuating the beat of the music with a quick jingle of her coin belt.

>l
Little Egypt Show (on the Folding Chair)
You are inside the Little Egypt Show. The attraction facade is to the east.

Little Egypt makes eye contact with you and smiles enigmatically. During her performance she balances a sword on her head and accents her dance with finger cymbals.

>l
Little Egypt Show (on the Folding Chair)
You are inside the Little Egypt Show. The attraction facade is to the east.

The music alternates between hauntingly slow melodies and rapid, energetic drum beats, creating an emotional arc that keeps the you entranced. Little Egypt relies on the music's dynamic changes to tell a story with movements reflecting joy, sorrow, seduction, and celebration.

>l
Little Egypt Show (on the Folding Chair)
You are inside the Little Egypt Show. The attraction facade is to the east.

The performance concludes with a dramatic flourish of a fast-paced shimmy, a bold spin, and Little Egypt dramatically casts off her veils. The dancer takes a bow to enthusiastic applause, leaving you spellbound by the sensual yet artful display.

You applaud until your hands are sore. Did she wink at me?

>l
Little Egypt Show (on the Folding Chair)
You are inside the Little Egypt Show. The attraction facade is to the east.

>exit
You get off the Folding Chair.

Little Egypt Show
You are inside the Little Egypt Show. The attraction facade is to the east.

>e
Little Egypt Facade
You are standing in front of a trailer. There is a stage in front of the trailer. The Barker is encouraging you to step up, pay for, and enjoy the Little Egypt Show.

You can see a Barker here.

>l
Little Egypt Facade
You are standing in front of a trailer. There is a stage in front of the trailer. The Barker is encouraging you to step up, pay for, and enjoy the Little Egypt Show.

You can see a Barker here.

>e
The Ticket Booth
You are standing in line at a ticket booth at the carnival. The booth sells tickets to the Hell Ride attraction. The line for the ride forms to the south and the midway continues east and west from here. There is a concession stand to the south west. The ticket booth is garishly painted in purple and green sparkles. There is a Ticket Seller here. The Ticket Seller has a Hell Ride ticket.

You can see a Ticket Seller here.

>l
The Ticket Booth
You are standing in line at a ticket booth at the carnival. The booth sells tickets to the Hell Ride attraction. The line for the ride forms to the south and the midway continues east and west from here. There is a concession stand to the south west. The ticket booth is garishly painted in purple and green sparkles. There is a Ticket Seller here. The Ticket Seller has a Hell Ride ticket.

You can see a Ticket Seller here.

>n
Parking Lot
You are in a parking lot full of cars. The midway is to the south. There is a blueberry bush here. There are blueberries on the bush

>l
Parking Lot
You are in a parking lot full of cars. The midway is to the south. There is a blueberry bush here. There are blueberries on the bush

* * *

>give dime to broker
You can't see any such thing.

>w
It'll cost you a dime to go that way.

* * *

>e
Ticket Booth
You are standing in line at a ticket booth at the carnival. The booth sells tickets to the Hell Ride attraction. The line for the ride forms to the south and the midway continues east and west from here. There is a concession stand to the south west. The ticket booth is garishly painted in purple and green sparkles. There is a Ticket Seller here. The Ticket Seller has a ticket.

>w
Little Egypt Facade
You are standing in front of a trailer. There is a stage in front of the trailer. The Barker is encouraging you to step up, pay for, and enjoy the Little Egypt Show.

You can see a Barker here.

>e
Ticket Booth
You are standing in line at a ticket booth at the carnival. The booth sells tickets to the Hell Ride attraction. The line for the ride forms to the south and the midway continues east and west from here. There is a concession stand to the south west. The ticket booth is garishly painted in purple and green sparkles. There is a Ticket Seller here. The Ticket Seller has a ticket.

>i
You are carrying:
  a wallet
    $10.00 in cash
  a dime

>l at barker
You can't see any such thing.

>l
Ticket Booth
You are standing in line at a ticket booth at the carnival. The booth sells tickets to the Hell Ride attraction. The line for the ride forms to the south and the midway continues east and west from here. There is a concession stand to the south west. The ticket booth is garishly painted in purple and green sparkles. There is a Ticket Seller here. The Ticket Seller has a ticket.

* * *

>l
Little Egypt Facade
You are standing in front of a trailer. There is a stage in front of the trailer. The Barker is encouraging you to step up, pay for, and enjoy the Little Egypt Show.

You can see a Barker here.

>w
It'll cost you a dime to go that way.

>give dime to barker
You can now head west into the show.

* * *

>l
Little Egypt Show (on the Folding Chair)
You are inside the Little Egypt Show. The attraction facade is to the east.

>e
You would have to get off the Folding Chair first.

>staznd
That's not a verb I recognize.

>e
You would have to get off the Folding Chair first.

>stand
You get off the Folding Chair.

Little Egypt Show
You are inside the Little Egypt Show. The attraction facade is to the east.

>e
Little Egypt Facade
You are standing in front of a trailer. There is a stage in front of the trailer. The Barker is encouraging you to step up, pay for, and enjoy the Little Egypt Show.

You can see a Barker here.

* * *

>l
Little Egypt Facade
You are standing in front of a trailer. There is a stage in front of the trailer. The Barker is encouraging you to step up, pay for, and enjoy the Little Egypt Show.

You can see a Barker here.

>e
Ticket Booth
You are standing in line at a ticket booth at the carnival. The booth sells tickets to the Hell Ride attraction. The line for the ride forms to the south and the midway continues east and west from here. There is a concession stand to the south west. The ticket booth is garishly painted in purple and green sparkles. There is a Ticket Seller here. The Ticket Seller has a ticket.

>e
Strongman Booth
The Strongman Booth is a popular carnival game in which you swing a mallet against a base and cause a striker to hit a bell. Along the length of the pole are markings indicating how strong you are.  A nearby sign says, "Buy a mallet, strike the bell, win a prize."

You can see a Strongman Atendant and a base here.

* * *

>w
Little Egypt Show
You are inside the Little Egypt Show. The attraction facade is to the east.

You enter the tent and sit in one of the folding chairs in the front row.

Little Egypt Show (on the Folding Chair)
You are inside the Little Egypt Show. The attraction facade is to the east.

>z
Time passes.

As you enter the dimly lit tent, you see that the stage is decorated to resemble an exotic Middle Eastern market or palace, featuring rich, colorful fabrics, brass ornaments, and lanterns casting a warm, flickering glow. Scents of incense waft through the air, enhancing the atmosphere of mystique. The backdrop displays painted scenes of pyramids, desert landscapes, or domed structures to evoking a sense of being transported to the "Middle East".

>z
Time passes.

Little Egypt emerges draped in a flowing silk veils which she skillfully uses as part of the dance. Her attire consists of a sparkling, sequined bodice and harem pants, adorned with jingling coin belts and jewelry that accentuate her movements.

>z
Time passes.

The performance begins with slow, undulating movements, drawing the you into the rhythm of exotic live music played on traditional instruments like the oud, darbuka, or zurna. As the tempo builds, her hips, torso, and hands move in intricate, mesmerizing patterns, demonstrating remarkable control and fluidity. She incorporates dramatic spins, drops, and shimmies, often accentuating the beat of the music with a quick jingle of her coin belt.

>z
Time passes.

Little Egypt makes eye contact with you and smiles enigmatically. During her performance she balances a sword on her head and accents her dance with finger cymbals.

>z
Time passes.

The music alternates between hauntingly slow melodies and rapid, energetic drum beats, creating an emotional arc that keeps the you entranced. Little Egypt relies on the music's dynamic changes to tell a story with movements reflecting joy, sorrow, seduction, and celebration.

>z
Time passes.

The performance concludes with a dramatic flourish of a fast-paced shimmy, a bold spin, and Little Egypt dramatically casts off her veils. The dancer takes a bow to enthusiastic applause, leaving you spellbound by the sensual yet artful display.

You stand and applaud until your hands are sore. Did she wink at me?

>z
Time passes.

>stand
You get off the Folding Chair.

Little Egypt Show
You are inside the Little Egypt Show. The attraction facade is to the east.

* * *

>w
It'll cost you a dime to go that way.

>w
It'll cost you a dime to go that way.

* * *

>give dime to barker
You can now head west into the show.

>ww
That's not a verb I recognize.

>w
Little Egypt Show
You are inside the Little Egypt Show. The attraction facade is to the east.

You enter the tent and sit in one of the folding chairs in the front row.

Little Egypt Show (on the Folding Chair)
You are inside the Little Egypt Show. The attraction facade is to the east.

>e
You would have to get off the Folding Chair first.

As you enter the dimly lit tent, you see that the stage is decorated to resemble an exotic Middle Eastern market or palace, featuring rich, colorful fabrics, brass ornaments, and lanterns casting a warm, flickering glow. Scents of incense waft through the air, enhancing the atmosphere of mystique. The backdrop displays painted scenes of pyramids, desert landscapes, or domed structures to evoking a sense of being transported to the "Middle East".

>z
Time passes.

Little Egypt emerges draped in a flowing silk veils which she skillfully uses as part of the dance. Her attire consists of a sparkling, sequined bodice and harem pants, adorned with jingling coin belts and jewelry that accentuate her movements.

* * *

>z
Time passes.

The music alternates between hauntingly slow melodies and rapid, energetic drum beats, creating an emotional arc that keeps the you entranced. Little Egypt relies on the music's dynamic changes to tell a story with movements reflecting joy, sorrow, seduction, and celebration.

>z
Time passes.

The performance concludes with a dramatic flourish of a fast-paced shimmy, a bold spin, and Little Egypt dramatically casts off her veils. The dancer takes a bow to enthusiastic applause, leaving you spellbound by the sensual yet artful display.

You applaud until your hands are sore. Did she wink at me?

>z
Time passes.

>e
You would have to get off the Folding Chair first.

* * *

>e
Little Egypt Facade
You are standing in front of a trailer. There is a stage in front of the trailer. The Barker is encouraging you to step up, pay for, and enjoy the Little Egypt Show.

You can see a Barker here.

>e
The Booth
You are standing in line at a ticket booth at the carnival. The booth sells tickets to the Hell Ride attraction. The line for the ride forms to the south and the midway continues east and west from here. There is a concession stand to the south west. The ticket booth is garishly painted in purple and green sparkles. There is a Ticket Seller here. The Ticket Seller has a ticket.

You can see a Seller here.

>restart
Are you sure you want to restart?

>y
The carnival is in town and you had a date with your sweetie to visit it. After dinner and just as you arrive at the carnival, you and your date have a terrible fight. They storm off leaving you alone at the carnival. You decide to stay at the carnival anyway.

Hell Ride
The ride of a lifetime... by No Shoes
Release 1 / Serial number 241201 / Inform 7 v10.1.2 / D

Parking Lot
You are in a parking lot full of cars. The midway is to the south. There is a blueberry bush here. There are blueberries on the bush

>s
The Booth
You are standing in line at a ticket booth at the carnival. The booth sells tickets to the Hell Ride attraction. The line for the ride forms to the south and the midway continues east and west from here. There is a concession stand to the south west. The ticket booth is garishly painted in purple and green sparkles. There is a Ticket Seller here. The Ticket Seller has a ticket.

You can see a Seller here.

>s
Head of the Line
You are standing in front of a ticket taker with his hand open waiting for your ticket. The entrance to the ride is south of here.

You can see a Ride Attendant here.

>s
You'll need a ticket to go that way.

>s
You'll need a ticket to go that way.

>give ticket to attendant
You can't see any such thing.

>n
The Booth
You are standing in line at a ticket booth at the carnival. The booth sells tickets to the Hell Ride attraction. The line for the ride forms to the south and the midway continues east and west from here. There is a concession stand to the south west. The ticket booth is garishly painted in purple and green sparkles. There is a Ticket Seller here. The Ticket Seller has a ticket.

You can see a Seller here.

>buy ticket
You fork over $2.50 for the Hell Ride ticket, leaving yourself with $7.50.

>s
Head of the Line
You are standing in front of a ticket taker with his hand open waiting for your ticket. The entrance to the ride is south of here.

You can see a Ride Attendant here.

* * *

>s
You'll need a ticket to go that way.

>give ticket to attendant
You give the Hell Ride ticket to the Ride Attendant.

>s
Ride Entrance
The cars that will take you into the fearsome Hell Ride stop here for you to board.  To the south is the track that will take you into the ride. The safety bar is raised allowing you to entering the car. East of here is a gate with a sign that reads "Employees Only".

You can see a car (empty) here.

>get in car
You get into the car.

The car moves forward and the safety bar begins to lower.

>s
You are enjoying the ride.

The car has begun to move toward the entrance of the ride and the safety bar has been lowered halfway.

>s
You are enjoying the ride.

The doors open and your car passes through into the darkness. The safety bar has been lowered.

>s
You are enjoying the ride.

You pass into a room which displays mannequins in stocks in a public square. The wax figures are especially life like.

>w
You are enjoying the ride.

The next room shows a man hanging from a gallows. The gallows are made of wood.

>s
You are enjoying the ride.

Here you can see a witch being burned at the stake as townsfolk jeer at the sight.

>e
You are enjoying the ride.

This a dungeon with all the usual devices: the rack, an iron maiden, a Saint Andrew's Cross.

>d
You are enjoying the ride.

There is a guillotine in this room. The guillotine is being raised and lowered. It appears that the timing of the guillotine is off and it is being lowered onto the cars. If a person would be in a car as it passed under the guillotine, they would be decapitated. Looks like your jig is up. Say "Goodnight, Gracie!"

    *** You have died. ***

In that game you scored 0 out of a possible 100, in 19 turns.

Would you like to RESTART, RESTORE a saved game, QUIT, or UNDO the last command?

>restart
The carnival is in town and you had a date with your sweetie to visit it. After dinner and just as you arrive at the carnival, you and your date have a terrible fight. They storm off leaving you alone at the carnival. You decide to stay at the carnival anyway.

Hell Ride
The ride of a lifetime... by No Shoes
Release 1 / Serial number 241201 / Inform 7 v10.1.2 / D

Parking Lot
You are in a parking lot full of cars. The midway is to the south. There is a blueberry bush here. There are blueberries on the bush

>s
The Booth
You are standing in line at a ticket booth at the carnival. The booth sells tickets to the Hell Ride attraction. The line for the ride forms to the south and the midway continues east and west from here. There is a concession stand to the south west. The ticket booth is garishly painted in purple and green sparkles. There is a Ticket Seller here. The Ticket Seller has a ticket.

You can see a Seller here.

>w
Little Egypt Facade
You are standing in front of a trailer. There is a stage in front of the trailer. The Barker is encouraging you to step up, pay for, and enjoy the Little Egypt Show.The barker cries: 

Ladies and gentlemen, boys and girls, gather "round! 
Step right up and witness the spectacle that's taken the world by storm! 
She walks, she talks, she crawls on her belly like a reptile. 
Behold the one, the only Little Egypt, performing her legendary Dance of the Pyramids-a dazzling display of mystery, grace, and exotic allure! 
For just a dime, a mere one tenth of a dollar, prepare to be transported to the sands of Cairo, where enchantment and wonder await!

You can see a Barker here.

* * *

>e
You would have to get off the Folding Chair first.

As you enter the dimly lit tent, you see that the stage is decorated to resemble an exotic Middle Eastern market or palace, featuring rich, colorful fabrics, brass ornaments, and lanterns casting a warm, flickering glow. Scents of incense waft through the air, enhancing the atmosphere of mystique. The backdrop displays painted scenes of pyramids, desert landscapes, or domed structures to evoking a sense of being transported to the "Middle East".

>s
You would have to get off the Folding Chair first.

Little Egypt emerges draped in a flowing silk veils which she skillfully uses as part of the dance. Her attire consists of a sparkling, sequined bodice and harem pants, adorned with jingling coin belts and jewelry that accentuate her movements.

>w
You would have to get off the Folding Chair first.

The performance begins with slow, undulating movements, drawing the you into the rhythm of exotic live music played on traditional instruments like the oud, darbuka, or zurna. As the tempo builds, her hips, torso, and hands move in intricate, mesmerizing patterns, demonstrating remarkable control and fluidity. She incorporates dramatic spins, drops, and shimmies, often accentuating the beat of the music with a quick jingle of her coin belt.

>e
You would have to get off the Folding Chair first.

Little Egypt makes eye contact with you and smiles enigmatically. During her performance she balances a sword on her head and accents her dance with finger cymbals.

>s
You would have to get off the Folding Chair first.

The music alternates between hauntingly slow melodies and rapid, energetic drum beats, creating an emotional arc that keeps the you entranced. Little Egypt relies on the music's dynamic changes to tell a story with movements reflecting joy, sorrow, seduction, and celebration.

>stand
You get off the Folding Chair.

Little Egypt Show
You are inside the Little Egypt Show. The attraction facade is to the east.

The performance concludes with a dramatic flourish of a fast-paced shimmy, a bold spin, and Little Egypt dramatically casts off her veils. The dancer takes a bow to enthusiastic applause, leaving you spellbound by the sensual yet artful display.

You applaud until your hands are sore. Did she wink at me?

>l
Little Egypt Show
You are inside the Little Egypt Show. The attraction facade is to the east.

>e
Little Egypt Facade
You are standing in front of a trailer. There is a stage in front of the trailer. The Barker is encouraging you to step up, pay for, and enjoy the Little Egypt Show.

You can see a Barker here.

* * *

>l
Little Egypt Facade
You are standing in front of a trailer. There is a stage in front of the trailer. The Barker is encouraging you to step up, pay for, and enjoy the Little Egypt Show.

You can see a Barker here.

>e
The Ticket Booth
You are standing in line at a ticket booth at the carnival. The booth sells tickets to the Hell Ride attraction. The line for the ride forms to the south and the midway continues east and west from here. There is a concession stand to the south west. The ticket booth is garishly painted in purple and green sparkles. There is a Ticket Seller here. The Ticket Seller has a ticket.

You can see a Ticket Seller here.

>l
The Ticket Booth
You are standing in line at a ticket booth at the carnival. The booth sells tickets to the Hell Ride attraction. The line for the ride forms to the south and the midway continues east and west from here. There is a concession stand to the south west. The ticket booth is garishly painted in purple and green sparkles. There is a Ticket Seller here. The Ticket Seller has a ticket.

You can see a Ticket Seller here.

>e
Strongman Booth
The Strongman Booth is a popular carnival game in which you swing a mallet against a base and cause a striker to hit a bell. Along the length of the pole are markings indicating how strong you are.  A nearby sign says, "Buy a mallet, strike the bell, win a prize."

You can see a Strongman Atendant and a base here.

>l
Strongman Booth
The Strongman Booth is a popular carnival game in which you swing a mallet against a base and cause a striker to hit a bell. Along the length of the pole are markings indicating how strong you are.  A nearby sign says, "Buy a mallet, strike the bell, win a prize."

You can see a Strongman Atendant and a base here.

>n
You can't go that way.

>s
You can't go that way.

>w
The Ticket Booth
You are standing in line at a ticket booth at the carnival. The booth sells tickets to the Hell Ride attraction. The line for the ride forms to the south and the midway continues east and west from here. There is a concession stand to the south west. The ticket booth is garishly painted in purple and green sparkles. There is a Ticket Seller here. The Ticket Seller has a ticket.

You can see a Ticket Seller here.

>n
Parking Lot
You are in a parking lot full of cars. The midway is to the south. There is a blueberry bush here. There are blueberries on the bush

>n
You can't go that way.

>E
You can't go that way.

>s
The Ticket Booth
You are standing in line at a ticket booth at the carnival. The booth sells tickets to the Hell Ride attraction. The line for the ride forms to the south and the midway continues east and west from here. There is a concession stand to the south west. The ticket booth is garishly painted in purple and green sparkles. There is a Ticket Seller here. The Ticket Seller has a ticket.

You can see a Ticket Seller here.

>buy ticket
(the Ticket Seller)
The Ticket Seller is yours already.

>buyt the hellride ticket
That's not a verb I recognize.

>buy the hellride ticket
You can't see any such thing.

>i
You are carrying:
  a wallet
    $10.00 in cash