The carnival is in town and you and your sweetie had a date to visit it. After dinner and just as you arrive at the carnival, you and your date have a terrible fight. They storm off leaving you alone. You decide to stay at the carnival anyway.

Hell Ride
The ride of a lifetime... by No Shoes
Release 122 / Serial number 250119 / Inform 7 v10.1.2 / D

Parking Lot
The carnival parking lot stretches across an open field, its gravel crunching under arriving cars. Temporary floodlights and the carnival's colorful glow light the area, while distant laughter, music, and the hum of rides fill the air.

Cars park haphazardly, guided by makeshift signs and fluttering flags. Families unload strollers and blankets, their chatter mixing with the carnival sounds. Others linger in vehicles, preparing for the chilly evening.

Shadows from nearby trees create dark pockets pierced by the occasional flashlight. Near the entrance, an attendant collects fees at a weathered booth, coins jingling in the cash box.

Puddles from recent rain shimmer with reflected lights, while patches of mud cling to unwary shoes. At the far end, RVs and trailers sit quietly, their occupants watching the Ferris wheel spin lazily against the sky.

Alive with anticipation, the parking lot marks the transition from the ordinary to the magic of the carnival.

The midway is to the south. There is a blueberry bush here. There are blueberries on the bush.

Your car is here. It's a bit of a beater. Inside the car, you can see the seat, the ignition, the dashboard, and the glove box.

You can see a parking attendant here.

The attendant has a parking ticket. The price of a parking ticket is $5.00.

>brief
Hell Ride is now in its "brief" printing mode, which gives long descriptions of places never before visited and short descriptions otherwise.

>get blueberries
Taken.

[Your score has just gone up by five points.]

>eat berries
The blueberries were delicious. A true taste of summer!

[Your score has just gone up by five points.]

>look
Parking Lot
The carnival parking lot stretches across an open field, its gravel crunching under arriving cars. Temporary floodlights and the carnival's colorful glow light the area, while distant laughter, music, and the hum of rides fill the air.

Cars park haphazardly, guided by makeshift signs and fluttering flags. Families unload strollers and blankets, their chatter mixing with the carnival sounds. Others linger in vehicles, preparing for the chilly evening.

Shadows from nearby trees create dark pockets pierced by the occasional flashlight. Near the entrance, an attendant collects fees at a weathered booth, coins jingling in the cash box.

Puddles from recent rain shimmer with reflected lights, while patches of mud cling to unwary shoes. At the far end, RVs and trailers sit quietly, their occupants watching the Ferris wheel spin lazily against the sky.

Alive with anticipation, the parking lot marks the transition from the ordinary to the magic of the carnival.

The midway is to the south. There is a blueberry bush here. The bush has been picked clean.

Your car is here. It's a bit of a beater. Inside the car, you can see the seat, the ignition, the dashboard, and the glove box.

You can see a parking attendant here.

The attendant has a parking ticket. The price of a parking ticket is $5.00.

>fuck me
Hell Ride isn't that kind of game!

>look under seat
You find the five dimes, the three quarters, the nickel, and your keys!

[Your score has just gone up by five points.]

>get dimes, nickels, quarters, keys
dime: Taken.
dime: Taken.
dime: Taken.
dime: Taken.
dime: Taken.
nickel: Taken.
quarter: Taken.
quarter: Taken.
quarter: Taken.
your keys: Taken.

>open glove box
(first unlocking the glove box)
(with your keys)
You open the glove box, revealing a pair of gloves.

>get gloves. wear it
Taken.

You put on the pair of gloves.

>give coupon
(to the parking attendant)
(first taking the coupon)
Done. The price of a parking ticket is now $3.00.

>buy ticket
The attendant mumbles something about the stub.

You fork over $3.00 for the parking ticket, leaving yourself with $27.00.

>ask attendant about stub
He replies, "Put the ticket stub on your dashboard or your car will get towed."

>put stub on dash
You put the parking stub on the dashboard.

>kiss attendant
Oh, my! Why would you want to kiss the parking attendant? Your sweetie wouldn't like that!

>look at attendant
This is another bored teenager. He's thinking about the big game on Friday night.

>touch attendant
Touching the parking attendant without consent is likely to get you punched in the face! Better not.

>smell attendant
You get close to the parking attendant. They smell like angst and regret.

>listen to attendant
All you can hear is the parking attendant whining about working at the carnival.

>show the attendant the wallet
"Sorry, I haven't the faintest," the wallet drawls.

>show the attendant the keys
"I'm afraid I don't know much about that," your keys comments.

>ask attendant about quarter
"I'm afraid I haven't the faintest," the parking attendant drawls.

>screw attendant
Hell Ride isn't that kind of game!

>look at sky
It's a beautiful evening. Not a cloud in the sky. The moon is out and there are so many stars to see. A shooting star streaks across the sky.

>s
Ticket Booth
The ticket kiosk stands at the carnival entrance, a compact booth painted in bright red and yellow stripes with bold letters above the window reading "Tickets Here!" Twinkling lights outline its edges, blinking rhythmically to draw attention.

A single window serves visitors, where a smiling cashier dispenses colorful tickets from neatly arranged rolls. Beside the tickets, a cash drawer jingles as change is counted, and a digital payment system glows faintly for modern convenience. Too bad you don't have a debit card.

Next to the kiosk, a vibrant signboard lists ticket prices with playful illustrations of rides and treats. Pennant flags flutter from the kiosk's roof, adding to the festive atmosphere, while the smell of popcorn and fried dough wafts from the southwest.

The worn ground around the kiosk shows the passage of eager carnival-goers. Families, couples, and friends form a buzzing line, their excitement building as they approach this first step into the magic of the carnival.

The midway continues in all directions from here. There is a cashier here. The prices of ride tickets are on the signboard. The cashier has Hell Ride ticket, Fortune Teller ticket, Ferris Wheel ticket, Bumper Cars ticket, and Carousel ticket.

You can see a ticket kiosk and a cashier here.

>buy all tickets
Hell Ride ticket: You fork over $3.00 for the Hell Ride ticket, leaving yourself with $24.00.
Fortune Teller ticket: You fork over $3.00 for the Fortune Teller ticket, leaving yourself with $21.00.
Ferris Wheel ticket: You fork over $2.00 for the Ferris Wheel ticket, leaving yourself with $19.00.
Bumper Cars ticket: You fork over $2.00 for the Bumper Cars ticket, leaving yourself with $17.00.
Carousel ticket: You fork over $1.00 for the Carousel ticket, leaving yourself with $16.00.

[Your score has just gone up by ten points.]

>w
Show Facade
You head west through the midway, the bright lights of the carnival fading behind you as you approach a wooden booth. A sign above the entrance reads "Little Egypt Show - A Journey Into the Mysterious and Exotic!" A rotund barker, wearing a fez and a dazzling smile, gestures to a small sign beside him that says "Dime Admission."  The Ticket Kiosk is back the way you came.

You are standing in front of a dark and mysterious tent filled with illusions and exotic performers. Perhaps there's a fortune teller inside, offering cryptic clues about your journey or a hidden artifact that can be collected. There is a stage in front of the tent. The Barker is encouraging you to step up, pay for, and enjoy the Little Egypt Show.

You can see a Barker here.

The barker cries:

Ladies and gentlemen, boys and girls, gather 'round! 
Step right up and witness the spectacle that's taken the world by storm! 
She walks, she talks, she crawls on her belly like a reptile. 
Behold the one, the only Little Egypt, performing her legendary Dance of the Pyramids - a dazzling display of mystery, grace, and exotic allure! 
For just a dime, a mere one tenth of a dollar, prepare to be transported to the sands of Cairo, where enchantment and wonder await!

>w
It'll cost you a dime to go that way.

>give dime to barker
You hand over a dime, and the barker nods, waving you through. As you step past the entrance, the air feels thicker, almost humid, and the sounds of the carnival fade away. You've entered an entirely different world now - one filled with the scents of incense and exotic spices, and the low, hypnotic music of a faraway land. Before you, a series of dimly lit tents stretch out, their flaps slightly swaying in the breeze. Intrigued, you take your first step into the Little Egypt Show. You can now head west into the show.

>w
Show Tent
You are inside the Little Egypt Show. The attraction's facade is to the east. There are folding chairs organized neatly in rows. The show should start soon.

>z
Time passes.

>z
Time passes.

>z
Time passes.

In the dimly lit tent, you see that the stage is decorated to resemble an exotic Middle Eastern market or palace, featuring rich, colorful fabrics, brass ornaments, and lanterns casting a warm, flickering glow. Scents of incense waft through the air, enhancing the atmosphere of mystique. The backdrop displays painted scenes of pyramids, desert landscapes, and domed structures evoking a sense of being transported to the "Middle East".

>z
Time passes.

Little Egypt emerges draped in flowing silk veils which she skillfully uses as part of the dance. Her attire consists of a sparkling, sequined bodice and a flowing skirt, adorned with jingling coin belts and jewelry that accentuate her movements.

>z
Time passes.

The performance begins with slow, undulating movements, drawing you into the rhythm of exotic live music played on traditional instruments like the oud, darbuka, or zurna. As the tempo builds, her hips, torso, and hands move in intricate, mesmerizing patterns, demonstrating remarkable control and fluidity. She incorporates dramatic spins, drops, and shimmies, often accentuating the beat of the music with a quick jingle of her coin belt.

>z
Time passes.

Little Egypt makes eye contact with you and smiles enigmatically. During her performance she balances a sword on her head and accents her dance with finger cymbals.

* * *

>wear veil
You wrap the veil around your head, shrouding your eyes. The world is a lovely color pink as you look through the veil while her perfume fills your nostrils in the most delightful way. You look pretty!

[Your score has just gone up by five points.]

>get lantern
Taken.

[Your score has just gone up by ten points.]

>turn it on
You flip a switch. A strong, narrow beam of light shines from the lit lantern.

* * *

>e
Show Facade
You can see a Barker here.

>e
Ticket Booth
You can see a ticket kiosk and a cashier here.

>nw
Bumper Cars Ride
The bumper cars is a bustling hub of excitement and laughter, set beneath a canopy of flashing lights and colorful decorations. The rectangular arena is surrounded by padded barriers, ensuring a safe yet thrilling experience for riders. The floor, slick and metallic, allows the brightly colored cars - painted in shades of red, blue, yellow, and green - to glide effortlessly in all directions.

Each car is equipped with a steering wheel and a padded bumper, designed to absorb the impact of playful collisions. As the ride begins, drivers of all ages eagerly maneuver their cars, aiming for friends, family, or strangers with mischievous grins. The air is filled with the sound of bumpers colliding, laughter, and the occasional squeal of surprise.

Overhead, a web of electric poles connects the cars to the ceiling, sparking faintly as they supply power to the vehicles. The ride operator watches from a booth, ensuring everyone enjoys the chaos safely. Surrounding the bumper cars are cheering onlookers, carnival lights, and the lively hum of the fairground.

The bumper cars perfectly captures the playful spirit of the carnival, offering a mix of harmless competition, shared laughter, and nostalgic fun for all ages. The Ticket Kiosk is southeast of here.

Hey! Is that a two dollar bill on the ground?

You can also see a Bumper Cars attendant here.

>get bill
Taken.

You now have $18.00.

>give bumper car ticket to attendant
You give the Bumper Cars ticket to the Bumper Cars attendant.

Sliding into the snug seat of the bumper car, your hands grip the steering wheel, anticipation buzzing in the air. Around you, the arena is alive with flashing lights, bursts of laughter, and the hum of electric currents running through the overhead poles. A quick glance shows other riders locking eyes, playful grins spreading as everyone braces for the chaos about to unfold.

As the ride starts, your car jolts forward, and you steer into the fray. The slick metal floor beneath makes every turn feel smooth yet unpredictable. Suddenly, bam! - another car collides into you from the side, sending your car into a spin. You laugh, recovering quickly to aim your vehicle at a friend across the arena.

The thrill of the bumper cars is in the collisions - every thud and jolt accompanied by squeals of delight or mock indignation. The impact is cushioned by the padded bumpers, keeping the fun safe but exhilarating. You swerve, dodge, and sometimes reverse in a desperate attempt to avoid being cornered, all while plotting your next playful crash.

The ride is a whirlwind of laughter, harmless competition, and shared joy. As the music fades and the cars slow to a stop, you climb out with a wide grin, already looking forward to your next turn in the driver's seat.

>se
Ticket Booth
You can see a ticket kiosk and a cashier here.

>sw
Concession Stand
The concession stand, perched along the midway, is a colorful and bustling hub. Painted in bright reds, blues, and yellows, it features bold lettering announcing treats like "SODA! POPCORN! CANDY APPLES!" Strings of twinkling lights frame the stand, making it a glowing beacon amid the carnival excitement.

Behind the counter, a popcorn machine churns out golden kernels, filling the air with a buttery aroma. Candy apples gleam under the lights, and cotton candy machines spin fluffy clouds of pink and blue. Warm pretzels sit under a heat lamp, their buttery, salted scent mingling with the sugary treats. A cooler holds sodas, their colorful labels visible through the frosted glass.

The counter is lively with stacks of paper bags, napkins, and cups of cheese and sugar sprinkles. A handwritten chalkboard menu lists prices in playful lettering. Workers in colorful aprons quickly hand out snacks, their movements efficient amid the cheerful chaos.

In front of the stand, kids tug at their parents, teens share pretzels, and the crowd buzzes with energy. More than just a snack stop, the stand is a sensory delight, adding flavor and charm to the carnival experience.

There is a menu to the right of the window. You can see the treats inside the stand. There is an exit to the northeast.

You can see a menu, a can of Cola, bubblegum, a bucket of popcorn, a candy apple, cotton candy, and a soft pretzel here.

>read sign
$2.00 Cola 
$2.50 Popcorn 
$1.50 Candy Apple 
$1.50 Cotton Candy 
$1.50 Soft Pretzel 
$1.00 Bubblegum

>buy cotton candy, pretzel, bubblegum
cotton candy: You fork over $1.50 for cotton candy, leaving yourself with $16.50.
soft pretzel: You fork over $1.50 for the soft pretzel, leaving yourself with $15.00.
bubblegum: You fork over $1.00 for bubblegum, leaving yourself with $14.00.

>buy cola, popcorn, candy apple
can of Cola: You fork over $2.00 for the can of Cola, leaving yourself with $12.00.
bucket of popcorn: You fork over $2.50 for the bucket of popcorn, leaving yourself with $9.50.
candy apple: You fork over $1.50 for the candy apple, leaving yourself with $8.00.

>ne
Ticket Booth
You can see a ticket kiosk and a cashier here.

>ne
Carousel Ride
The carousel is a timeless carnival attraction, radiating charm and nostalgia with its brightly painted horses, vibrant lights, and cheerful music. The circular platform is adorned with a canopy of swirling colors, gold trim, and decorative mirrors that reflect the flickering bulbs lining its edges.

Rows of hand-carved animals, most often horses with flowing manes, are arranged in a circle. Each is painted in vivid colors, detailed with golden saddles and ribbons. It also features exotic creatures like lions, tigers, and sea dragons, adding whimsy to the ride. The animals rise and fall gently as the carousel spins, mimicking a galloping motion.

The carousel's warm, playful tunes drift across the midway, inviting riders of all ages to enjoy its simple delight. Children laugh as they choose their favorite animals, while adults savor the nostalgia of the spinning ride. As it rotates, the carousel becomes a moving work of art, blending motion, color, and music into an enchanting centerpiece of the carnival. The Ticket Kiosk is back to the southwest; the way you came.

You can see a Carousel attendant here.

>give carousel ticket to attendant
You give the Carousel ticket to the Carousel attendant.

Stepping onto the carousel's spinning platform, you're greeted by a kaleidoscope of color - brightly painted horses, glittering lights, and golden trim. The cheerful melody of calliope music fills the air. What will you choose as your mount, perhaps a galloping horse with a flowing mane, a majestic lion, or a whimsical giraffe. Gripping the polished pole, you settle onto the saddle, feeling the smooth rise and fall as the carousel begins to turn.

As the ride picks up speed, the world outside becomes a blur of glowing carnival lights and swirling colors. The gentle up-and-down motion mimics a playful gallop, and the rhythmic whir of the carousel's machinery adds a soothing backdrop to the cheerful atmosphere. Laughter and the sound of children's chatter mix with the music, creating a sense of nostalgia and joy.

For a few moments, you're transported into a magical world, the worries of the day fading away with each graceful rotation. Whether you're enjoying the ride alone, with friends, or sharing a special moment with family, the carousel's charm captures a timeless blend of whimsy and wonder. As it slows to a stop, you step off with a smile, the music lingering in your ears as you rejoin the bustling carnival.

>sw
Ticket Booth
You can see a ticket kiosk and a cashier here.

>se
Fortune Teller Booth
Approaching the fortune teller's booth, you're drawn in by its mysterious allure. Draped in deep purple curtains adorned with golden moons and stars, the booth glows with the soft, inviting light of lanterns. The air is heavy with the scent of incense, mingling with the sweet aroma of carnival treats. A sign reading "Fortunes Told - What Does Your Future Hold?" sways slightly in the evening breeze.

You can see a Mysterious Woman here.

>give fortune teller ticket to mysterious woman
You give the Fortune Teller ticket to the Mysterious Woman.

Stepping inside, you're greeted by the fortune teller, a figure cloaked in flowing robes with a jeweled headpiece catching the flickering light. Their piercing eyes seem to look right through you as they gesture for you to sit at a small round table covered in an ornate cloth. At its center rests a glowing crystal ball, surrounded by tarot cards and mysterious trinkets.

The fortune teller's voice is low and melodic, weaving an air of intrigue as they ask you to focus on a question or offer your palm for a reading. The room seems to shrink, the bustling carnival outside fading into the background as they reveal your fate. Each card turned or line traced feels significant, as though unlocking a secret you didn't know you carried.

As the reading concludes, the fortune teller gazes into your eyes with a cryptic smile and delivers their final words of wisdom. Whether you leave with a sense of wonder, excitement, or unease, the encounter lingers with you - a touch of magic amid the carnival's chaos, as if you've glimpsed something beyond the ordinary.

>nw
Ticket Booth
You can see a ticket kiosk and a cashier here.

>e
High Striker
This area features a tall, eye-catching machine adorned with bright, colorful lights, typically red, yellow, and blue. A large sign at the top reads "Test Your Strength!" in bold, playful lettering. The machine's base is made of polished wood, with a polished, vintage appearance. At the center is a sturdy metal pole, with a large bell hanging at the top, signaling when a successful attempt has been made. Along the length of the pole are markings indicating how strong you are.  A nearby sign says, "Buy a mallet, strike the bell, win a prize."

Spectators gather around, cheering on participants and offering lighthearted jabs and encouragement, creating a lively, competitive atmosphere. The sound of the mallet hitting the target is followed by the resonant clang of the bell (if struck), alongside the buzz of carnival music in the background. The Ticket Kiosk is back the way you came and other games are northeast and northwest of here. The Ferris Wheel lies to the east.

You can see a Strongman attendant and a lever here.

The attendant is holding a mallet.

>buy mallet
You fork over $2.00 for the mallet, leaving yourself with $6.00.

>hit bullseye with mallet
You lift the mallet high and bring it down on the lever with all your might! The striker rises towards the bell stopping at "Getting Stronger".  C'mon! You can do better than that!

>g
You lift the mallet high and bring it down on the lever with all your might! The striker rises towards the bell stopping at "Getting Stronger".  C'mon! You can do better than that!

>g
You lift the mallet high and bring it down on the lever with all your might! The striker rises towards the bell stopping at "Average".  C'mon! You can do better than that!

>g
You lift the mallet high and bring it down on the lever with all your might! The striker rises towards the bell stopping at "Average".  C'mon! You can do better than that!

>g
You lift the mallet high and bring it down on the lever with all your might! The striker rises towards the bell stopping at "Getting Stronger".  C'mon! You can do better than that!

You swing the mallet one more time. The bell rings as the striker reaches the top of the pole. The attendant says, "You're a Muscle Man. Here's a prize for you."
Which prize would you like? 1) a teddy bear, 2) a Swiss Army knife, 3) a poster of Taylor Swift, 4) a magenta fuse?

>2
You are now holding a Swiss Army knife.

[Your score has just gone up by ten points.]

>e
Ferris Wheel Ride
The Ferris wheel is the towering centerpiece of the carnival, its vibrant lights and graceful rotations drawing the attention of visitors from every corner of the fairgrounds. The wheel's massive steel frame arches high into the sky, its intricate network of beams glinting under the colorful glow of bulbs strung along its circumference. Each gondola, painted in bright hues like red, yellow, and blue, dangles from the wheel, swaying gently as it turns.

At night, the Ferris wheel transforms into a dazzling spectacle, with hundreds of synchronized lights creating patterns and ripples that pulse outward like waves. The bulbs flash in bursts of red, green, and white, casting playful reflections on nearby attractions and the surrounding crowd.

The air around the wheel is filled with a mix of excited chatter, the hum of its motor, and the occasional squeal of laughter or nervousness from riders high above. The ride operator, standing in a small booth at the base, keeps a steady rhythm of loading and unloading passengers, their voice occasionally calling out, "Step right up! The best view of the carnival awaits!"

The Ferris wheel offers an ever-changing perspective of the carnival below. From its peak, riders can see the entire fairground: the spinning lights of the rides, the colorful stripes of game booths, and the winding paths of visitors navigating the midway. Beyond the carnival, the view stretches to the horizon, with city lights adding to the magical experience.

Whether it's a romantic ride for couples, a thrilling adventure for friends, or a calming retreat for families, the Ferris wheel captures the spirit of the carnival - an iconic blend of excitement, wonder, and timeless charm.

You can see a Ferris Wheel attendant here.

>give Ferris wheel ticket to attendant
You give the Ferris Wheel ticket to the Ferris Wheel attendant.

As you step into the gently swaying gondola, a faint creak accompanies the safety bar locking into place. The Ferris wheel begins its slow ascent, the hum of its machinery blending with the distant sounds of carnival games and laughter below. A soft breeze brushes against your face as the gondola rises higher, offering an ever-expanding view of the fairgrounds.

With each rotation, the world transforms. At the peak, the carnival sprawls beneath you like a miniature village, its vibrant lights twinkling against the twilight sky. The sound of the midway fades into a soft murmur, replaced by the serene quiet of being high above the bustling crowd. Beyond the fair, the horizon stretches endlessly, framed by the glow of distant city lights.

The gondola sways gently, adding a hint of thrill to the tranquil ride. You exchange smiles with your companions, pointing out tiny figures darting between booths and the dizzying motion of other rides below. The Ferris wheel begins its descent, and the lively carnival sounds grow louder once again, bringing you back into the heart of the action.

Whether you're seeking a moment of calm, a romantic view, or the sheer wonder of seeing the world from above, the Ferris wheel delivers an unforgettable ride that captures the magic of the carnival.

>w
High Striker
You can see a Strongman attendant and a lever here.

>ne
Dime Toss Game
The game booth is adorned with vibrant colors - red-and-white striped awnings, twinkling lights, and eye-catching signage that reads "TOSS A DIME - WIN A PRIZE!". You can see prizes of all shapes and sizes hang around the booth, from stuffed animals and novelty toys to shiny trinkets and quirky collectibles. The larger prizes are prominently displayed to entice passersby. Rows of gleaming plates sparkle under overhead lights, their glass surfaces reflecting the surrounding glow.

The distinctive "ping" of dimes hitting plates creates a rhythmic soundtrack, punctuated by the occasional satisfying "plop" when a dime lands perfectly. Victorious shouts mix with playful groans of near-misses, creating a symphony of excitement. Nearby, the hum of other booths, upbeat carnival music, and the distant laughter of children add to the lively backdrop. The booth operator calls out enthusiastically, "Step right up! Test your skill! Win big!" Their energetic pitch draws in curious onlookers. You thought you caught a flash of something coming from the area of the booth.

You're surprised to see that this game only costs a dime.

You can see a Dime Toss attendant and a plate here.

>look under booth
You find the mercury dime!

>get mercury dime
Taken.

[Your score has just gone up by five points.]

>flip it on plate
You toss the dime. The dime hits the plate, starts to spins, and lands in the center of the plate. The attendant shouts out, "Winner! Winner! Which prize would you like? 1) a stuffed monkey, 2) an orange fuse, 3) a poster of Billie Eilish, 4) a small pocket mirror?

>sw
High Striker
You can see a Strongman attendant and a lever here.

>ne
Dime Toss Game
You can see a Dime Toss attendant and a plate here.

Which prize would you like? 1) a stuffed monkey, 2) an orange fuse, 3) a poster of Billie Eilish, 4) a small pocket mirror?

>2
You are now holding an orange fuse.

[Your score has just gone up by five points.]

>sw
High Striker
You can see a Strongman attendant and a lever here.

>se
Pitcher's Mound
The milk bottle ball toss is a classic carnival game that combines skill, strength, and a bit of luck. The setup features a pyramid of brightly colored milk bottles stacked on a sturdy platform - three on the bottom, two in the middle, and one on top. Players stand behind a marked line and toss baseballs, aiming to knock down as many bottles as possible. Clearing the entire stack wins a prize.

The booth buzzes with energy, its colorful banners and flashing lights drawing a lively crowd. The satisfying clatter of falling bottles mixes with cheers and groans from players and spectators. A carnival barker calls out, "Step right up and test your aim! Three balls for just a dime." Prizes - ranging from small toys to giant stuffed animals - hang prominently, enticing players to take a shot. With every toss, the game delivers moments of suspense, joy, and fun, making it a favorite at the carnival.

You're surprised to see that this game only costs a dime.

You can see a Pitcher's Mound attendant here.

>give dime to attendant
The attendant gives you three baseballs in return.

>throw baseball at bottles
You wind up and throw the baseball at the milk bottles. The ball hits the bottles in the sweet spot and they go flying off the platform. The attendant shouts out, "Winner! Winner! Which prize would you like? 1) a crimson fuse, 2) a plush donkey, 3) a goldfish in a bowl, 4) a poster of Lourde?

>1
You are now holding a crimson fuse.

[Your score has just gone up by ten points.]

>nw
High Striker
You can see a Strongman attendant and a lever here.

>w
Ticket Booth
You can see a ticket kiosk and a cashier here.

>s
Head of the Line
You are standing in front of a ticket taker with his hand open waiting for your ticket. The entrance to the ride is south of here. The ride operator tells you that you're lucky you showed up when you did because this will be the last trip through Hell Ride for the night. You notice that all the other cars are empty. The Ticket Kiosk is back the way you came.

You can see a Hell Ride attendant here.

>give hell ride ticket to attendant
You give the Hell Ride ticket to the Hell Ride attendant.

>s
Ride Entrance
The cars that will take you into the fearsome Hell Ride stop here for you to board and then move forward, the safety bar locked in place, as the entrance to Hell Ride looms ahead - a grotesque facade of twisted metal and carved wood, illuminated by flickering blood-red lights. The air carries a faint sulfuric tang mingled with the sweet aroma of carnival popcorn.

A towering archway of flames, spikes, and grinning skulls frames the entrance, crowned by flickering letters that read "HELL RIDE", pulsing like a heartbeat. Below, crouching demon sculptures extend clawed hands in a sinister invitation. Wooden doors cover the entrance, whispering with faint, menacing chuckles as distorted organ music grows louder, punctuated by shrieks and grinding machinery.

Inside, near-total darkness is broken by flashes of sickly green light revealing twisted paths and grotesque shapes. Beyond the threshold lies only uncertainty and terror.

You can see a Hell Ride car (empty) here.

>e
Dark Passage
This room is backstage at the Hell Ride attraction. The room is littered with bags of trash, piles of junk, and dust bunnies so large they should be paying rent. West is back the way you came from. There an exit to the south.

[Your score has just gone up by five points.]

>l under junk
In the pile of junk is a flashlight.

You find a flashlight here.

>get flashlight
Taken.

>turn it on
You flip a switch. A strong, narrow beam of light shines from the lit flashlight.

>s
Maintenance Office
The maintenance office, hidden behind the carnival's bright facade, is a dim and cluttered space reeking of grease, sweat, and faint traces of popcorn from the midway. The air hangs heavy with oil and stirred-up dust.

The walls are lined with shelves holding tools and parts in disarray - screws and mismatched containers with faded labels. Paint cans and grease jars clutter the workbenches, many left half-open. In the center, a battered desk is strewn with wires, gears, and springs, a bent piece of metal held in a vise. Overhead, a single flickering fluorescent light struggles to illuminate the room.

In one corner, a disassembled ride mechanism lies exposed, chains and pulleys dangling from hooks above, faintly clinking with the vibrations of the rides. A grease-stained manual and a half-drained mug of coffee sit abandoned on a nearby stool.

The walls display faded safety posters, a cork board with maintenance schedules and notes, and a worn photo of the carnival in its prime. A clock ticks faintly, its hands out of sync with reality. The floor, gritty with dust and scattered nails, adds to the room's chaotic charm.

Despite the mess, the room buzzes with purpose - a hidden hub where the carnival's magic is sustained through sweat, ingenuity, and the hum of machinery.

Exits lead north and south. There is a door to the west.

Nearby a ladder leads up.

Nearby an aqua colored door leads west.

On the desk are a coffee mug and a radio.

You can also see a worn photo here.

>turn radio on
You switch the radio on.

The DJ announces that "Rainbow Connection" by Kermit the Frog will be up next.

>u
Dark Hallway
This is a poorly lit hallway. Ahead to the west you can see the glow of an open door.

Nearby a ladder leads down to the Maintenance Office.

"Peace Train" by Cat Stevens plays on the radio.

>w
Control Room
The backstage control room is a plain, functional hub where the carnival's rides, lights, and attractions are managed. Gray industrial walls, scuffed and greasy, surround a large monitor streaming live carnival feeds. Beneath them, control panels with labeled dials, colored buttons, and lights oversee the systems scattered about the room. Glancing at the control panels, you can see they are dark.

The hum of electronics fills the air, punctuated by the crackle of a radio: "Maintenance to Bumper Cars - wrench needed!" The worn floor is scattered with papers, tools, and coffee cups. A cluttered desk holds logs and schedules, while a cork board above displays charts and red-marked notes like "Check Zipper circuit breakers."

A flickering light casts cold shadows as the metallic tang of machinery mixes with dampness. Functional yet essential, this hidden space ensures the carnival's magic runs seamlessly. On one wall is a large switch with sparks arcing out from it.

A dark hallway lies to the east.

You can see a big switch and a cluttered desk here.

You sing along to Warren Zevon's "Werewolves Of London".

[Your score has just gone up by five points.]

>flip switch
You switch the big switch off.

You hear Pharell's "Happy" playing on the radio.

[Your score has just gone up by ten points.]

>e
Dark Hallway
Nearby a ladder leads down to the Maintenance Office.

You whistle along to "Losing My Religion" by R.E.M..

>d
Maintenance Office
Nearby a ladder leads up to the Dark Hallway.

Nearby an aqua colored door leads west.

On the desk are a coffee mug and a radio.

You can also see a worn photo here.

"Fool In The Rain" by Led Zeppelin plays on the radio.

>s
Crawl Space
The crawl space beneath the carnival ride is a tight, claustrophobic tunnel shrouded in darkness and filled with the hum of machinery above. The air is stale and heavy, carrying the sharp metallic scent of oil and the faint tang of rust. Every sound is amplified in the confined space - the groaning of steel beams, the clanking of chains, and the rhythmic thrum of motors driving the ride above.

The ground is uneven, a mix of packed dirt and loose gravel scattered with forgotten tools, scraps of metal, and tangled wires. Overhead, a network of pipes and cables crisscross the space, some wrapped in fraying insulation that crackles faintly as you crawl past. Small puddles of murky water collect in dips on the floor, their surfaces rippling with vibrations from the ride's movement.

The backstage area continues north and south. There is a door to the west.

Nearby a crimson colored door leads west.

You hear Paul Simon's "Kodachrome" playing on the radio.

>s
Mechanical Room North
The north mechanical room is compact and specialized, housing auxiliary systems that keep the ride running smoothly. A subdued hum of capacitors and relays fills the space, its quiet rhythm broken only by the occasional hiss of hydraulic fluid.

Electrical panels line the walls, labeled for functions like "Lighting Controls," "Brake Systems," and "Emergency Shutdown." Smaller cables and conduits snake along the walls, linking these systems to the main hub. In one corner, a hydraulic pump and reservoir manage lifting arms and rotating platforms, their gauges flickering as they work.

A small workbench against the eastern wall is cluttered with tools and coiled wires, while shelves above hold neatly labeled spare parts - cables, and hydraulic tubing. A faded ride diagram pinned nearby is marked with red annotations from past repairs.

Dimly lit by a single hanging bulb, the room feels cooler and slightly damp, the metallic tang of machinery mixing with a hint of mildew. Though quieter and less prominent than the south mechanical room, this space plays a vital role in supporting the ride's operation and ensuring its emergency systems are always prepared.

There are exists north and south. There is a wooden door to the west.

Nearby an emerald colored door leads west.

You can also see a toolbox (closed) here.

>s
Mechanical Room South
The south mechanical room is the operational core of the carnival ride, a bustling, noisy space dominated by a massive motor. Its steady hum drives the thick belts, pulleys, and gears that work in perfect unison to power the ride.

Heavy-duty electrical panels line the walls, adorned with warning labels like "High Voltage" and blinking indicator lights in an array of colors. Overhead, labeled conduits and wires snake across the ceiling, connecting systems with meticulous precision.

A cluttered table holds tools and spare parts - bolts and lubricants - alongside open maintenance logs marked with greasy fingerprints. The air is thick with the smell of oil, metal, and a faint trace of ozone from the electrics.

A cooling fan spins in the corner, barely cutting through the room's warmth. The hum of machinery is occasionally punctuated by clinking chains and the sharp hiss of hydraulic fluid. The floor, a mix of metal grates and worn concrete, reflects years of use and maintenance.

Bright fluorescent lights in wire cages illuminate the space, highlighting the intricate systems at work. The south mechanical room is the ride's powerhouse, where every movement is controlled with precision to deliver its thrilling experience.

You can travel north and south from here. There is a door to the west.

Nearby a gray colored door leads west.

>s
Generator Room
 The generator room is a compact, utilitarian space where the lifeblood of the carnival's power is produced. Its reinforced concrete walls bear grime, oil streaks, and faint graffiti from past workers. The air carries a mix of diesel, hot metal, ozone, and damp earth, creating a distinctly industrial scent.

At the center, the main generator hums steadily, its scuffed steel casing evidence of years of service. Thick rubberized cables extend from it like veins, connecting to junction boxes and circuit breakers along the walls. A large panel nearby is cluttered with buttons, switches, and gauges, many with faded labels like "Fuel Intake" and "Emergency Shutoff." A flickering display screen shows power levels and load distribution.

The rough concrete floor is uneven, marked by small puddles of spilled fuel or condensation. Shelves along the walls hold spare parts - filters, spark plugs, and wire coils - while tools lie scattered on a workbench beside a grease canister and a worn maintenance manual.

A single industrial bulb in a protective cage casts harsh light, leaving deep shadows across the machinery. In the corner, a vent fan whirs faintly, struggling to cool the warm, vibrating air. A row of diesel canisters gleams beneath a faded safety poster that warns, "Fuel Safely - No Open Flames!"

Though isolated and utilitarian, the generator room is the carnival's heartbeat, powering its lights, rides, and sounds. Its quiet separation from the carnival's chaos serves as a stark reminder of the machinery driving the magic.

The backstage area continues north and south of here. There is a wooden door to the west.

Nearby an indigo colored door leads west.

>s
Electrical Room
The electrical room is a small but essential space hidden behind the carnival's bright attractions. The air vibrates with electric energy, carrying the acrid scent of overheated wires and metal. Metal panels line the walls, some polished, others worn and streaked with grease.

A central breaker panel, labeled with destinations like "Ferris Wheel Lights" and "Carousel Motors," dominates one wall. Colored indicator lights blink intermittently, reflecting off steel surfaces. Overhead, thick cable bundles snake across the ceiling, connecting to the carnival's power network.

In a corner, an open junction box spills wires onto the wall, while a workbench holds scattered tools and a smudged wiring diagram pinned above. The dirt floor bears scratches, oil stains, and wire clippings. A faint vibration, carried from the generator or nearby rides, pulses through the room.

An emergency shutdown panel painted bright red stands near a fire extinguisher and a faded safety poster. A small fan on the workbench oscillates weakly, barely cooling the room's warmth. Flickering fluorescent tubes overhead cast harsh, shifting shadows.

The electrical room is raw and utilitarian, revealing the fragile systems behind the carnival's magic - a humbling reminder of the power sustaining the midway's enchantment.

This room is eerily quiet, missing the ever present buzz of electricity. There are exits in all directions.

>ne
Electrical Closet One
This is Electrical Closet One. There's an electrical panel here and an exit to the south west.

You can see a silver key here.

>get key
(the silver key)
Taken.

Over the loud speaker, an announcement blares: Attention please. There is a vehicle being towed from the parking lot for parking illegally. The license plate of the car is "862901". You breathe a sigh of relief as you realize that's not your license plate. I guess it's a good thing you remembered to place the parking stub on the dashboard.

>sw
Electrical Room

>s
Storage Room
The carnival storage room is a cramped yet essential space, tucked away from the bustling grounds. Its rusted metal and peeling wooden walls bear the marks of years of use, while the air hangs heavy with grease, dust, damp canvas, and a faint trace of stale popcorn.

Shelves overflow with supplies - boxes of light bulbs, spools of wire, and assorted ride parts - piled without order. Tangled flags and strings of lights dangle from hooks, while crates labeled "GAME PRIZES" and "RIDE PARTS" hold items like stuffed animals and plastic toys. Folded tarps and tent poles teeter in one corner.

The room's center is dominated by larger objects: spare ride seats, unassembled booths, and faded attraction pieces like a scratched carousel horse, all hidden beneath protective tarps.

Near the entrance, a battered desk is cluttered with maintenance logs, tools, and empty coffee cups. Above it, a cork board brims with ride schedules, repair requests, and notes. A flickering fluorescent bulb casts uneven shadows, adding an eerie atmosphere.

The floor, a rough blend of concrete and dirt, is littered with bolts and wire scraps. In the dim corners, the scuttle of rats and the glint of cobwebs underline the room's gritty nature.

Chaotic yet indispensable, this hidden space powers the carnival's magic, ensuring every ride and booth runs seamlessly.

There is an exit to the north and a door to the west.

Nearby a khaki colored door leads west.

>w
(first opening the khaki colored door)
(first unlocking the khaki colored door)
(with the silver key)

Ride Exit
The exit of Hell Ride is designed to leave riders with lingering unease. Emerging from a dark corridor with peeling black and red-streaked walls, flickering lights cast erratic shadows on the uneven floor. The air is cool and damp, carrying a faint metallic tang, while faint whispers and distant screams echo softly in the background.

Riders step into a small courtyard enclosed by jagged, rusted fencing draped with cobwebs and plastic bones. Overhead, a weathered sign reads, "You've Survived… For Now." Nearby, carnival workers in tattered costumes watch silently, occasionally muttering cryptic remarks like, "Not everyone makes it out."

A merchandise stand glows red, selling items like Hell Ride Survivor t-shirts and devil horns. Beyond the fencing, the cheerful carnival lights and sounds feel jarring, contrasting sharply with the ride's oppressive atmosphere.

The exit ensures Hell Ride isn't just an experience - it lingers, blurring the line between thrill and fear.

Nearby a khaki colored door leads east to the Storage Room.

>look in stand
In the merchandise stand are an aqua colored fuse, plastic bones, devil horns, and a t-shirt.

>buy aqua fuse
You fork over $3.50 for the aqua colored fuse, leaving yourself with $2.50.

[Your score has just gone up by five points.]

>n
Guillotine Room
The public square buzzes with tense anticipation, a crowd gathered under gray skies that cast a somber light on the cobblestones. At the center, a stark wooden platform looms, its purpose grim and unavoidable.

A lone figure stands on the scaffold, bound hands behind their back and head bowed low, avoiding the crowd's gaze. Their tattered clothing, once fine, reflects the fall that led them to this moment.

The crowd encircles the platform, emotions ranging from jeers and curses to silent, grim observation. Children sit on shoulders, their curious eyes unaware of the event's gravity. Near the edge of the platform, the town crier proclaims the crime: "High treason against the crown. Let this be a warning to all who defy the realm!"

The condemned flinches but remains silent as the executioner - a hooded figure in black - stands ready beside the guillotine, its blade gleaming faintly in the dim light. The murmurs of the crowd fall into silence at the executioner's signal, leaving only the rustle of wind and the creak of the scaffold.

As the condemned approaches the guillotine, a crow caws sharply from a nearby rooftop, its cry echoing through the square like an omen. The crowd leans forward, breath held, as justice and mortality converge on the scene.

There is just one problem: the guillotine is being raised and lowered by some mechanism. It appears that the timing of the guillotine is off and it is being lowered onto the cars instead of between them. If a person were to be in a car as it passed under the guillotine, they would be decapitated. 

Nearby an indigo colored door leads east to the Generator Room.

You can also see a guillotine platform here.

>l under platform
You find the gray colored fuse!

>get gray fuse
Taken.

[Your score has just gone up by five points.]

>n
Dungeon
The dungeon is a dark, suffocating chamber carved into the earth, its stone walls slick with moisture and grime. The air reeks of sweat, blood, mildew, and burning oil from flickering torches mounted on rusted sconces. Shadows twist on the walls, creating grotesque, unsettling shapes in the dim light.

Chains hang from walls and ceilings, their faint clinking blending with the moans and occasional screams of prisoners. Water drips rhythmically from a cracked ceiling, adding to the chamber's eerie ambiance.

The room is littered with instruments of torment: a splintered rack, a glowing brazier holding bloodstained tools, and a spiked chair gleaming faintly in the light. Prisoners endure their own horrors - one stretched on the rack, another hanging limply from manacles, and a third gasping weakly in the spiked chair.

The hooded torturer moves with detached precision, their leather apron stained with the evidence of countless victims. They work silently, indifferent to the agony surrounding them.

Above, rats scuttle in the shadows, and the low ceiling presses down like the weight of despair. The sole exit, a riveted iron-bound door, feels more like a barrier to hope than a path to freedom.

This is a realm of suffering and hopelessness, where life and death blur, and torment is the only certainty.

Nearby a gray colored door leads east to the Mechanical Room South.

>l under chair
You find the indigo colored fuse!

>get indigo fuse
Taken.

[Your score has just gone up by five points.]

>n
Stake Room
The public square is steeped in grim silence, broken only by the crackling of flames. At its center, three wooden stakes rise from a pyre of logs and kindling, darkened by smoke from past executions. Bound to the stakes are three women, their faces reflecting defiance, resignation, and terror.

A crowd encircles the scene, expressions ranging from morbid fascination to righteous fury. Children cling to their mothers, while elders nod solemnly. Some jeer and throw stones; others murmur prayers or avert their gaze.

The executioner, hooded and clad in a leather apron, steps forward with a blazing torch, igniting the pyre in a sudden roar. Flames climb rapidly as thick smoke coils upward. The condemned cry out, their voices mingling with the crackle of fire. The oppressive heat radiates outward, pressing against the silent, uneasy crowd.

Gray clouds loom overhead, nature's somber backdrop to the grim spectacle. A raven caws from the bell tower as slow church bells toll, each strike punctuating the tragedy. As the pyre burns, some onlookers remain transfixed while others quietly slip away, the square heavy with ash, smoke, and the echoes of the condemned.

Nearby an emerald colored door leads east to the Mechanical Room North.

You can also see a pyre here.

>l in pyre
In the pyre is a quartz colored fuse.

>get quartz fuse
Taken.

>n
Gallows Room
The public square, slick with morning drizzle, lies under a brooding, overcast sky. At its center looms the gallows, a weathered wooden platform with thick ropes swaying ominously. The crowd stands in somber silence, broken by the shuffle of feet or faint murmurs, their eyes fixed on the grim scene.

A hooded executioner, cloaked in black, adjusts the frayed noose with practiced precision, his cold presence exuding purpose. In front of him stands the condemned man, pale and trembling, his bound hands behind him. Beads of sweat mix with rain on his haunted face as his darting eyes search the indifferent crowd. Each shallow breath forms a fleeting cloud in the chilly air - a fragile reminder of his fleeting life.

Vendors hawk bread and cider, while children strain for a better view. An old man clutches a rosary, whispering prayers, as others smirk and place bets. Above, the bell tower tolls, its mournful chime marking the passage of the man's final moments. A raven perches on the gallows" beam, its unblinking gaze fixed on the scene below.

As the executioner adjusts the noose around the man's neck, the crowd falls silent, the air thick with dread. Distant thunder rumbles faintly, as if the heavens themselves await the inevitable.

Nearby a crimson colored door leads east to the Crawl Space.

You can also see a gallows platform here.

>l under platform
You find the khaki colored fuse!

>get khaki fuse
Taken.

[Your score has just gone up by five points.]

>n
Stocks Room
The public square is a cobblestone expanse bordered by weathered timber-framed buildings. The air carries the mingling scents of chimney smoke, damp earth, and the faint tang of a nearby smithy. At its center, crude wooden stocks stand as a grim focal point, their beams weathered and stained from years of use. Iron clasps lock captives in degrading postures, their tattered clothing offering little protection from the biting wind.

The animatronics and wax figures are extremely life like. Hell Ride sure lives up to its name.

The punished individuals hang their heads in shame, their faces etched with despair. Around them, the crowd revels in cruelty - a wiry man spits insults with gleeful laughter, while a stout woman throws overripe vegetables, each impact sparking jeers. Even children join in, pointing and mocking with mischievous delight.

The square hums with noise: the crowd's taunts, the crack of objects hitting wood, and the quiet murmurs of the suffering captives. Overhead, a gray sky threatens rain, indifferent to the spectacle below. The jeering mob ignores its ominous weight, too engrossed in their shared cruelty to notice nature's disapproval.

Nearby an aqua colored door leads east to the Maintenance Office.

You can also see a wooden stocks here.

>l under stocks
You find the emerald colored fuse!

>get emerald fuse
Taken.

[Your score has just gone up by five points.]

>e
(first opening the aqua colored door)
(first unlocking the aqua colored door)
(with the silver key)

Maintenance Office
Nearby an aqua colored door leads west to the Stocks Room.

Nearby a ladder leads up to the Dark Hallway.

On the desk are a coffee mug and a radio.

You can also see a worn photo here.

"Bohemian Rhapsody" by Queen plays on the radio.

>s
Crawl Space
Nearby a crimson colored door leads west to the Gallows Room.

The DJ announces that "Never Gonna Give You Up" by Rick Astley will be up next.
 Yes, you have been Rick Rolled!

>s
Mechanical Room North
Nearby an emerald colored door leads west to the Stake Room.

You can also see a toolbox (closed) here.

>open tool box
You open the toolbox, revealing an adjustable wrench, channel locks, pliers, and a hammer.

>get wrench
Taken.

>n
Crawl Space
Nearby a crimson colored door leads west to the Gallows Room.

You sing along to Bruce Springsteen's "Born To Run".

>n
Maintenance Office
Nearby an aqua colored door leads west to the Stocks Room.

Nearby a ladder leads up to the Dark Hallway.

On the desk are a coffee mug and a radio.

You can also see a worn photo here.

You hear Cat Stevens's "Peace Train" playing on the radio.

>n
Dark Passage
The DJ announces that "Respect" by Aretha Franklin will be up next.

>w
Ride Entrance
You can see a Hell Ride car (empty) here.

* * *

>n
Head of the Line
You can see a Hell Ride attendant here.

>n
Ticket Booth
You can see a ticket kiosk and a cashier here.

>nw
Bumper Cars Ride
You can see a Bumper Cars attendant here.

>give adjustable wrench to attendant
Hey! Thanks, I really appreciate it. Usually no one ever responds to the radio in the Control Room.

[Your score has just gone up by five points.]

>se
Ticket Booth
You can see a ticket kiosk and a cashier here.

>s
Head of the Line
You can see a Hell Ride attendant here.

* * *

>s
Ride Entrance
You can see a Hell Ride car (empty) here.

>e
Dark Passage
Nearby, you can hear "No Woman, No Cry" by Bob Marley.

>s
Maintenance Office
Nearby an aqua colored door leads west to the Stocks Room.

Nearby a ladder leads up to the Dark Hallway.

On the desk are a coffee mug and a radio.

You can also see a worn photo here.

You hear Kermit the Frog's "Rainbow Connection" playing on the radio.

>s
Crawl Space
Nearby a crimson colored door leads west to the Gallows Room.

Nearby, you can hear "Respect" by Aretha Franklin.

>s
Mechanical Room North
Nearby an emerald colored door leads west to the Stake Room.

You can also see a toolbox (in which are channel locks, pliers, and a hammer) here.

>s
Mechanical Room South
Nearby a gray colored door leads west to the Dungeon.

>s
Generator Room
Nearby an indigo colored door leads west to the Guillotine Room.

* * *

>put aqua fuse in socket
You hear a satisfying snick as the aqua fuse slides into place.

>turn on switch
To TURN ON a switch, try FLIP switch, PUSH switch, or TOGGLE switch.

>flip switch
You switch Electrical Panel 1's switch on.

The aqua indicator's light goes on.

[Your score has just gone up by five points.]

* * *

>put crimson fuse in socket
You hear a satisfying snick as the crimson fuse slides into place.

>toggle switch
You switch Electrical Panel 3's switch on.

The crimson indicator's light goes on.

[Your score has just gone up by five points.]

>w
Electrical Room

>se
Electrical Closet Five
This is Electrical Closet Five. There's an electrical panel here and an exit to the north west.

>open panel
(first unlocking Electrical Panel 5)
(with the Swiss Army knife)
Using the screwdriver on the Swiss Army knife, you remove the screws holding the electrical panel shut.

You open Electrical Panel 5.

>insert emerald fuse in socket
You hear a satisfying snick as the emerald fuse slides into place.

>turn on switch
To TURN ON a switch, try FLIP switch, PUSH switch, or TOGGLE switch.

>flip switch
You switch Electrical Panel 5's switch on.

The emerald indicator's light goes on.

[Your score has just gone up by five points.]

* * *

>nw
Electrical Room

>sw
Electrical Closet Seven
This is Electrical Closet Seven. There's an electrical panel here and an exit to the north east.

>open panel
(first unlocking Electrical Panel 7)
(with the Swiss Army knife)
Using the screwdriver on the Swiss Army knife, you remove the screws holding the electrical panel shut.

You open Electrical Panel 7.

* * *

>put gray fuse in socket
You hear a satisfying snick as the gray fuse slides into place.

>push switch
You switch Electrical Panel 7's switch on.

The gray indicator's light goes on.

[Your score has just gone up by five points.]

>ne
Electrical Room

* * *

>e
Electrical Room

>nw
Electrical Closet Eleven
This is Electrical Closet Eleven. There's an electrical panel here and an exit to the south east.

>open panel
(first unlocking Electrical Panel 11)
(with the Swiss Army knife)
Using the screwdriver on the Swiss Army knife, you remove the screws holding the electrical panel shut.

You open Electrical Panel 11.

* * *

>n
Generator Room
Nearby an indigo colored door leads west to the Guillotine Room.

>n
Mechanical Room South
Nearby a gray colored door leads west to the Dungeon.

>n
Mechanical Room North
Nearby an emerald colored door leads west to the Stake Room.

You can also see a toolbox (in which are channel locks, pliers, and a hammer) here.

>n
Crawl Space
Nearby a crimson colored door leads west to the Gallows Room.

"Folsom Prison Blues" by Johnny Cash plays on the radio.

>n
Maintenance Office
Nearby an aqua colored door leads west to the Stocks Room.

Nearby a ladder leads up to the Dark Hallway.

On the desk are a coffee mug and a radio.

You can also see a worn photo here.

The DJ announces that "Heart Of Glass" by Blondie will be up next.

>u
Dark Hallway
Nearby a ladder leads down to the Maintenance Office.

You whistle along to "Heart Of Glass" by Blondie.

>w
Control Room
You can see a big switch and a cluttered desk here.

The DJ announces that "Tracks Of My Tears" by Smokey Robinson will be up next.

>spin aqua dial to 1
The aqua colored dial is now set to 1.

Nearby, you can hear "Sweet Jane" by Lou Reed and the Velvet Underground.

>turn crimson dial to 3
The crimson colored dial is now set to 3.

You hear The Talking Heads's "Psycho Killer" playing on the radio.

>set emerald dial to 5
The emerald colored dial is now set to 5.

Nearby, you can hear "Sweet Jane" by Lou Reed and the Velvet Underground.

>turn gray dial to 7
The gray colored dial is now set to 7.

"King of the Road" by Roger Miller plays on the radio.

>set indigo dial to 9
The indigo colored dial is now set to 9.

You hear Pink Floyd's "Comfortably Numb" playing on the radio.

>set khaki dial to 21
The khaki colored dial can only be set from 0 to 20.

You whistle along to "Fool In The Rain" by Led Zeppelin.

>set khaki dial to 11
The khaki colored dial is now set to 11.

You hear Jimmy Buffet's "Margaritaville" playing on the radio.

>push indigo button
You switch the indigo button on.

The monitor flickers for a second and the scene it displays changes to something different.
The monitor now shows a tableau of a guillotine rising and falling over the ride exit.
The indigo light is now on.

As you push the indigo button, the monitor switches to a view of the guillotine room. You can still see the blade rising and falling over the cars. Suddenly, you see the blade slowing down, taking longer and longer to fall. Until it finally comes to a complete rest.

The room is heavy with uneasy silence. The Hell Ride, once a thrilling spectacle, now looms motionless, as the guillotine blade is frozen halfway down its track. Moments ago, chaos erupted as the malfunctioning mechanism sent the blade crashing unpredictably, ripping through the roofs of cars on the track.

A single car, its roof gashed open, sits under the still blade - a grim reminder of the disaster narrowly averted. Above, a black crow lands on the guillotine's frame, its sharp caw cutting through the murmurs of anger and fear.

Two mechanics climb the scaffolding with tools in hand, their appearance met with wary hope. The crowd watches, holding their breath, as the cursed ride's fate hangs in the balance.

As you exit the ride, the carnival owner and the mayor are present and extending their undying gratitude for saving the day, not to mention lives!

*** You have won! ***

Wow, you've received 150 points out of a possible 150 in 188 moves! I'm very proud of you. This was a triumph. I'm being so sincere right now.

You have received points for the following: 

•  Taking the blueberries: 5 points.
•  Eating the blueberries: 5 points.
•  Finding the coins and keys: 5 points.
•  Buying the Hell Ride ticket: 10 points.
•  Wearing the sheer veil: 5 points.
•  Taking the lantern: 10 points.
•  Winning the Swiss Army knife: 10 points.
•  Taking the Mercury dime: 5 points.
•  Winning the Orange fuse: 5 points.
•  Winning the Crimson fuse: 10 points.
•  Finding the Dark Passage: 5 points.
•  Finding the Control Room: 5 points.
•  Turning off the big switch: 10 points.
•  Acquiring the Aqua fuse: 5 points.
•  Acquiring the Gray fuse: 5 points.
•  Acquiring the Indigo fuse: 5 points.
•  Acquiring the Khaki fuse: 5 points.
•  Acquiring the Emerald fuse: 5 points.
•  Bringing the wrench to the Bumper Cars: 5 points.
•  Flipping the Aqua switch: 5 points.
•  Flipping the Crimson switch: 5 points.
•  Flipping the Emerald switch: 5 points.
•  Flipping the Gray switch: 5 points.
•  Flipping the Indigo switch: 5 points.
•  Flipping the Khaki switch: 5 points.

Would you like to RESTART, RESTORE a saved game, QUIT, or UNDO the last command?

* * *

>brief
Hell Ride is now in its "brief" printing mode, which gives long descriptions of places never before visited and short descriptions otherwise.

>get berries
Taken.

[Your score has just gone up by five points.]

>eat blueberries
The blueberries were delicious. A true taste of summer!

[Your score has just gone up by five points.]

>look under seat
You find the five dimes, the three quarters, the nickel, and your keys!

[Your score has just gone up by five points.]

>get dimes, keys
dime: Taken.
dime: Taken.
dime: Taken.
dime: Taken.
dime: Taken.
your keys: Taken.

>open glove box
(first unlocking the glove box)
(with your keys)
You open the glove box, revealing a pair of gloves.

>get gloves
Taken.

>wear gloves
You put on the pair of gloves.

* * *

>give coupon to attendant
(first taking the coupon)
Done. The price of a parking ticket is now $3.00.

>buy ticket
The attendant mumbles something about the stub.

You fork over $3.00 for the parking ticket, leaving yourself with $27.00.

>put parking stub on dashboard
You put the parking stub on the dashboard.

>s
Ticket Booth
The ticket kiosk stands at the carnival entrance, a compact booth painted in bright red and yellow stripes with bold letters above the window reading "Tickets Here!" Twinkling lights outline its edges, blinking rhythmically to draw attention.

A single window serves visitors, where a smiling cashier dispenses colorful tickets from neatly arranged rolls. Beside the tickets, a cash drawer jingles as change is counted, and a digital payment system glows faintly for modern convenience. Too bad you don't have a debit card.

Next to the kiosk, a vibrant signboard lists ticket prices with playful illustrations of rides and treats. Pennant flags flutter from the kiosk's roof, adding to the festive atmosphere, while the smell of popcorn and fried dough wafts from the southwest.

The worn ground around the kiosk shows the passage of eager carnival-goers. Families, couples, and friends form a buzzing line, their excitement building as they approach this first step into the magic of the carnival.

The midway continues in all directions from here. There is a cashier here. The prices of ride tickets are on the signboard. The cashier has Hell Ride ticket, Fortune Teller ticket, Ferris Wheel ticket, Bumper Cars ticket, and Carousel ticket.

You can see a ticket kiosk and a cashier here.

>e
High Striker
This area features a tall, eye-catching machine adorned with bright, colorful lights, typically red, yellow, and blue. A large sign at the top reads "Test Your Strength!" in bold, playful lettering. The machine's base is made of polished wood, with a polished, vintage appearance. At the center is a sturdy metal pole, with a large bell hanging at the top, signaling when a successful attempt has been made. Along the length of the pole are markings indicating how strong you are.  A nearby sign says, "Buy a mallet, strike the bell, win a prize."

Spectators gather around, cheering on participants and offering lighthearted jabs and encouragement, creating a lively, competitive atmosphere. The sound of the mallet hitting the target is followed by the resonant clang of the bell (if struck), alongside the buzz of carnival music in the background. The Ticket Kiosk is back the way you came and other games are northeast and northwest of here. The Ferris Wheel lies to the east.

You can see a Strongman attendant and a lever here.

The attendant is holding a mallet.

>buy mallet
You fork over $2.00 for the mallet, leaving yourself with $25.00.

>hit bullseye with mallet
You lift the mallet high and bring it down on the lever with all your might! The striker rises towards the bell stopping at "Weakling".  C'mon! You can do better than that!

>g
You lift the mallet high and bring it down on the lever with all your might! The striker rises towards the bell stopping at "Getting Stronger".  C'mon! You can do better than that!

>g
You lift the mallet high and bring it down on the lever with all your might! The striker rises towards the bell stopping at "Getting Stronger".  C'mon! You can do better than that!

* * *

>2
You are now holding a Swiss Army knife.

[Your score has just gone up by ten points.]

>ne
Dime Toss Game
The game booth is adorned with vibrant colors - red-and-white striped awnings, twinkling lights, and eye-catching signage that reads "TOSS A DIME - WIN A PRIZE!". You can see prizes of all shapes and sizes hang around the booth, from stuffed animals and novelty toys to shiny trinkets and quirky collectibles. The larger prizes are prominently displayed to entice passersby. Rows of gleaming plates sparkle under overhead lights, their glass surfaces reflecting the surrounding glow.

The distinctive "ping" of dimes hitting plates creates a rhythmic soundtrack, punctuated by the occasional satisfying "plop" when a dime lands perfectly. Victorious shouts mix with playful groans of near-misses, creating a symphony of excitement. Nearby, the hum of other booths, upbeat carnival music, and the distant laughter of children add to the lively backdrop. The booth operator calls out enthusiastically, "Step right up! Test your skill! Win big!" Their energetic pitch draws in curious onlookers. You thought you caught a flash of something coming from the area of the booth.

You're surprised to see that this game only costs a dime.

You can see a Dime Toss attendant and a plate here.

* * *

>get mercury dime
Taken.

[Your score has just gone up by five points.]

>flip mercury dime on plate
You toss the dime. The dime hits the plate, starts to spins, and lands in the center of the plate. The attendant shouts out, "Winner! Winner! Which prize would you like? 1) a stuffed monkey, 2) an orange fuse, 3) a poster of Billie Eilish, 4) a small pocket mirror?

>2
You are now holding an orange fuse.

[Your score has just gone up by five points.]

* * *

>w
Ticket Booth
You can see a ticket kiosk and a cashier here.

>w
Show Facade
You head west through the midway, the bright lights of the carnival fading behind you as you approach a wooden booth. A sign above the entrance reads "Little Egypt Show - A Journey Into the Mysterious and Exotic!" A rotund barker, wearing a fez and a dazzling smile, gestures to a small sign beside him that says "Dime Admission."  The Ticket Kiosk is back the way you came.

You are standing in front of a dark and mysterious tent filled with illusions and exotic performers. Perhaps there's a fortune teller inside, offering cryptic clues about your journey or a hidden artifact that can be collected. There is a stage in front of the tent. The Barker is encouraging you to step up, pay for, and enjoy the Little Egypt Show.

You can see a Barker here.

The barker cries:

Ladies and gentlemen, boys and girls, gather 'round! 
Step right up and witness the spectacle that's taken the world by storm! 
She walks, she talks, she crawls on her belly like a reptile. 
Behold the one, the only Little Egypt, performing her legendary Dance of the Pyramids - a dazzling display of mystery, grace, and exotic allure! 
For just a dime, a mere one tenth of a dollar, prepare to be transported to the sands of Cairo, where enchantment and wonder await!

>give dime to barker
You hand over a dime, and the barker nods, waving you through. As you step past the entrance, the air feels thicker, almost humid, and the sounds of the carnival fade away. You've entered an entirely different world now - one filled with the scents of incense and exotic spices, and the low, hypnotic music of a faraway land. Before you, a series of dimly lit tents stretch out, their flaps slightly swaying in the breeze. Intrigued, you take your first step into the Little Egypt Show. You can now head west into the show.

* * *

>z
Time passes.

The performance concludes with a dramatic flourish of a fast-paced shimmy, a bold spin, and Little Egypt dramatically casts off her veils. The dancer takes a bow to enthusiastic applause, leaving you spellbound by the sensual yet artful display.

You applaud until your hands are sore. Did she just wink at you?

As she leaves the stage, Little Egypt tosses one of her veils to you!

>wear sheer veil
You wrap the veil around your head, shrouding your eyes. The world is a lovely color pink as you look through the veil while her perfume fills your nostrils in the most delightful way. You look pretty!

[Your score has just gone up by five points.]

>e
Show Facade
You can see a Barker here.

* * *

>e
Ticket Booth
You can see a ticket kiosk and a cashier here.

>buy hell ride ticket
You fork over $3.00 for the Hell Ride ticket, leaving yourself with $22.00.

[Your score has just gone up by ten points.]

>s
Head of the Line
You are standing in front of a ticket taker with his hand open waiting for your ticket. The entrance to the ride is south of here. The ride operator tells you that you're lucky you showed up when you did because this will be the last trip through Hell Ride for the night. You notice that all the other cars are empty. The Ticket Kiosk is back the way you came.

You can see a Hell Ride attendant here.

* * *

>l under junk
In the pile of junk is a flashlight.

You find a flashlight here.

>get flashlight
Taken.

[Your score has just gone up by ten points.]

>turn it on
You flip a switch. A strong, narrow beam of light shines from the lit flashlight.

* * *

>u
Dark Hallway
This is a poorly lit hallway. Ahead to the west you can see the glow of an open door.

Nearby a ladder leads down to the Maintenance Office.

>w
Control Room
The backstage control room is a plain, functional hub where the carnival's rides, lights, and attractions are managed. Gray industrial walls, scuffed and greasy, surround a large monitor streaming live carnival feeds. Beneath them, control panels with labeled dials, colored buttons, and lights oversee the systems scattered about the room. Glancing at the control panels, you can see they are dark.

The hum of electronics fills the air, punctuated by the crackle of a radio: "Maintenance to Bumper Cars - wrench needed!" The worn floor is scattered with papers, tools, and coffee cups. A cluttered desk holds logs and schedules, while a cork board above displays charts and red-marked notes like "Check Zipper circuit breakers."

A flickering light casts cold shadows as the metallic tang of machinery mixes with dampness. Functional yet essential, this hidden space ensures the carnival's magic runs seamlessly. On one wall is a large switch with sparks arcing out from it.

A dark hallway lies to the east.

You can see a big switch and a cluttered desk here.

[Your score has just gone up by five points.]

>flip big switch
You switch the big switch off.

[Your score has just gone up by ten points.]

>e
Dark Hallway
Nearby a ladder leads down to the Maintenance Office.

>d
Maintenance Office
Nearby a ladder leads up to the Dark Hallway.

Nearby an aqua colored door leads west.

On the desk are a coffee mug and a radio.

You can also see a worn photo here.

>s
Crawl Space
The crawl space beneath the carnival ride is a tight, claustrophobic tunnel shrouded in darkness and filled with the hum of machinery above. The air is stale and heavy, carrying the sharp metallic scent of oil and the faint tang of rust. Every sound is amplified in the confined space - the groaning of steel beams, the clanking of chains, and the rhythmic thrum of motors driving the ride above.

The ground is uneven, a mix of packed dirt and loose gravel scattered with forgotten tools, scraps of metal, and tangled wires. Overhead, a network of pipes and cables crisscross the space, some wrapped in fraying insulation that crackles faintly as you crawl past. Small puddles of murky water collect in dips on the floor, their surfaces rippling with vibrations from the ride's movement.

The backstage area continues north and south. There is a door to the west.

Nearby a crimson colored door leads west.

>s
Mechanical Room North
The north mechanical room is compact and specialized, housing auxiliary systems that keep the ride running smoothly. A subdued hum of capacitors and relays fills the space, its quiet rhythm broken only by the occasional hiss of hydraulic fluid.

Electrical panels line the walls, labeled for functions like "Lighting Controls," "Brake Systems," and "Emergency Shutdown." Smaller cables and conduits snake along the walls, linking these systems to the main hub. In one corner, a hydraulic pump and reservoir manage lifting arms and rotating platforms, their gauges flickering as they work.

A small workbench against the eastern wall is cluttered with tools and coiled wires, while shelves above hold neatly labeled spare parts - cables, and hydraulic tubing. A faded ride diagram pinned nearby is marked with red annotations from past repairs.

Dimly lit by a single hanging bulb, the room feels cooler and slightly damp, the metallic tang of machinery mixing with a hint of mildew. Though quieter and less prominent than the south mechanical room, this space plays a vital role in supporting the ride's operation and ensuring its emergency systems are always prepared.

There are exists north and south. There is a wooden door to the west.

Nearby an emerald colored door leads west.

You can also see a toolbox (closed) here.

>open toolbox
You open the toolbox, revealing an adjustable wrench, channel locks, pliers, and a hammer.

>get wrench
Taken.

>s
Mechanical Room South
The south mechanical room is the operational core of the carnival ride, a bustling, noisy space dominated by a massive motor. Its steady hum drives the thick belts, pulleys, and gears that work in perfect unison to power the ride.

Heavy-duty electrical panels line the walls, adorned with warning labels like "High Voltage" and blinking indicator lights in an array of colors. Overhead, labeled conduits and wires snake across the ceiling, connecting systems with meticulous precision.

A cluttered table holds tools and spare parts - bolts and lubricants - alongside open maintenance logs marked with greasy fingerprints. The air is thick with the smell of oil, metal, and a faint trace of ozone from the electrics.

A cooling fan spins in the corner, barely cutting through the room's warmth. The hum of machinery is occasionally punctuated by clinking chains and the sharp hiss of hydraulic fluid. The floor, a mix of metal grates and worn concrete, reflects years of use and maintenance.

Bright fluorescent lights in wire cages illuminate the space, highlighting the intricate systems at work. The south mechanical room is the ride's powerhouse, where every movement is controlled with precision to deliver its thrilling experience.

You can travel north and south from here. There is a door to the west.

Nearby a gray colored door leads west.

* * *

>ne
Electrical Closet One
This is Electrical Closet One. There's an electrical panel here and an exit to the south west.

You can see a silver key here.

>get key
(the silver key)
Taken.

* * *

>buy aqua fuse
You fork over $3.50 for the aqua colored fuse, leaving yourself with $18.50.

[Your score has just gone up by five points.]

>n
Guillotine Room
The public square buzzes with tense anticipation, a crowd gathered under gray skies that cast a somber light on the cobblestones. At the center, a stark wooden platform looms, its purpose grim and unavoidable.

A lone figure stands on the scaffold, bound hands behind their back and head bowed low, avoiding the crowd's gaze. Their tattered clothing, once fine, reflects the fall that led them to this moment.

The crowd encircles the platform, emotions ranging from jeers and curses to silent, grim observation. Children sit on shoulders, their curious eyes unaware of the event's gravity. Near the edge of the platform, the town crier proclaims the crime: "High treason against the crown. Let this be a warning to all who defy the realm!"

The condemned flinches but remains silent as the executioner - a hooded figure in black - stands ready beside the guillotine, its blade gleaming faintly in the dim light. The murmurs of the crowd fall into silence at the executioner's signal, leaving only the rustle of wind and the creak of the scaffold.

As the condemned approaches the guillotine, a crow caws sharply from a nearby rooftop, its cry echoing through the square like an omen. The crowd leans forward, breath held, as justice and mortality converge on the scene.

There is just one problem: the guillotine is being raised and lowered by some mechanism. It appears that the timing of the guillotine is off and it is being lowered onto the cars instead of between them. If a person were to be in a car as it passed under the guillotine, they would be decapitated. 

Nearby an indigo colored door leads east to the Generator Room.

You can also see a guillotine platform here.

* * *

>n
Gallows Room
The public square, slick with morning drizzle, lies under a brooding, overcast sky. At its center looms the gallows, a weathered wooden platform with thick ropes swaying ominously. The crowd stands in somber silence, broken by the shuffle of feet or faint murmurs, their eyes fixed on the grim scene.

A hooded executioner, cloaked in black, adjusts the frayed noose with practiced precision, his cold presence exuding purpose. In front of him stands the condemned man, pale and trembling, his bound hands behind him. Beads of sweat mix with rain on his haunted face as his darting eyes search the indifferent crowd. Each shallow breath forms a fleeting cloud in the chilly air - a fragile reminder of his fleeting life.

Vendors hawk bread and cider, while children strain for a better view. An old man clutches a rosary, whispering prayers, as others smirk and place bets. Above, the bell tower tolls, its mournful chime marking the passage of the man's final moments. A raven perches on the gallows" beam, its unblinking gaze fixed on the scene below.

As the executioner adjusts the noose around the man's neck, the crowd falls silent, the air thick with dread. Distant thunder rumbles faintly, as if the heavens themselves await the inevitable.

Nearby a crimson colored door leads east to the Crawl Space.

You can also see a gallows platform here.

>look under platform
You find the khaki colored fuse!

>get khaki fuse
Taken.

[Your score has just gone up by five points.]

* * *

>look under stocks
You find the emerald colored fuse!

>get emerald fuse
Taken.

[Your score has just gone up by five points.]

>e
(first opening the aqua colored door)
(first unlocking the aqua colored door)
(with the silver key)

Maintenance Office
Nearby an aqua colored door leads west to the Stocks Room.

Nearby a ladder leads up to the Dark Hallway.

On the desk are a coffee mug and a radio.

You can also see a worn photo here.

>n
Dark Passage

* * *

>n
Ticket Booth
You can see a ticket kiosk and a cashier here.

>nw
Bumper Cars Ride
The bumper cars is a bustling hub of excitement and laughter, set beneath a canopy of flashing lights and colorful decorations. The rectangular arena is surrounded by padded barriers, ensuring a safe yet thrilling experience for riders. The floor, slick and metallic, allows the brightly colored cars - painted in shades of red, blue, yellow, and green - to glide effortlessly in all directions.

Each car is equipped with a steering wheel and a padded bumper, designed to absorb the impact of playful collisions. As the ride begins, drivers of all ages eagerly maneuver their cars, aiming for friends, family, or strangers with mischievous grins. The air is filled with the sound of bumpers colliding, laughter, and the occasional squeal of surprise.

Overhead, a web of electric poles connects the cars to the ceiling, sparking faintly as they supply power to the vehicles. The ride operator watches from a booth, ensuring everyone enjoys the chaos safely. Surrounding the bumper cars are cheering onlookers, carnival lights, and the lively hum of the fairground.

The bumper cars perfectly captures the playful spirit of the carnival, offering a mix of harmless competition, shared laughter, and nostalgic fun for all ages. The Ticket Kiosk is southeast of here.

Hey! Is that a two dollar bill on the ground?

You can also see a Bumper Cars attendant here.

>get bill
Taken.

You now have $20.50.

>give wrench to attendant
Hey! Thanks, I really appreciate it. Usually no one ever responds to the radio in the Control Room.

[Your score has just gone up by five points.]

>se
Ticket Booth
You can see a ticket kiosk and a cashier here.

* * *

>e
Dark Passage

>s
Maintenance Office
Nearby an aqua colored door leads west to the Stocks Room.

Nearby a ladder leads up to the Dark Hallway.

On the desk are a coffee mug and a radio.

You can also see a worn photo here.

>s
Crawl Space
Nearby a crimson colored door leads west to the Gallows Room.

>s
Mechanical Room North
Nearby an emerald colored door leads west to the Stake Room.

You can also see a toolbox (in which are channel locks, pliers, and a hammer) here.

* * *

>s
Generator Room
Nearby an indigo colored door leads west to the Guillotine Room.

>s
Electrical Room
Over the loud speaker, an announcement blares: Attention please. There is a vehicle being towed from the parking lot for parking illegally. The license plate of the car is "862901". You breathe a sigh of relief as you realize that's not your license plate. I guess it's a good thing you remembered to place the parking stub on the dashboard.

>ne
Electrical Closet One

* * *

>put aqua fuse in socket
You hear a satisfying snick as the aqua fuse slides into place.

>push switch
You switch Electrical Panel 1's switch on.

The aqua indicator's light goes on.

[Your score has just gone up by five points.]

>sw
Electrical Room

* * *

>put emerald fuse in socket
You hear a satisfying snick as the emerald fuse slides into place.

>toggle switch
You switch Electrical Panel 5's switch on.

The emerald indicator's light goes on.

[Your score has just gone up by five points.]

>nw
Electrical Room

* * *

>put gray fuse in socket
You hear a satisfying snick as the gray fuse slides into place.

>toggle switch
You switch Electrical Panel 7's switch on.

The gray indicator's light goes on.

[Your score has just gone up by five points.]

>ne
Electrical Room

* * *

>put indigo fuse in socket
You hear a satisfying snick as the indigo fuse slides into place.

>push switch
You switch Electrical Panel 9's switch on.

The indigo indicator's light goes on.

[Your score has just gone up by five points.]

>e
Electrical Room

* * *

>put khaki fuse in socket
You hear a satisfying snick as the khaki fuse slides into place.

>push switch
You switch Electrical Panel 11's switch on.

The khaki indicator's light goes on.

[Your score has just gone up by five points.]

>se
Electrical Room

* * *

>n
Mechanical Room North
Nearby an emerald colored door leads west to the Stake Room.

You can also see a toolbox (in which are channel locks, pliers, and a hammer) here.

>n
Crawl Space
Nearby a crimson colored door leads west to the Gallows Room.

>n
Maintenance Office
Nearby an aqua colored door leads west to the Stocks Room.

Nearby a ladder leads up to the Dark Hallway.

On the desk are a coffee mug and a radio.

You can also see a worn photo here.

>u
Dark Hallway
Nearby a ladder leads down to the Maintenance Office.

>w
Control Room
You can see a big switch and a cluttered desk here.

>spin aqua dial to 1
The aqua colored dial is now set to 1.

>turn crimson dial to 3
The crimson colored dial is now set to 3.

>set emerald dial to 5
The emerald colored dial is now set to 5.

>set gray dial to 7
The gray colored dial is now set to 7.

>spin indigo dial to nine
The indigo colored dial is now set to 9.

>turn khaki dial to 11
The khaki colored dial is now set to 11.

>push indigo button
You switch the indigo button on.

The monitor flickers for a second and the scene it displays changes to something different.
The monitor now shows a tableau of a guillotine rising and falling over the ride exit.
The indigo light is now on.

As you push the indigo button, the monitor switches to a view of the guillotine room. You can still see the blade rising and falling over the cars. Suddenly, you see the blade slowing down, taking longer and longer to fall. Until it finally comes to a complete rest.

The room is heavy with uneasy silence. The Hell Ride, once a thrilling spectacle, now looms motionless, as the guillotine blade is frozen halfway down its track. Moments ago, chaos erupted as the malfunctioning mechanism sent the blade crashing unpredictably, ripping through the roofs of cars on the track.

A single car, its roof gashed open, sits under the still blade - a grim reminder of the disaster narrowly averted. Above, a black crow lands on the guillotine's frame, its sharp caw cutting through the murmurs of anger and fear.

Two mechanics climb the scaffolding with tools in hand, their appearance met with wary hope. The crowd watches, holding their breath, as the cursed ride's fate hangs in the balance.

As you exit the ride, the carnival owner and the mayor are present and extending their undying gratitude for saving the day, not to mention lives!

*** You have won! ***

Wow, you've received 150 points out of a possible 150 in 144 moves! I'm very proud of you. This was a triumph. I'm being so sincere right now.

You have received points for the following: 

•  Taking the blueberries: 5 points.
•  Eating the blueberries: 5 points.
•  Finding the coins and keys: 5 points.
•  Winning the Swiss Army knife: 10 points.
•  Taking the Mercury dime: 5 points.
•  Winning the Orange fuse: 5 points.
•  Winning the Crimson fuse: 10 points.
•  Wearing the sheer veil: 5 points.
•  Buying the Hell Ride ticket: 10 points.
•  Finding the Dark Passage: 5 points.
•  Taking the flashlight: 10 points.
•  Finding the Control Room: 5 points.
•  Turning off the big switch: 10 points.
•  Acquiring the Aqua fuse: 5 points.
•  Acquiring the Gray fuse: 5 points.
•  Acquiring the Indigo fuse: 5 points.
•  Acquiring the Khaki fuse: 5 points.
•  Acquiring the Emerald fuse: 5 points.
•  Bringing the wrench to the Bumper Cars: 5 points.
•  Flipping the Aqua switch: 5 points.
•  Flipping the Crimson switch: 5 points.
•  Flipping the Emerald switch: 5 points.
•  Flipping the Gray switch: 5 points.
•  Flipping the Indigo switch: 5 points.
•  Flipping the Khaki switch: 5 points.

Would you like to RESTART, RESTORE a saved game, QUIT, or UNDO the last command?

* * *

>help
Sometimes the temptation to rely on hints becomes overwhelming, and you may prefer to turn off hints now. If you do so, your further requests for guidance will be denied. Turn off hints?

>n
> Introduction to Hell Ride
   Instructions for Play
   Contacting the Author
   The Parking Lot
   The Attractions
   The Games
   Back Stage
   Hell Ride
   The Electrical Area
   The Control Room
   Settings

>[enter]
Hell Ride - A Ride to remember...

In the early 1980's, I had an Apple II Plus computer with 64K of RAM, dual 5.25" floppy disks, and a color monitor as big as a television. And the very first game I ever bought was Infocom's Zork I: The Great Underground Empire. This was cool. It was all text-based. The game described your surroundings and you interacted with commands that say what you wanted to do. This "Interactive Fiction" really evoked in a game what I appreciated most about reading: rich descriptions, colorful characters, and the like. After Zork I, there was Zork II and III. Enchanter, Moonmist, Suspect, and so many more. I played them all with my best friend Andy.

Andy and I were software developers at the time and we thought, "We can do this!" So we set out to do this. We developed a game engine with a natural language parser. And it was pretty good. We could support most of the kinds of things they did, certainly less graceful but pretty good. In fact, our parser was better than Infocom's in one case where the sentence was ambiguous. e.g. "Walk into the room with the lamp." Is the player carrying the lamp? Or is the lamp in the room?

For fun, we reverse engineered parts of Infocom's game format. We found the dictionary, certain text tokens used for text substitution, the game text. We also discovered the first example of compression I had ever seen and it just about made my head explode. They stored all ASCII characters in five bits! Pow! Mind blown. I had never considered anything like that. Just another hook.

We developed two prototypes: Diner and Hell Ride. Diner was about bank robbers coming into the diner where you are a short order cook and you have to save the day. Hell Ride was pretty close to what you find here. I decided to implement it using modern tools. It's pretty good. Maybe.

I hope you enjoy it.

d.

Please press SPACE to continue.

> Introduction to Hell Ride
   Instructions for Play
   Contacting the Author
   The Parking Lot
   The Attractions
   The Games
   Back Stage
   Hell Ride
   The Electrical Area
   The Control Room
   Settings

 > Introduction to Hell Ride
   Instructions for Play
   Contacting the Author
   The Parking Lot
   The Attractions
   The Games
   Back Stage
   Hell Ride
   The Electrical Area
   The Control Room
   Settings

>n
Introduction to Hell Ride
 > Instructions for Play
   Contacting the Author
   The Parking Lot
   The Attractions
   The Games
   Back Stage
   Hell Ride
   The Electrical Area
   The Control Room
   Settings

   Introduction to Hell Ride
 > Instructions for Play
   Contacting the Author
   The Parking Lot
   The Attractions
   The Games
   Back Stage
   Hell Ride
   The Electrical Area
   The Control Room
   Settings

>n
Introduction to Hell Ride
   Instructions for Play
 > Contacting the Author
   The Parking Lot
   The Attractions
   The Games
   Back Stage
   Hell Ride
   The Electrical Area
   The Control Room
   Settings

   Introduction to Hell Ride
   Instructions for Play
 > Contacting the Author
   The Parking Lot
   The Attractions
   The Games
   Back Stage
   Hell Ride
   The Electrical Area
   The Control Room
   Settings

>[enter]
If you have any difficulties with Hell Ride, please contact me at dmontgom22@gmail.com

Please press SPACE to continue.

Introduction to Hell Ride
   Instructions for Play
 > Contacting the Author
   The Parking Lot
   The Attractions
   The Games
   Back Stage
   Hell Ride
   The Electrical Area
   The Control Room
   Settings

   Introduction to Hell Ride
   Instructions for Play
 > Contacting the Author
   The Parking Lot
   The Attractions
   The Games
   Back Stage
   Hell Ride
   The Electrical Area
   The Control Room
   Settings

>n
Introduction to Hell Ride
   Instructions for Play
   Contacting the Author
 > The Parking Lot
   The Attractions
   The Games
   Back Stage
   Hell Ride
   The Electrical Area
   The Control Room
   Settings

   Introduction to Hell Ride
   Instructions for Play
   Contacting the Author
 > The Parking Lot
   The Attractions
   The Games
   Back Stage
   Hell Ride
   The Electrical Area
   The Control Room
   Settings

>[enter]
> What about the glove box?
   Why can't I leave the parking lot?
   What do I do with the string?
   Why does my car get towed?

>[enter]
1/4: It's locked.

Press SPACE to return to the menu or H to reveal another hint.

>h
1/4: It's locked.

2/4: Have you tried unlocking it?

Press SPACE to return to the menu or H to reveal another hint.

>h
1/4: It's locked.

2/4: Have you tried unlocking it?

3/4: You need a key.

Press SPACE to return to the menu or H to reveal another hint.

>h
1/4: It's locked.

2/4: Have you tried unlocking it?

3/4: You need a key.

4/4: Look under the car seat.

Press SPACE to return to the menu.

> What about the glove box?
   Why can't I leave the parking lot?
   What do I do with the string?
   Why does my car get towed?

 > What about the glove box?
   Why can't I leave the parking lot?
   What do I do with the string?
   Why does my car get towed?

>n
What about the glove box?
 > Why can't I leave the parking lot?
   What do I do with the string?
   Why does my car get towed?

   What about the glove box?
 > Why can't I leave the parking lot?
   What do I do with the string?
   Why does my car get towed?

>[enter]
1/4: Looks like you need something before heading into the carnival.

Press SPACE to return to the menu or H to reveal another hint.

>h
1/4: Looks like you need something before heading into the carnival.

2/4: Looks like you need a parking ticket.

Press SPACE to return to the menu or H to reveal another hint.

>h
1/4: Looks like you need something before heading into the carnival.

2/4: Looks like you need a parking ticket.

3/4: The parking attendant has a parking ticket.

Press SPACE to return to the menu or H to reveal another hint.

>h
1/4: Looks like you need something before heading into the carnival.

2/4: Looks like you need a parking ticket.

3/4: The parking attendant has a parking ticket.

4/4: Buy the parking ticket.

Press SPACE to return to the menu.

What about the glove box?
 > Why can't I leave the parking lot?
   What do I do with the string?
   Why does my car get towed?

   What about the glove box?
 > Why can't I leave the parking lot?
   What do I do with the string?
   Why does my car get towed?

>n
What about the glove box?
   Why can't I leave the parking lot?
 > What do I do with the string?
   Why does my car get towed?

   What about the glove box?
   Why can't I leave the parking lot?
 > What do I do with the string?
   Why does my car get towed?

>[enter]
1/3: Remember that you know how to macrame.

Press SPACE to return to the menu or H to reveal another hint.

>h
1/3: Remember that you know how to macrame.

2/3: Isn't macrame the art of tying?

Press SPACE to return to the menu or H to reveal another hint.

>h
1/3: Remember that you know how to macrame.

2/3: Isn't macrame the art of tying?

3/3: Oh, come now, isn't it obvious?

Press SPACE to return to the menu.

What about the glove box?
   Why can't I leave the parking lot?
 > What do I do with the string?
   Why does my car get towed?

   What about the glove box?
   Why can't I leave the parking lot?
 > What do I do with the string?
   Why does my car get towed?

>n
What about the glove box?
   Why can't I leave the parking lot?
   What do I do with the string?
 > Why does my car get towed?

   What about the glove box?
   Why can't I leave the parking lot?
   What do I do with the string?
 > Why does my car get towed?

>[enter]
1/6: Why might your car get towed?

Press SPACE to return to the menu or H to reveal another hint.

>h
1/6: Why might your car get towed?

2/6: Is your car parked legally?

Press SPACE to return to the menu or H to reveal another hint.

>h
1/6: Why might your car get towed?

2/6: Is your car parked legally?

3/6: Are you sure?

Press SPACE to return to the menu or H to reveal another hint.

>h
1/6: Why might your car get towed?

2/6: Is your car parked legally?

3/6: Are you sure?

4/6: What about the parking stub

Press SPACE to return to the menu or H to reveal another hint.

>h
1/6: Why might your car get towed?

2/6: Is your car parked legally?

3/6: Are you sure?

4/6: What about the parking stub

5/6: The parking attendant knows something about the stub

Press SPACE to return to the menu or H to reveal another hint.

>h
1/6: Why might your car get towed?

2/6: Is your car parked legally?

3/6: Are you sure?

4/6: What about the parking stub

5/6: The parking attendant knows something about the stub

6/6: Put the stub on the dashboard.

Press SPACE to return to the menu.

What about the glove box?
   Why can't I leave the parking lot?
   What do I do with the string?
 > Why does my car get towed?

   What about the glove box?
   Why can't I leave the parking lot?
   What do I do with the string?
 > Why does my car get towed?

>q
Introduction to Hell Ride
   Instructions for Play
   Contacting the Author
 > The Parking Lot
   The Attractions
   The Games
   Back Stage
   Hell Ride
   The Electrical Area
   The Control Room
   Settings

>n
Introduction to Hell Ride
   Instructions for Play
   Contacting the Author
   The Parking Lot
 > The Attractions
   The Games
   Back Stage
   Hell Ride
   The Electrical Area
   The Control Room
   Settings

   Introduction to Hell Ride
   Instructions for Play
   Contacting the Author
   The Parking Lot
 > The Attractions
   The Games
   Back Stage
   Hell Ride
   The Electrical Area
   The Control Room
   Settings

>[enter]
> Can I ride the rides?
   Why are tickets so expensive?
   The rides are boring.

>[enter]
1/3: You'll need a ticket.

Press SPACE to return to the menu or H to reveal another hint.

>h
1/3: You'll need a ticket.

2/3: Tickets are expensive though.

Press SPACE to return to the menu or H to reveal another hint.

>h
1/3: You'll need a ticket.

2/3: Tickets are expensive though.

3/3: You can buy tickets at the Ticket Kiosk.

Press SPACE to return to the menu.

> Can I ride the rides?
   Why are tickets so expensive?
   The rides are boring.

 > Can I ride the rides?
   Why are tickets so expensive?
   The rides are boring.

>n
Can I ride the rides?
 > Why are tickets so expensive?
   The rides are boring.

   Can I ride the rides?
 > Why are tickets so expensive?
   The rides are boring.

>[enter]
1/2: What? You were expecting wrist bands?

Press SPACE to return to the menu or H to reveal another hint.

>h
1/2: What? You were expecting wrist bands?

2/2: To remind you to spend your money wisely.

Press SPACE to return to the menu.

Can I ride the rides?
 > Why are tickets so expensive?
   The rides are boring.

   Can I ride the rides?
 > Why are tickets so expensive?
   The rides are boring.

>n
Can I ride the rides?
   Why are tickets so expensive?
 > The rides are boring.

   Can I ride the rides?
   Why are tickets so expensive?
 > The rides are boring.

>[enter]
1/3: Surely not ALL the rides are boring.

Press SPACE to return to the menu or H to reveal another hint.

>h
1/3: Surely not ALL the rides are boring.

2/3: It's a small carnival, what do you expect?

Press SPACE to return to the menu or H to reveal another hint.

>h
1/3: Surely not ALL the rides are boring.

2/3: It's a small carnival, what do you expect?

3/3: Have you ridden Hell Ride?

Press SPACE to return to the menu.

Can I ride the rides?
   Why are tickets so expensive?
 > The rides are boring.

   Can I ride the rides?
   Why are tickets so expensive?
 > The rides are boring.

>q
Introduction to Hell Ride
   Instructions for Play
   Contacting the Author
   The Parking Lot
 > The Attractions
   The Games
   Back Stage
   Hell Ride
   The Electrical Area
   The Control Room
   Settings

>n
Introduction to Hell Ride
   Instructions for Play
   Contacting the Author
   The Parking Lot
   The Attractions
 > The Games
   Back Stage
   Hell Ride
   The Electrical Area
   The Control Room
   Settings

   Introduction to Hell Ride
   Instructions for Play
   Contacting the Author
   The Parking Lot
   The Attractions
 > The Games
   Back Stage
   Hell Ride
   The Electrical Area
   The Control Room
   Settings

>[enter]
> Are the prizes important?
   Why do the games only cost a dime?
   I've found a Mercury dime. What is it?

>[enter]
1/4: Important? That's a matter of opinion.

Press SPACE to return to the menu or H to reveal another hint.

>h
1/4: Important? That's a matter of opinion.

2/4: A teddy bear to make up with your sweetie?

Press SPACE to return to the menu or H to reveal another hint.

>h
1/4: Important? That's a matter of opinion.

2/4: A teddy bear to make up with your sweetie?

3/4: I'd go with my instincts on this one if I were you.

Press SPACE to return to the menu or H to reveal another hint.

>h
1/4: Important? That's a matter of opinion.

2/4: A teddy bear to make up with your sweetie?

3/4: I'd go with my instincts on this one if I were you.

4/4: Yes, the prizes are important.

Press SPACE to return to the menu.

> Are the prizes important?
   Why do the games only cost a dime?
   I've found a Mercury dime. What is it?

 > Are the prizes important?
   Why do the games only cost a dime?
   I've found a Mercury dime. What is it?

>n
Are the prizes important?
 > Why do the games only cost a dime?
   I've found a Mercury dime. What is it?

   Are the prizes important?
 > Why do the games only cost a dime?
   I've found a Mercury dime. What is it?

>[enter]
1/3: What? You want them to cost a quarter?

Press SPACE to return to the menu or H to reveal another hint.

>h
1/3: What? You want them to cost a quarter?

2/3: The carnival likes to maintain a link to days past when games cost only a dime?

Press SPACE to return to the menu or H to reveal another hint.

>h
1/3: What? You want them to cost a quarter?

2/3: The carnival likes to maintain a link to days past when games cost only a dime?

3/3: Just be grateful

Press SPACE to return to the menu.

Are the prizes important?
 > Why do the games only cost a dime?
   I've found a Mercury dime. What is it?

   Are the prizes important?
 > Why do the games only cost a dime?
   I've found a Mercury dime. What is it?

>n
Are the prizes important?
   Why do the games only cost a dime?
 > I've found a Mercury dime. What is it?

   Are the prizes important?
   Why do the games only cost a dime?
 > I've found a Mercury dime. What is it?

>[enter]
1/4: It's a dime.

Press SPACE to return to the menu or H to reveal another hint.

>h
1/4: It's a dime.

2/4: It's a Mercury Dime.

Press SPACE to return to the menu or H to reveal another hint.

>h
1/4: It's a dime.

2/4: It's a Mercury Dime.

3/4: Have you looked at it?

Press SPACE to return to the menu or H to reveal another hint.

>h
1/4: It's a dime.

2/4: It's a Mercury Dime.

3/4: Have you looked at it?

4/4: It's a dime. Geez.

Press SPACE to return to the menu.

Are the prizes important?
   Why do the games only cost a dime?
 > I've found a Mercury dime. What is it?

   Are the prizes important?
   Why do the games only cost a dime?
 > I've found a Mercury dime. What is it?

>q
Introduction to Hell Ride
   Instructions for Play
   Contacting the Author
   The Parking Lot
   The Attractions
 > The Games
   Back Stage
   Hell Ride
   The Electrical Area
   The Control Room
   Settings

>n
Introduction to Hell Ride
   Instructions for Play
   Contacting the Author
   The Parking Lot
   The Attractions
   The Games
 > Back Stage
   Hell Ride
   The Electrical Area
   The Control Room
   Settings

   Introduction to Hell Ride
   Instructions for Play
   Contacting the Author
   The Parking Lot
   The Attractions
   The Games
 > Back Stage
   Hell Ride
   The Electrical Area
   The Control Room
   Settings

>[enter]
> Why do I get eaten by a grue?
   Are the doors important?

>[enter]
1/6: Grues love the dark.

Press SPACE to return to the menu or H to reveal another hint.

>h
1/6: Grues love the dark.

2/6: Do you have a light?

Press SPACE to return to the menu or H to reveal another hint.

>h
1/6: Grues love the dark.

2/6: Do you have a light?

3/6: Have you looked for one?

Press SPACE to return to the menu or H to reveal another hint.

>h
1/6: Grues love the dark.

2/6: Do you have a light?

3/6: Have you looked for one?

4/6: There are two in the game.

Press SPACE to return to the menu or H to reveal another hint.

>h
1/6: Grues love the dark.

2/6: Do you have a light?

3/6: Have you looked for one?

4/6: There are two in the game.

5/6: One is in the Dark Passage.

Press SPACE to return to the menu or H to reveal another hint.

>h
1/6: Grues love the dark.

2/6: Do you have a light?

3/6: Have you looked for one?

4/6: There are two in the game.

5/6: One is in the Dark Passage.

6/6: The other is in the Little Egypt tent.

Press SPACE to return to the menu.

> Why do I get eaten by a grue?
   Are the doors important?

 > Why do I get eaten by a grue?
   Are the doors important?

>n
Why do I get eaten by a grue?
 > Are the doors important?

   Why do I get eaten by a grue?
 > Are the doors important?

>[enter]
1/5: Only if you want to know what's on the other side.

Press SPACE to return to the menu or H to reveal another hint.

>h
1/5: Only if you want to know what's on the other side.

2/5: Have you tried checking what's on the other side?

Press SPACE to return to the menu or H to reveal another hint.

>h
1/5: Only if you want to know what's on the other side.

2/5: Have you tried checking what's on the other side?

3/5: You'll need a key

Press SPACE to return to the menu or H to reveal another hint.

>h
1/5: Only if you want to know what's on the other side.

2/5: Have you tried checking what's on the other side?

3/5: You'll need a key

4/5: You have to find it

Press SPACE to return to the menu or H to reveal another hint.

>h
1/5: Only if you want to know what's on the other side.

2/5: Have you tried checking what's on the other side?

3/5: You'll need a key

4/5: You have to find it

5/5: It's in Electrical Closet One

Press SPACE to return to the menu.

Why do I get eaten by a grue?
 > Are the doors important?

   Why do I get eaten by a grue?
 > Are the doors important?

>q
Introduction to Hell Ride
   Instructions for Play
   Contacting the Author
   The Parking Lot
   The Attractions
   The Games
 > Back Stage
   Hell Ride
   The Electrical Area
   The Control Room
   Settings

>n
Introduction to Hell Ride
   Instructions for Play
   Contacting the Author
   The Parking Lot
   The Attractions
   The Games
   Back Stage
 > Hell Ride
   The Electrical Area
   The Control Room
   Settings

   Introduction to Hell Ride
   Instructions for Play
   Contacting the Author
   The Parking Lot
   The Attractions
   The Games
   Back Stage
 > Hell Ride
   The Electrical Area
   The Control Room
   Settings

>[enter]
> Why do I die?
   What about the different rooms

>[enter]
1/5: Everybody dies.

Press SPACE to return to the menu or H to reveal another hint.

>h
1/5: Everybody dies.

2/5: So, you've ridden Hell Ride.

Press SPACE to return to the menu or H to reveal another hint.

>h
1/5: Everybody dies.

2/5: So, you've ridden Hell Ride.

3/5: Aren't the animatronics and wax figures amazing?

Press SPACE to return to the menu or H to reveal another hint.

>h
1/5: Everybody dies.

2/5: So, you've ridden Hell Ride.

3/5: Aren't the animatronics and wax figures amazing?

4/5: Did you notice the guillotine rising and falling?

Press SPACE to return to the menu or H to reveal another hint.

>h
1/5: Everybody dies.

2/5: So, you've ridden Hell Ride.

3/5: Aren't the animatronics and wax figures amazing?

4/5: Did you notice the guillotine rising and falling?

5/5: Did you notice it chop you in half?

Press SPACE to return to the menu.

> Why do I die?
   What about the different rooms

 > Why do I die?
   What about the different rooms

>n
Why do I die?
 > What about the different rooms

   Why do I die?
 > What about the different rooms

>[enter]
1/5: Everything sure looks realistic.

Press SPACE to return to the menu or H to reveal another hint.

>h
1/5: Everything sure looks realistic.

2/5: Aren't the animatronics and wax figures amazing?

Press SPACE to return to the menu or H to reveal another hint.

>h
1/5: Everything sure looks realistic.

2/5: Aren't the animatronics and wax figures amazing?

3/5: Each room shows a different manner of punishment.

Press SPACE to return to the menu or H to reveal another hint.

>h
1/5: Everything sure looks realistic.

2/5: Aren't the animatronics and wax figures amazing?

3/5: Each room shows a different manner of punishment.

4/5: There's the Stocks, the Gallows, the Stake, the Dungeon, and the Guillotine.

Press SPACE to return to the menu or H to reveal another hint.

>h
1/5: Everything sure looks realistic.

2/5: Aren't the animatronics and wax figures amazing?

3/5: Each room shows a different manner of punishment.

4/5: There's the Stocks, the Gallows, the Stake, the Dungeon, and the Guillotine.

5/5: Just your typical ride in the dark.

Press SPACE to return to the menu.

Why do I die?
 > What about the different rooms

   Why do I die?
 > What about the different rooms

>q
Introduction to Hell Ride
   Instructions for Play
   Contacting the Author
   The Parking Lot
   The Attractions
   The Games
   Back Stage
 > Hell Ride
   The Electrical Area
   The Control Room
   Settings

>n
Introduction to Hell Ride
   Instructions for Play
   Contacting the Author
   The Parking Lot
   The Attractions
   The Games
   Back Stage
   Hell Ride
 > The Electrical Area
   The Control Room
   Settings

   Introduction to Hell Ride
   Instructions for Play
   Contacting the Author
   The Parking Lot
   The Attractions
   The Games
   Back Stage
   Hell Ride
 > The Electrical Area
   The Control Room
   Settings

>[enter]
> What's going on in the Electrical Room?
   What about the electrical panels?
   Are the fuses important?

>[enter]
1/7: There are exits in all directions

Press SPACE to return to the menu or H to reveal another hint.

>h
1/7: There are exits in all directions

2/7: Have you mapped the area?

Press SPACE to return to the menu or H to reveal another hint.

>h
1/7: There are exits in all directions

2/7: Have you mapped the area?

3/7: Can you go in the direction you intend?

Press SPACE to return to the menu or H to reveal another hint.

>h
1/7: There are exits in all directions

2/7: Have you mapped the area?

3/7: Can you go in the direction you intend?

4/7: The room is electromagnetic.

Press SPACE to return to the menu or H to reveal another hint.

>h
1/7: There are exits in all directions

2/7: Have you mapped the area?

3/7: Can you go in the direction you intend?

4/7: The room is electromagnetic.

5/7: Maybe that's causing the problem.

Press SPACE to return to the menu or H to reveal another hint.

>h
1/7: There are exits in all directions

2/7: Have you mapped the area?

3/7: Can you go in the direction you intend?

4/7: The room is electromagnetic.

5/7: Maybe that's causing the problem.

6/7: Maybe you can make it so it's not electromagnetic.

Press SPACE to return to the menu or H to reveal another hint.

>h
1/7: There are exits in all directions

2/7: Have you mapped the area?

3/7: Can you go in the direction you intend?

4/7: The room is electromagnetic.

5/7: Maybe that's causing the problem.

6/7: Maybe you can make it so it's not electromagnetic.

7/7: Turn off the big switch.

Press SPACE to return to the menu.

> What's going on in the Electrical Room?
   What about the electrical panels?
   Are the fuses important?

 > What's going on in the Electrical Room?
   What about the electrical panels?
   Are the fuses important?

>n
What's going on in the Electrical Room?
 > What about the electrical panels?
   Are the fuses important?

   What's going on in the Electrical Room?
 > What about the electrical panels?
   Are the fuses important?

>[enter]
1/4: There's a socket, a switch, and an indictor in each one.

Press SPACE to return to the menu or H to reveal another hint.

>h
1/4: There's a socket, a switch, and an indictor in each one.

2/4: You could probably put something in the socket.

Press SPACE to return to the menu or H to reveal another hint.

>h
1/4: There's a socket, a switch, and an indictor in each one.

2/4: You could probably put something in the socket.

3/4: Looks like a fuse will fit in the socket.

Press SPACE to return to the menu or H to reveal another hint.

>h
1/4: There's a socket, a switch, and an indictor in each one.

2/4: You could probably put something in the socket.

3/4: Looks like a fuse will fit in the socket.

4/4: I'd put a fuse in the socket and flip the switch.

Press SPACE to return to the menu.

What's going on in the Electrical Room?
 > What about the electrical panels?
   Are the fuses important?

   What's going on in the Electrical Room?
 > What about the electrical panels?
   Are the fuses important?

>n
What's going on in the Electrical Room?
   What about the electrical panels?
 > Are the fuses important?

   What's going on in the Electrical Room?
   What about the electrical panels?
 > Are the fuses important?

>[enter]
1/4: Yes.

Press SPACE to return to the menu or H to reveal another hint.

>h
1/4: Yes.

2/4: They come in pretty colors.

Press SPACE to return to the menu or H to reveal another hint.

>h
1/4: Yes.

2/4: They come in pretty colors.

3/4: Have you seen those colors before?

Press SPACE to return to the menu or H to reveal another hint.

>h
1/4: Yes.

2/4: They come in pretty colors.

3/4: Have you seen those colors before?

4/4: Have you put a fuse in a socket?

Press SPACE to return to the menu.

What's going on in the Electrical Room?
   What about the electrical panels?
 > Are the fuses important?

   What's going on in the Electrical Room?
   What about the electrical panels?
 > Are the fuses important?

>q
Introduction to Hell Ride
   Instructions for Play
   Contacting the Author
   The Parking Lot
   The Attractions
   The Games
   Back Stage
   Hell Ride
 > The Electrical Area
   The Control Room
   Settings

>n
Introduction to Hell Ride
   Instructions for Play
   Contacting the Author
   The Parking Lot
   The Attractions
   The Games
   Back Stage
   Hell Ride
   The Electrical Area
 > The Control Room
   Settings

   Introduction to Hell Ride
   Instructions for Play
   Contacting the Author
   The Parking Lot
   The Attractions
   The Games
   Back Stage
   Hell Ride
   The Electrical Area
 > The Control Room
   Settings

>[enter]
> Tell me about the big switch.
   What about the control panels?

>[enter]
1/6: It's big

Press SPACE to return to the menu or H to reveal another hint.

>h
1/6: It's big

2/6: Very big

Press SPACE to return to the menu or H to reveal another hint.

>h
1/6: It's big

2/6: Very big

3/6: It's in the Control Room.

Press SPACE to return to the menu or H to reveal another hint.

>h
1/6: It's big

2/6: Very big

3/6: It's in the Control Room.

4/6: Have you tried turning it off?

Press SPACE to return to the menu or H to reveal another hint.

>h
1/6: It's big

2/6: Very big

3/6: It's in the Control Room.

4/6: Have you tried turning it off?

5/6: Did you die because your hands were unprotected?

Press SPACE to return to the menu or H to reveal another hint.

>h
1/6: It's big

2/6: Very big

3/6: It's in the Control Room.

4/6: Have you tried turning it off?

5/6: Did you die because your hands were unprotected?

6/6: Try wearing the gloves.

Press SPACE to return to the menu.

> Tell me about the big switch.
   What about the control panels?

 > Tell me about the big switch.
   What about the control panels?

>n
Tell me about the big switch.
 > What about the control panels?

   Tell me about the big switch.
 > What about the control panels?

>[enter]
1/7: There's a dial, a button, and a light in each one.

Press SPACE to return to the menu or H to reveal another hint.

>h
1/7: There's a dial, a button, and a light in each one.

2/7: These are pretty colors.

Press SPACE to return to the menu or H to reveal another hint.

>h
1/7: There's a dial, a button, and a light in each one.

2/7: These are pretty colors.

3/7: Have you seen these colors before?

Press SPACE to return to the menu or H to reveal another hint.

>h
1/7: There's a dial, a button, and a light in each one.

2/7: These are pretty colors.

3/7: Have you seen these colors before?

4/7: Try spinning the dials.

Press SPACE to return to the menu or H to reveal another hint.

>h
1/7: There's a dial, a button, and a light in each one.

2/7: These are pretty colors.

3/7: Have you seen these colors before?

4/7: Try spinning the dials.

5/7: Spin the dials to the right number.

Press SPACE to return to the menu or H to reveal another hint.

>h
1/7: There's a dial, a button, and a light in each one.

2/7: These are pretty colors.

3/7: Have you seen these colors before?

4/7: Try spinning the dials.

5/7: Spin the dials to the right number.

6/7: Is there a number that corresponds to each color?

Press SPACE to return to the menu or H to reveal another hint.

>h
1/7: There's a dial, a button, and a light in each one.

2/7: These are pretty colors.

3/7: Have you seen these colors before?

4/7: Try spinning the dials.

5/7: Spin the dials to the right number.

6/7: Is there a number that corresponds to each color?

7/7: Push the indigo button.

Press SPACE to return to the menu.

Tell me about the big switch.
 > What about the control panels?

   Tell me about the big switch.
 > What about the control panels?

>q
Introduction to Hell Ride
   Instructions for Play
   Contacting the Author
   The Parking Lot
   The Attractions
   The Games
   Back Stage
   Hell Ride
   The Electrical Area
 > The Control Room
   Settings

>q
Parking Lot
The carnival parking lot stretches across an open field, its gravel crunching under arriving cars. Temporary floodlights and the carnival's colorful glow light the area, while distant laughter, music, and the hum of rides fill the air.

Cars park haphazardly, guided by makeshift signs and fluttering flags. Families unload strollers and blankets, their chatter mixing with the carnival sounds. Others linger in vehicles, preparing for the chilly evening.

Shadows from nearby trees create dark pockets pierced by the occasional flashlight. Near the entrance, an attendant collects fees at a weathered booth, coins jingling in the cash box.

Puddles from recent rain shimmer with reflected lights, while patches of mud cling to unwary shoes. At the far end, RVs and trailers sit quietly, their occupants watching the Ferris wheel spin lazily against the sky.

Alive with anticipation, the parking lot marks the transition from the ordinary to the magic of the carnival.

The midway is to the south. There is a blueberry bush here. There are blueberries on the bush.

Your car is here. It's a bit of a beater. Inside the car, you can see the seat, the ignition, the dashboard, and the glove box.

You can see a parking attendant here.

The attendant has a parking ticket. The price of a parking ticket is $5.00.

* * *

>push indigo button
You switch the indigo button on.

The monitor flickers for a second and the scene it displays changes to something different.
The monitor now shows a tableau of a guillotine rising and falling over the ride exit.
The indigo light is now on.

As you push the indigo button, the monitor switches to a view of the guillotine room. You can still see the blade rising and falling over the cars. Suddenly, you see the blade slowing down, taking longer and longer to fall. Until it finally comes to a complete rest.

The room is heavy with uneasy silence. The Hell Ride, once a thrilling spectacle, now looms motionless, as the guillotine blade is frozen halfway down its track. Moments ago, chaos erupted as the malfunctioning mechanism sent the blade crashing unpredictably, ripping through the roofs of cars on the track.

A single car, its roof gashed open, sits under the still blade - a grim reminder of the disaster narrowly averted. Above, a black crow lands on the guillotine's frame, its sharp caw cutting through the murmurs of anger and fear.

Two mechanics climb the scaffolding with tools in hand, their appearance met with wary hope. The crowd watches, holding their breath, as the cursed ride's fate hangs in the balance.

As you exit the ride, the carnival owner and the mayor are present and extending their undying gratitude for saving the day, not to mention lives!

*** You have won! ***

Wow, you've received 150 points out of a possible 150 in 264 moves! I'm very proud of you. This was a triumph. I'm being so sincere right now.

You have received points for the following: 

•  Taking the blueberries: 5 points.
•  Eating the blueberries: 5 points.
•  Finding the coins and keys: 5 points.
•  Taking the lantern: 10 points.
•  Wearing the sheer veil: 5 points.
•  Winning the Swiss Army knife: 10 points.
•  Taking the Mercury dime: 5 points.
•  Winning the stuffed monkey: 5 points.
•  Winning the Crimson fuse: 10 points.
•  Buying the Hell Ride ticket: 10 points.
•  Finding the Dark Passage: 5 points.
•  Finding the Control Room: 5 points.
•  Turning off the big switch: 10 points.
•  Bringing the wrench to the Bumper Cars: 5 points.
•  Acquiring the Emerald fuse: 5 points.
•  Acquiring the Khaki fuse: 5 points.
•  Acquiring the Indigo fuse: 5 points.
•  Acquiring the Gray fuse: 5 points.
•  Acquiring the Aqua fuse: 5 points.
•  Flipping the Aqua switch: 5 points.
•  Flipping the Crimson switch: 5 points.
•  Flipping the Emerald switch: 5 points.
•  Flipping the Gray switch: 5 points.
•  Flipping the Indigo switch: 5 points.
•  Flipping the Khaki switch: 5 points.

Would you like to RESTART, RESTORE a saved game, QUIT, or UNDO the last command?

* * *

I beg your pardon?

>read sign
You can't see any such thing.

>s
Ticket Booth
The ticket kiosk stands at the carnival entrance, a compact booth painted in bright red and yellow stripes with bold letters above the window reading "Tickets Here!" Twinkling lights outline its edges, blinking rhythmically to draw attention.

A single window serves visitors, where a smiling cashier dispenses colorful tickets from neatly arranged rolls. Beside the tickets, a cash drawer jingles as change is counted, and a digital payment system glows faintly for modern convenience. Too bad you don't have a debit card.

Next to the kiosk, a vibrant signboard lists ticket prices with playful illustrations of rides and treats. Pennant flags flutter from the kiosk's roof, adding to the festive atmosphere, while the smell of popcorn and fried dough wafts from the southwest.

The worn ground around the kiosk shows the passage of eager carnival-goers. Families, couples, and friends form a buzzing line, their excitement building as they approach this first step into the magic of the carnival.

The midway continues in all directions from here. There is a cashier here. The prices of ride tickets are on the signboard. The cashier has Hell Ride ticket, Fortune Teller ticket, Ferris Wheel ticket, Bumper Cars ticket, and Carousel ticket.

You can see a ticket kiosk and a cashier here.

>read sign
$3.00 Hell Ride ticket
$3.00 Fortune Teller ticket
$2.00 Ferris Wheel ticket
$2.00 Bumper Cars ticket
$1.00 Carousel ticket

>sw
Concession Stand
The concession stand, perched along the midway, is a colorful and bustling hub. Painted in bright reds, blues, and yellows, it features bold lettering announcing treats like "SODA! POPCORN! CANDY APPLES!" Strings of twinkling lights frame the stand, making it a glowing beacon amid the carnival excitement.

Behind the counter, a popcorn machine churns out golden kernels, filling the air with a buttery aroma. Candy apples gleam under the lights, and cotton candy machines spin fluffy clouds of pink and blue. Warm pretzels sit under a heat lamp, their buttery, salted scent mingling with the sugary treats. A cooler holds sodas, their colorful labels visible through the frosted glass.

The counter is lively with stacks of paper bags, napkins, and cups of cheese and sugar sprinkles. A handwritten chalkboard menu lists prices in playful lettering. Workers in colorful aprons quickly hand out snacks, their movements efficient amid the cheerful chaos.

In front of the stand, kids tug at their parents, teens share pretzels, and the crowd buzzes with energy. More than just a snack stop, the stand is a sensory delight, adding flavor and charm to the carnival experience.

There is a menu to the right of the window. You can see the treats inside the stand. There is an exit to the northeast.

You can see a menu, a soda can of Cola, bubblegum, a bucket of popcorn, a candy apple, cotton candy, and a soft pretzel here.

>read sign
$2.00 soda can
$2.50 bucket of popcorn
$1.50 candy apple
$1.50 cotton candy
$1.50 soft pretzel
$1.00 bubblegum

>read menu
$2.00 soda can
$2.50 bucket of popcorn
$1.50 candy apple
$1.50 cotton candy
$1.50 soft pretzel
$1.00 bubblegum

>examine menu
$2.00 soda can
$2.50 bucket of popcorn
$1.50 candy apple
$1.50 cotton candy
$1.50 soft pretzel
$1.00 bubblegum

>look at menu
$2.00 soda can
$2.50 bucket of popcorn
$1.50 candy apple
$1.50 cotton candy
$1.50 soft pretzel
$1.00 bubblegum

>ne
Ticket Booth
You can see a ticket kiosk and a cashier here.

>read sign
$3.00 Hell Ride ticket
$3.00 Fortune Teller ticket
$2.00 Ferris Wheel ticket
$2.00 Bumper Cars ticket
$1.00 Carousel ticket

>look at sign
$3.00 Hell Ride ticket
$3.00 Fortune Teller ticket
$2.00 Ferris Wheel ticket
$2.00 Bumper Cars ticket
$1.00 Carousel ticket

>x sign
$3.00 Hell Ride ticket
$3.00 Fortune Teller ticket
$2.00 Ferris Wheel ticket
$2.00 Bumper Cars ticket
$1.00 Carousel ticket

* * *

>s
Ticket Booth
The ticket kiosk stands at the carnival entrance, a compact booth painted in bright red and yellow stripes with bold letters above the window reading "Tickets Here!" Twinkling lights outline its edges, blinking rhythmically to draw attention.

A single window serves visitors, where a smiling cashier dispenses colorful tickets from neatly arranged rolls. Beside the tickets, a cash drawer jingles as change is counted, and a digital payment system glows faintly for modern convenience. Too bad you don't have a debit card.

Next to the kiosk, a vibrant signboard lists ticket prices with playful illustrations of rides and treats. Pennant flags flutter from the kiosk's roof, adding to the festive atmosphere, while the smell of popcorn and fried dough wafts from the southwest.

The worn ground around the kiosk shows the passage of eager carnival-goers. Families, couples, and friends form a buzzing line, their excitement building as they approach this first step into the magic of the carnival.

The midway continues in all directions from here. There is a cashier here. The prices of ride tickets are on the signboard. The cashier has Hell Ride ticket, Fortune Teller ticket, Ferris Wheel ticket, Bumper Cars ticket, and Carousel ticket.

You can see a ticket kiosk and a cashier here.

>buy hell ride
(the Hell Ride ticket)
You fork over $3.00 for the Hell Ride ticket, leaving yourself with $24.00.

[Your score has just gone up by ten points.]

>s
Head of the Line
You are standing in front of a ticket taker with his hand open waiting for your ticket. The entrance to the ride is south of here. The ride operator tells you that you're lucky you showed up when you did because this will be the last trip through Hell Ride for the night. You notice that all the other cars are empty. The Ticket Kiosk is back the way you came.

You can see a Hell Ride attendant here.

>give hell ride ticket
(to the Hell Ride attendant)
You give the Hell Ride ticket to the Hell Ride attendant.

>s
Ride Entrance
The cars that will take you into the fearsome Hell Ride stop here for you to board and then move forward, the safety bar locked in place, as the entrance to Hell Ride looms ahead - a grotesque facade of twisted metal and carved wood, illuminated by flickering blood-red lights. The air carries a faint sulfuric tang mingled with the sweet aroma of carnival popcorn.

A towering archway of flames, spikes, and grinning skulls frames the entrance, crowned by flickering letters that read "HELL RIDE", pulsing like a heartbeat. Below, crouching demon sculptures extend clawed hands in a sinister invitation. Wooden doors cover the entrance, whispering with faint, menacing chuckles as distorted organ music grows louder, punctuated by shrieks and grinding machinery.

Inside, near-total darkness is broken by flashes of sickly green light revealing twisted paths and grotesque shapes. Beyond the threshold lies only uncertainty and terror.

You can see a Hell Ride car (empty) here.

>s
You can't go that way.

>s
You can't go that way.

>e
Dark Passage
This room is backstage at the Hell Ride attraction. The room is littered with bags of trash, piles of junk, and dust bunnies so large they should be paying rent. West is back the way you came from. There an exit to the south.

[Your score has just gone up by five points.]

* * *

>get flashlight
Taken.

[Your score has just gone up by ten points.]

>sturn it on
I didn't understand that sentence.

>turn it on
You flip a switch. A strong, narrow beam of light shines from the lit flashlight.

* * *

>push switch
You switch the big switch off.

[Your score has just gone up by ten points.]

>e
Dark Hallway
Nearby a ladder leads down to the Maintenance Office.

* * *

>ne
Electrical Closet One
This is Electrical Closet One. There's an electrical panel here and an exit to the south west.

You can see a silver key here.

>get key
Taken.

>w
You can't go that way.

>s
You can't go that way.

>sw
Electrical Room

* * *

>n
Guillotine Room
The public square buzzes with tense anticipation, a crowd gathered under gray skies that cast a somber light on the cobblestones. At the center, a stark wooden platform looms, its purpose grim and unavoidable.

A lone figure stands on the scaffold, bound hands behind their back and head bowed low, avoiding the crowd's gaze. Their tattered clothing, once fine, reflects the fall that led them to this moment.

The crowd encircles the platform, emotions ranging from jeers and curses to silent, grim observation. Children sit on shoulders, their curious eyes unaware of the event's gravity. Near the edge of the platform, the town crier proclaims the crime: "High treason against the crown. Let this be a warning to all who defy the realm!"

The condemned flinches but remains silent as the executioner - a hooded figure in black - stands ready beside the guillotine, its blade gleaming faintly in the dim light. The murmurs of the crowd fall into silence at the executioner's signal, leaving only the rustle of wind and the creak of the scaffold.

As the condemned approaches the guillotine, a crow caws sharply from a nearby rooftop, its cry echoing through the square like an omen. The crowd leans forward, breath held, as justice and mortality converge on the scene.

There is just one problem: the guillotine is being raised and lowered by some mechanism. It appears that the timing of the guillotine is off and it is being lowered onto the cars instead of between them. If a person were to be in a car as it passed under the guillotine, they would be decapitated. 

Nearby an indigo colored door leads east to the Generator Room.

You can also see a guillotine platform here.

>n
Dungeon
The dungeon is a dark, suffocating chamber carved into the earth, its stone walls slick with moisture and grime. The air reeks of sweat, blood, mildew, and burning oil from flickering torches mounted on rusted sconces. Shadows twist on the walls, creating grotesque, unsettling shapes in the dim light.

Chains hang from walls and ceilings, their faint clinking blending with the moans and occasional screams of prisoners. Water drips rhythmically from a cracked ceiling, adding to the chamber's eerie ambiance.

The room is littered with instruments of torment: a splintered rack, a glowing brazier holding bloodstained tools, and a spiked chair gleaming faintly in the light. Prisoners endure their own horrors - one stretched on the rack, another hanging limply from manacles, and a third gasping weakly in the spiked chair.

The hooded torturer moves with detached precision, their leather apron stained with the evidence of countless victims. They work silently, indifferent to the agony surrounding them.

Above, rats scuttle in the shadows, and the low ceiling presses down like the weight of despair. The sole exit, a riveted iron-bound door, feels more like a barrier to hope than a path to freedom.

This is a realm of suffering and hopelessness, where life and death blur, and torment is the only certainty.

Nearby a gray colored door leads east to the Mechanical Room South.

>n
Stake Room
The public square is steeped in grim silence, broken only by the crackling of flames. At its center, three wooden stakes rise from a pyre of logs and kindling, darkened by smoke from past executions. Bound to the stakes are three women, their faces reflecting defiance, resignation, and terror.

A crowd encircles the scene, expressions ranging from morbid fascination to righteous fury. Children cling to their mothers, while elders nod solemnly. Some jeer and throw stones; others murmur prayers or avert their gaze.

The executioner, hooded and clad in a leather apron, steps forward with a blazing torch, igniting the pyre in a sudden roar. Flames climb rapidly as thick smoke coils upward. The condemned cry out, their voices mingling with the crackle of fire. The oppressive heat radiates outward, pressing against the silent, uneasy crowd.

Gray clouds loom overhead, nature's somber backdrop to the grim spectacle. A raven caws from the bell tower as slow church bells toll, each strike punctuating the tragedy. As the pyre burns, some onlookers remain transfixed while others quietly slip away, the square heavy with ash, smoke, and the echoes of the condemned.

Nearby an emerald colored door leads east to the Mechanical Room North.

You can also see a pyre here.

* * *

>n
Stocks Room
The public square is a cobblestone expanse bordered by weathered timber-framed buildings. The air carries the mingling scents of chimney smoke, damp earth, and the faint tang of a nearby smithy. At its center, crude wooden stocks stand as a grim focal point, their beams weathered and stained from years of use. Iron clasps lock captives in degrading postures, their tattered clothing offering little protection from the biting wind.

The animatronics and wax figures are extremely life like. Hell Ride sure lives up to its name.

The punished individuals hang their heads in shame, their faces etched with despair. Around them, the crowd revels in cruelty - a wiry man spits insults with gleeful laughter, while a stout woman throws overripe vegetables, each impact sparking jeers. Even children join in, pointing and mocking with mischievous delight.

The square hums with noise: the crowd's taunts, the crack of objects hitting wood, and the quiet murmurs of the suffering captives. Overhead, a gray sky threatens rain, indifferent to the spectacle below. The jeering mob ignores its ominous weight, too engrossed in their shared cruelty to notice nature's disapproval.

Nearby an aqua colored door leads east to the Maintenance Office.

You can also see a wooden stocks here.

>n
Ride Entrance
You can see a Hell Ride car (empty) here.

>s
You can't go that way.

>n
Head of the Line
You can see a Hell Ride attendant here.

>w
You can't go that way.

>n
Ticket Booth
You can see a ticket kiosk and a cashier here.

>w
Show Facade
You head west through the midway, the bright lights of the carnival fading behind you as you approach a wooden booth. A sign above the entrance reads "Little Egypt Show - A Journey Into the Mysterious and Exotic!" A rotund barker, wearing a fez and a dazzling smile, gestures to a small sign beside him that says "Dime Admission."  The Ticket Kiosk is back the way you came.

You are standing in front of a dark and mysterious tent filled with illusions and exotic performers. Perhaps there's a fortune teller inside, offering cryptic clues about your journey or a hidden artifact that can be collected. There is a stage in front of the tent. The Barker is encouraging you to step up, pay for, and enjoy the Little Egypt Show.

You can see a Barker here.

The barker cries:

Ladies and gentlemen, boys and girls, gather 'round! 
Step right up and witness the spectacle that's taken the world by storm! 
She walks, she talks, she crawls on her belly like a reptile. 
Behold the one, the only Little Egypt, performing her legendary Dance of the Pyramids - a dazzling display of mystery, grace, and exotic allure! 
For just a dime, a mere one tenth of a dollar, prepare to be transported to the sands of Cairo, where enchantment and wonder await!

* * *

>sit in chair
You get onto the folding chair.

>z
Time passes.

* * *

>z
Time passes.

In the dimly lit tent, you see that the stage is decorated to resemble an exotic Middle Eastern market or palace, featuring rich, colorful fabrics, brass ornaments, and lanterns casting a warm, flickering glow. Scents of incense waft through the air, enhancing the atmosphere of mystique. The backdrop displays painted scenes of pyramids, desert landscapes, and domed structures evoking a sense of being transported to the "Middle East".

>kiss little egypt
You're much too entranced by the show to do anything other than watch the show. You are riveted!

Little Egypt emerges draped in flowing silk veils which she skillfully uses as part of the dance. Her attire consists of a sparkling, sequined bodice and a flowing skirt, adorned with jingling coin belts and jewelry that accentuate her movements.

>restart
Are you sure you want to restart?

>y
The carnival is in town and you and your sweetie had a date to visit it. After dinner and just as you arrive at the carnival, you and your date have a terrible fight. They storm off leaving you alone. You decide to stay at the carnival anyway.

Hell Ride
The ride of a lifetime... by No Shoes
Release 122 / Serial number 250119 / Inform 7 v10.1.2 / D

Parking Lot
The carnival parking lot stretches across an open field, its gravel crunching under arriving cars. Temporary floodlights and the carnival's colorful glow light the area, while distant laughter, music, and the hum of rides fill the air.

Cars park haphazardly, guided by makeshift signs and fluttering flags. Families unload strollers and blankets, their chatter mixing with the carnival sounds. Others linger in vehicles, preparing for the chilly evening.

Shadows from nearby trees create dark pockets pierced by the occasional flashlight. Near the entrance, an attendant collects fees at a weathered booth, coins jingling in the cash box.

Puddles from recent rain shimmer with reflected lights, while patches of mud cling to unwary shoes. At the far end, RVs and trailers sit quietly, their occupants watching the Ferris wheel spin lazily against the sky.

Alive with anticipation, the parking lot marks the transition from the ordinary to the magic of the carnival.

The midway is to the south. There is a blueberry bush here. There are blueberries on the bush.

Your car is here. It's a bit of a beater. Inside the car, you can see the seat, the ignition, the dashboard, and the glove box.

You can see a parking attendant here.

The attendant has a parking ticket. The price of a parking ticket is $5.00.

* * *

>buy mallet
You fork over $2.00 for the mallet, leaving yourself with $25.00.

>hit bullseye with mallet
You lift the mallet high and bring it down on the lever with all your might! The striker rises towards the bell stopping at "Getting Stronger".  C'mon! You can do better than that!

>g
You lift the mallet high and bring it down on the lever with all your might! The striker rises towards the bell stopping at "Average".  C'mon! You can do better than that!

>g
You lift the mallet high and bring it down on the lever with all your might! The striker rises towards the bell stopping at "Getting Stronger".  C'mon! You can do better than that!

>g
You lift the mallet high and bring it down on the lever with all your might! The striker rises towards the bell stopping at "Almost There".  C'mon! You can do better than that!

>g
You lift the mallet high and bring it down on the lever with all your might! The striker rises towards the bell stopping at "Getting Stronger".  C'mon! You can do better than that!

You swing the mallet one more time. The bell rings as the striker reaches the top of the pole. The attendant says, "You're a Muscle Man. Here's a prize for you."
Which prize would you like? 1) a teddy bear, 2) a Swiss Army knife, 3) a poster of Taylor Swift, 4) a magenta fuse?

* * *

>2
You are now holding a Swiss Army knife.

[Your score has just gone up by ten points.]

>look
High Striker
This area features a tall, eye-catching machine adorned with bright, colorful lights, typically red, yellow, and blue. A large sign at the top reads "Test Your Strength!" in bold, playful lettering. The machine's base is made of polished wood, with a polished, vintage appearance. At the center is a sturdy metal pole, with a large bell hanging at the top, signaling when a successful attempt has been made. Along the length of the pole are markings indicating how strong you are.  A nearby sign says, "Buy a mallet, strike the bell, win a prize."

Spectators gather around, cheering on participants and offering lighthearted jabs and encouragement, creating a lively, competitive atmosphere. The sound of the mallet hitting the target is followed by the resonant clang of the bell (if struck), alongside the buzz of carnival music in the background. The Ticket Kiosk is back the way you came and other games are northeast and northwest of here. The Ferris Wheel lies to the east.

You can see a Strongman attendant and a lever here.

[Your score has just gone up by ten points.]

>ne
Dime Toss Game
The game booth is adorned with vibrant colors - red-and-white striped awnings, twinkling lights, and eye-catching signage that reads "TOSS A DIME - WIN A PRIZE!". You can see prizes of all shapes and sizes hang around the booth, from stuffed animals and novelty toys to shiny trinkets and quirky collectibles. The larger prizes are prominently displayed to entice passersby. Rows of gleaming plates sparkle under overhead lights, their glass surfaces reflecting the surrounding glow.

The distinctive "ping" of dimes hitting plates creates a rhythmic soundtrack, punctuated by the occasional satisfying "plop" when a dime lands perfectly. Victorious shouts mix with playful groans of near-misses, creating a symphony of excitement. Nearby, the hum of other booths, upbeat carnival music, and the distant laughter of children add to the lively backdrop. The booth operator calls out enthusiastically, "Step right up! Test your skill! Win big!" Their energetic pitch draws in curious onlookers. You thought you caught a flash of something coming from the area of the booth.

You're surprised to see that this game only costs a dime.

You can see a Dime Toss attendant and a plate here.

>flip dime on plate
(the dime on the plate)
You toss the dime. Like skipping a stone in water, the dime skitters off the plate.

>g
(the dime on the plate)
You toss the dime. Like skipping a stone in water, the dime skitters off the plate.

>g
(the dime on the plate)
You toss the dime. The dime hits the plate, starts to spins, and lands in the center of the plate. The attendant shouts out, "Winner! Winner! Which prize would you like? 1) a stuffed monkey, 2) an orange fuse, 3) a poster of Billie Eilish, 4) a small pocket mirror?

>1
You are now holding a stuffed monkey.

* * *

>l at sign
It's a sign displaying the prices of the various ride tickets

>read sign
It's a sign displaying the prices of the various ride tickets

>shjow prices
I didn't understand that sentence.

>show prices
You can't see any such thing.

>show sign
(to the cashier)
(first taking the signboard)
That's hardly portable.

* * *

>read sign
It's a sign display the prices of the various concession items for sale.

>l at sign
It's a sign display the prices of the various concession items for sale.

>show sign
(to yourself)
(first taking the menu)
That's fixed in place.

* * *

>test misc
(Testing.)

>[1] brief
Hell Ride is now in its "brief" printing mode, which gives long descriptions of places never before visited and short descriptions otherwise.

>[2] xyzzy
A  hollow voice says "Plugh".

>[3] plugh
Nothing happens.

>[4] hello sailor
Nothing happens here.

>[5] please get the dime
Please do not say "please."

>[6] i
You are carrying:
  a soft pretzel
  cotton candy
  a candy apple
  a bucket of popcorn
  an empty can
  a Hell Ride ticket
  a crimson colored fuse
  two baseballs
  a small plush monkey
  a Swiss Army knife
  a mallet
  a lit lantern (providing light)
  a sheer veil (being worn)
  an air freshener
  a pair of gloves (being worn)
  a nickel
  three quarters
  a dime
  a parking ticket
  a wallet
    $7.00 in cash

>[7] score
Wow, you've received 70 points out of a possible 150 in 122 moves! I'm very proud of you. This was a triumph. I'm being so sincere right now.

You have received points for the following: 

•  Taking the blueberries: 5 points.
•  Eating the blueberries: 5 points.
•  Finding the coins and keys: 5 points.
•  Taking the lantern: 10 points.
•  Wearing the sheer veil: 5 points.
•  Winning the Swiss Army knife: 10 points.
•  Taking the Mercury dime: 5 points.
•  Winning the stuffed monkey: 5 points.
•  Winning the Crimson fuse: 10 points.
•  Buying the Hell Ride ticket: 10 points.

* * *

>s. l
Ticket Booth
The ticket kiosk stands at the carnival entrance, a compact booth painted in bright red and yellow stripes with bold letters above the window reading "Tickets Here!" Twinkling lights outline its edges, blinking rhythmically to draw attention.

A single window serves visitors, where a smiling cashier dispenses colorful tickets from neatly arranged rolls. Beside the tickets, a cash drawer jingles as change is counted, and a digital payment system glows faintly for modern convenience. Too bad you don't have a debit card.

Next to the kiosk, a vibrant signboard lists ticket prices with playful illustrations of rides and treats. Pennant flags flutter from the kiosk's roof, adding to the festive atmosphere, while the smell of popcorn and fried dough wafts from the southwest.

The worn ground around the kiosk shows the passage of eager carnival-goers. Families, couples, and friends form a buzzing line, their excitement building as they approach this first step into the magic of the carnival.

The midway continues in all directions from here. There is a cashier here. The prices of ride tickets are on the signboard. The cashier has Hell Ride ticket, Fortune Teller ticket, Ferris Wheel ticket, Bumper Cars ticket, and Carousel ticket.

You can see a ticket kiosk and a cashier here.

Ticket Booth
The ticket kiosk stands at the carnival entrance, a compact booth painted in bright red and yellow stripes with bold letters above the window reading "Tickets Here!" Twinkling lights outline its edges, blinking rhythmically to draw attention.

A single window serves visitors, where a smiling cashier dispenses colorful tickets from neatly arranged rolls. Beside the tickets, a cash drawer jingles as change is counted, and a digital payment system glows faintly for modern convenience. Too bad you don't have a debit card.

Next to the kiosk, a vibrant signboard lists ticket prices with playful illustrations of rides and treats. Pennant flags flutter from the kiosk's roof, adding to the festive atmosphere, while the smell of popcorn and fried dough wafts from the southwest.

The worn ground around the kiosk shows the passage of eager carnival-goers. Families, couples, and friends form a buzzing line, their excitement building as they approach this first step into the magic of the carnival.

The midway continues in all directions from here. There is a cashier here. The prices of ride tickets are on the signboard. The cashier has Hell Ride ticket, Fortune Teller ticket, Ferris Wheel ticket, Bumper Cars ticket, and Carousel ticket.

You can see a ticket kiosk and a cashier here.

* * *

>l
Ticket Booth
The ticket kiosk stands at the carnival entrance, a compact booth painted in bright red and yellow stripes with bold letters above the window reading "Tickets Here!" Twinkling lights outline its edges, blinking rhythmically to draw attention.

A single window serves visitors, where a smiling cashier dispenses colorful tickets from neatly arranged rolls. Beside the tickets, a cash drawer jingles as change is counted, and a digital payment system glows faintly for modern convenience. Too bad you don't have a debit card.

Next to the kiosk, a vibrant signboard lists ticket prices with playful illustrations of rides and treats. Pennant flags flutter from the kiosk's roof, adding to the festive atmosphere, while the smell of popcorn and fried dough wafts from the southwest.

The worn ground around the kiosk shows the passage of eager carnival-goers. Families, couples, and friends form a buzzing line, their excitement building as they approach this first step into the magic of the carnival.

The midway continues in all directions from here. There is a cashier here. The prices of ride tickets are on the signboard. The cashier has Hell Ride ticket, Fortune Teller ticket, Ferris Wheel ticket, Bumper Cars ticket, and Carousel ticket.

You can see a ticket kiosk and a cashier here.