wallet has no description.
$15.00 in cash has no description.
Sailor has no description.
blueberry bush has no description.
screwdriver has no description.
Little Eygpt has no description.
toolbox has no description.
monkey wrench has no description.
channel locks has no description.
pliers has no description.
hammer has no description.
drawer has no description.

The carnival is in town and you had a date with your sweetie to visit it. After dinner and just as you arrive at the carnival, you and your date have a terrible fight. They storm off leaving you alone at the carnival. You decide to stay at the carnival anyway.

The midway is bustling with activity-lights flashing, the sounds of carnival music, and the laughter of children mix with the occasional shrill scream of a roller coaster. Various attractions line the street, promising thrills, challenges, and wonders.

Hell Ride
The ride of a lifetime... by No Shoes
Release 1 / Serial number 241203 / Inform 7 v10.1.2 / D

Parking Lot
You are in a parking lot full of cars. The midway is to the south. There is a blueberry bush here. There are blueberries on the bush

You can see a dime here.

>e
You can't go that way.

>test b
(Testing.)

>[1] s

Kiosk
You are standing in line at a kiosk at the carnival. The kiosk sells tickets to the Hell Ride attraction. The line for the ride forms to the south and the midway continues east and west from here. There is a concession stand to the south west. The kiosk is garishly painted in purple and green sparkles. There is a cashier here. The Cashier has a Hell Ride ticket.

You can see a Cashier here.

>[2] buy ticket
You fork over $2.50 for the Hell Ride ticket, leaving yourself with $12.50.

>[3] s

Head of the Line
You are standing in front of a ticket taker with his hand open waiting for your ticket. The entrance to the ride is south of here.

You can see a Ride Attendent here.

>[4] give ticket to attendent
You give the Hell Ride ticket to the Ride Attendent.

>[5] s

Ride Entrance
The cars that will take you into the fearsome Hell Ride stop here for you to board.  To the south is the track that will take you into the ride. The safety bar is raised allowing you to enter the car. East of here the darkness looks just a little bit darker.

You can see a car (empty) here.

>[6] e
Walking in the darkness with your arms extended you nearly fall through an open doorway.

Backstage Entrance
This room is backstage at the Hell Ride attraction. The room is littered with bags of trash, piles of junk, and dust bunnies so large they should be paying rent. West is back the way you came from. There an exit to the south.

[Your score has just gone up by five points.]

>[7] get all
flashlight: Taken.

>[8] turn on flashlight
You flip a switch. A strong, narrow beam of light shines from the flashlight.

>[9] s

Maintenance Office
This appears to be the maintenance office, There is a desk here.

You can see a desk here.

>[10] s

Crawl Space
This crawl space is extremely small. You begin to feel claustrophobic in here.

>[11] s

Mechanical Room North
There is machinery filling the room.

>[12] s

Mechanical Room South
There is machinery filling the room.

>[13] s

Generator Room
There are two massive generators here powering the ride.

>[14] s

Electrical Room
This room is oozing with electromagnetic energy. You can feel your hair stand on end and all your nerves twitching. This feels dangerous! There are exits in all directions.

>n
Maintenance Office
This appears to be the maintenance office, There is a desk here.

You can see a desk here.

>n
Backstage Entrance
This room is backstage at the Hell Ride attraction. The room is littered with bags of trash, piles of junk, and dust bunnies so large they should be paying rent. West is back the way you came from. There an exit to the south.

>s
Maintenance Office
This appears to be the maintenance office, There is a desk here.

You can see a desk here.

>s
Crawl Space
This crawl space is extremely small. You begin to feel claustrophobic in here.

>s
Mechanical Room North
There is machinery filling the room.

>l
Mechanical Room North
There is machinery filling the room.

>get toolbox
You can't see any such thing.

* * *

>l
Parking Lot
You are in a parking lot full of cars. The midway is to the south. There is a blueberry bush here. There are blueberries on the bush

You can see a dime here.

* * *

>s
Kiosk
You are standing in line at a kiosk at the carnival. The kiosk sells tickets to the Hell Ride attraction. The line for the ride forms to the south and the midway continues east and west from here. There is a concession stand to the south west. The kiosk is garishly painted in purple and green sparkles. There is a cashier here. The Cashier has a Hell Ride ticket.

You can see a Cashier here.

>s
Head of the Line
You are standing in front of a ticket taker with his hand open waiting for your ticket. The entrance to the ride is south of here.

You can see a Ride Attendent here.

>n
Kiosk
You are standing in line at a kiosk at the carnival. The kiosk sells tickets to the Hell Ride attraction. The line for the ride forms to the south and the midway continues east and west from here. There is a concession stand to the south west. The kiosk is garishly painted in purple and green sparkles. There is a cashier here. The Cashier has a Hell Ride ticket.

You can see a Cashier here.

>buy ticket
You fork over $2.50 for the Hell Ride ticket, leaving yourself with $12.50.

>s
Head of the Line
You are standing in front of a ticket taker with his hand open waiting for your ticket. The entrance to the ride is south of here.

You can see a Ride Attendent here.

>give ticket to ride
(the Ride Attendent)
You give the Hell Ride ticket to the Ride Attendent.

>s
Ride Entrance
The cars that will take you into the fearsome Hell Ride stop here for you to board.  To the south is the track that will take you into the ride. The safety bar is raised allowing you to enter the car. East of here the darkness looks just a little bit darker.

You can see a car (empty) here.

* * *

>s
Head of the Line
You are standing in front of a ticket taker with his hand open waiting for your ticket. The entrance to the ride is south of here.

You can see a Ride Attendent here.

>s
You'll need a ticket to go that way.

>e
You can't go that way.

>s
You'll need a ticket to go that way.

>n
Kiosk
You are standing in line at a kiosk at the carnival. The kiosk sells tickets to the Hell Ride attraction. The line for the ride forms to the south and the midway continues east and west from here. There is a concession stand to the south west. The kiosk is garishly painted in purple and green sparkles. There is a cashier here. The Cashier has a Hell Ride ticket.

You can see a Cashier here.

* * *

>s
Head of the Line
You are standing in front of a ticket taker with his hand open waiting for your ticket. The entrance to the ride is south of here.

You can see a Ride Attendent here.

>give ticket
(to the Ride Attendent)
You give the Hell Ride ticket to the Ride Attendent.

>s
Ride Entrance
The cars that will take you into the fearsome Hell Ride stop here for you to board.  To the south is the track that will take you into the ride. The safety bar is raised allowing you to enter the car. East of here the darkness looks just a little bit darker.

You can see a car (empty) here.

>e
Walking in the darkness with your arms extended you nearly fall through an open doorway.

Backstage Entrance
This room is backstage at the Hell Ride attraction. The room is littered with bags of trash, piles of junk, and dust bunnies so large they should be paying rent. West is back the way you came from. There an exit to the south.

[Your score has just gone up by five points.]

>s
Darkness
It is pitch dark, and you can't see a thing.

>s
Darkness
It is pitch dark, and you can't see a thing.

>n
Darkness
It is pitch dark, and you can't see a thing.

>n
Darkness
It is pitch dark, and you can't see a thing.

>n
Backstage Entrance
This room is backstage at the Hell Ride attraction. The room is littered with bags of trash, piles of junk, and dust bunnies so large they should be paying rent. West is back the way you came from. There an exit to the south.

>l at bunnies
You can't see any such thing.

>l at trash
You can't see any such thing.

>l at bags
You can't see any such thing.

>l at piles
In the corner is a pile of junk.

In the pile of junk is a flashlight.

You find a flashlight here.

>get flashlight
Taken.

>turn it on
You flip a switch. A strong, narrow beam of light shines from the flashlight.

>s
Maintenance Office
This appears to be the maintenance office, There is a desk here.

You can see a desk here.

* * *

>s
Crawl Space
This crawl space is extremely small. You begin to feel claustrophobic in here.

>s
Mechanical Room North
There is machinery filling the room.

You can see a toolbox (closed) here.

>open toolbox
You open the toolbox, revealing a monkey wrench, channel locks, pliers, and a hammer.

>get hammer
Taken.

>look at it
You see nothing special about the hammer.

* * *

>test b
(Testing.)

>[1] s

Kiosk
You are standing in line at a kiosk at the carnival. The kiosk sells tickets to the Hell Ride attraction. The line for the ride forms to the south and the midway continues east and west from here. There is a concession stand to the south west. The kiosk is garishly painted in purple and green sparkles. There is a cashier here. The Cashier has a Hell Ride ticket.

You can see a Cashier here.

>[2] buy ticket
You fork over $2.50 for the Hell Ride ticket, leaving yourself with $12.50.

>[3] s

Head of the Line
You are standing in front of a ticket taker with his hand open waiting for your ticket. The entrance to the ride is south of here.

You can see a Ride Attendent here.

>[4] give ticket to attendent
You give the Hell Ride ticket to the Ride Attendent.

>[5] s

Ride Entrance
The cars that will take you into the fearsome Hell Ride stop here for you to board.  To the south is the track that will take you into the ride. The safety bar is raised allowing you to enter the car. East of here the darkness looks just a little bit darker.

You can see a car (empty) here.

>[6] e

Backstage Entrance
This room is backstage at the Hell Ride attraction. The room is littered with bags of trash, piles of junk, and dust bunnies so large they should be paying rent. West is back the way you came from. There an exit to the south.

>[7] get all
flashlight: Taken.

>[8] turn on flashlight
You flip a switch. A strong, narrow beam of light shines from the flashlight.

>[9] s

Maintenance Office
This appears to be the maintenance office, There is a desk here.

You can see a desk here.

>[10] s

Crawl Space
This crawl space is extremely small. You begin to feel claustrophobic in here.

>[11] s

Mechanical Room North
There is machinery filling the room.

>[12] s

Mechanical Room South
There is machinery filling the room.

>[13] s

Generator Room
There are two massive generators here powering the ride.

>[14] s

Electrical Room
This room is oozing with electromagnetic energy. You can feel your hair stand on end and all your nerves twitching. This feels dangerous! There are exits in all directions.

>i
You are carrying:
  a lit flashlight (providing light)
  a wallet
    $12.50 in cash

* * *

>l
Maintenance Office
This appears to be the maintenance office, There is a desk here.

You can see a desk here.

* * *

>ne
Electrical Closet One
You are in a section of the electrical room. There is an electrical panel here. There is an exit to the south west.

You can see a key here.

>l at panel
This is a standard issue 200 amp electrical panel supplying 220 power throughout the ride. The electrical panel is closed.

>open panel
You open electrical panel.

* * *

>nw
Electrical Closet Eleven
You are in a section of the electrical room. There is an exit to the south east.

>get all
There are none at all available!

>l at panel
This is a standard issue 200 amp electrical panel supplying 220 power throughout the ride. The electrical panel is closed.

* * *

>nw
Electrical Closet Eleven
You are in a section of the electrical room. There is an exit to the south east.

>l
Electrical Closet Eleven
You are in a section of the electrical room. There is an exit to the south east.

>showme
Electrical Closet Eleven - room
    Sailor - man
    yourself - person
        lit flashlight - electric lamp
        wallet - open container
            $12.50 in cash
    Electrical Panel Eleven - closed container

>l at panel
You see nothing special about Electrical Panel Eleven.

>open panel
You open Electrical Panel Eleven.

>l in panel;
You can't see any such thing.

>l in panel
Electrical Panel Eleven is empty.

* * *

>nw
Electrical Closet Eleven
You are in a section of the electrical room. There is an exit to the south east.

>l at panel
This is a standard issue 200 amp electrical panel supplying 220 power throughout the ride. The electrical panel is closed.

>open pane;
You can't see any such thing.

>open panel
You open Electrical Panel Eleven.

* * *

>l at panel
This is a standard issue 200 amp electrical panel supplying 220 power throughout the ride. The electrical panel is closed.

>open panel
You open Electrical Panel Eleven.

>se
Electrical Room South
This room is oozing with electromagnetic energy. You can feel your hair stand on end and all your nerves twitching. This feels dangerous!

>e
Electrical Closet Three
You are in a section of the electrical room. There is an exit to the west.

>l at panel
This is a standard issue 200 amp electrical panel supplying 220 power throughout the ride. The electrical panel is closed.

* * *

>s
Crawl Space
This crawl space is extremely small. You begin to feel claustrophobic in here.

* * *

>s
Mechanical Room North
There is machinery filling the room.

>s
Mechanical Room South
There is machinery filling the room.

>s
Electrical Room North
There is machinery filling the room.

>s
Electrical Room South
This room is oozing with electromagnetic energy. You can feel your hair stand on end and all your nerves twitching. This feels dangerous!

>nw
Electrical Closet Eleven
You are in a section of the electrical room. There is an exit to the south east.

>l at panel
You can't see any such thing.

>show me
What do you want to show yourself?

>showme
Electrical Closet Eleven - room
    Sailor - man
    yourself - person
        lit flashlight - electric lamp
        wallet - open container
            $12.50 in cash

* * *

>test bn
>--> The following tests are available:
'test misc'
'test me'
'test concession'
'test striker'
'test egypt'
'test ride'
'test b'
'test backstage'

>n
Maintenance Office
This appears to be the maintenance office, There is a desk here.

You can see a desk here.

* * *

>n
Backstage Entrance
This room is backstage at the Hell Ride attraction. The room is littered with bags of trash, piles of junk, and dust bunnies so large they should be paying rent. West is back the way you came from. There an exit to the south.

>n
You can't go that way.

>w
Ride Entrance
The cars that will take you into the fearsome Hell Ride stop here for you to board.  To the south is the track that will take you into the ride. The safety bar is raised allowing you to enter the car. East of here the darkness looks just a little bit darker.

You can see a car (empty) here.

>e
Backstage Entrance
This room is backstage at the Hell Ride attraction. The room is littered with bags of trash, piles of junk, and dust bunnies so large they should be paying rent. West is back the way you came from. There an exit to the south.

>restart
Are you sure you want to restart?

>y
wallet has no description.
$15.00 in cash has no description.
Sailor has no description.
blueberry bush has no description.
screwdriver has no description.
Little Eygpt has no description.
drawer has no description.
toolbox has no description.
monkey wrench has no description.
channel locks has no description.
pliers has no description.
hammer has no description.

The carnival is in town and you had a date with your sweetie to visit it. After dinner and just as you arrive at the carnival, you and your date have a terrible fight. They storm off leaving you alone at the carnival. You decide to stay at the carnival anyway.

The midway is bustling with activity-lights flashing, the sounds of carnival music, and the laughter of children mix with the occasional shrill scream of a roller coaster. Various attractions line the street, promising thrills, challenges, and wonders.

Hell Ride
The ride of a lifetime... by No Shoes
Release 1 / Serial number 241203 / Inform 7 v10.1.2 / D

Parking Lot
You are in a parking lot full of cars. The midway is to the south. There is a blueberry bush here. There are blueberries on the bush

You can see a dime here.

>s
Kiosk
You are standing in line at a kiosk at the carnival. The kiosk sells tickets to the Hell Ride attraction. The line for the ride forms to the south and the midway continues east and west from here. There is a concession stand to the south west. The kiosk is garishly painted in purple and green sparkles. There is a cashier here. The Cashier has a Hell Ride ticket.

You can see a Cashier here.

* * *

>s
Head of the Line
You are standing in front of a ticket taker with his hand open waiting for your ticket. The entrance to the ride is south of here.

You can see a Ride Attendent here.

>give ride
What do you want to give the Ride Attendent?

>ticket
(to the Ride Attendent)
You give the Hell Ride ticket to the Ride Attendent.

>e
You can't go that way.

>s
Ride Entrance
The cars that will take you into the fearsome Hell Ride stop here for you to board.  To the south is the track that will take you into the ride. The safety bar is raised allowing you to enter the car. East of here the darkness looks just a little bit darker.

You can see a car (empty) here.

>e
Backstage Entrance
This room is backstage at the Hell Ride attraction. The room is littered with bags of trash, piles of junk, and dust bunnies so large they should be paying rent. West is back the way you came from. There an exit to the south.

* * *

>test concession
(Testing.)

>[1] get blueberries
Good Job!

[Your score has just gone up by five points.]

>[2] s

Kiosk
You are standing in line at a kiosk at the carnival. The kiosk sells tickets to the Hell Ride attraction. The line for the ride forms to the south and the midway continues east and west from here. There is a concession stand to the south west. The kiosk is garishly painted in purple and green sparkles. There is a cashier here. The Cashier has a Hell Ride ticket.

You can see a Cashier here.

>[3] sw

Concession Stand
You are standing in front of a brightly lit Concession Stand. There is a menu to the right of the window. You can see the treats inside the stand.

You can see a menu, a can of Cola, a bucket of popcorn, a candy apple, Cotton candy, and a soft pretzel here.

>[4] l at treats
There are a variety of things to eat here.

>[5] read menu

$1.00 Cola 
$2.50 Popcorn 
$1.50 Candy Apple 
$1.50 Cotton Candy 
$1.50 Soft Pretzel

>[6] buy cola
You fork over $1.00 for the can of Cola, leaving yourself with $14.00.

>[7] buy popcorn
You fork over $2.50 for the bucket of popcorn, leaving yourself with $11.50.

>[8] buy candy apple
You fork over $1.50 for the candy apple, leaving yourself with $10.00.

>[9] buy cotton candy
You fork over $1.50 for Cotton candy, leaving yourself with $8.50.

>[10] buy pretzel
You fork over $1.50 for the soft pretzel, leaving yourself with $7.00.

>[11] inventory
You are carrying:
  a soft pretzel
  Cotton candy
  a candy apple
  a bucket of popcorn
  a can of Cola
  blueberries
  a wallet
    $7.00 in cash

>[12] drink soda
You gulp down some Cola.

>[13] g
You gulp down some Cola.

>[14] g
You gulp down some Cola.

>[15] g
You gulp down some Cola.

>[16] g
You tip the can again only to find it empty.

>[17] i
You are carrying:
  a soft pretzel
  Cotton candy
  a candy apple
  a bucket of popcorn
  an empty can
  blueberries
  a wallet
    $7.00 in cash

>[18] ne

Kiosk
You are standing in line at a kiosk at the carnival. The kiosk sells tickets to the Hell Ride attraction. The line for the ride forms to the south and the midway continues east and west from here. There is a concession stand to the south west. The kiosk is garishly painted in purple and green sparkles. There is a cashier here. The Cashier has a Hell Ride ticket.

You can see a Cashier here.

>[19] n

Parking Lot
You are in a parking lot full of cars. The midway is to the south. There is a blueberry bush here. The bush has been picked clean.

You can see a dime here.

* * *

>test misc
(Testing.)

>[1] get blueberries
Good Job!

[Your score has just gone up by five points.]

>[2] xyzzy
A voice nearby says "Plugh".

>[3] hello sailor
Nothing happens here.

>[4] please get the dime
Please do not say please.