The carnival is in town and you and your sweetie had a date to visit it. After dinner and just as you arrive at the carnival, you and your date have a terrible fight. They storm off leaving you alone at the carnival. You decide to stay at the carnival anyway.

Hell Ride
The ride of a lifetime... by No Shoes
Release 105 / Serial number 241212 / Inform 7 v10.1.2 / D

Parking Lot
The carnival parking lot stretches across an open field, its gravel crunching under arriving cars. Temporary floodlights and the carnival"s colorful glow light the area, while distant laughter, music, and the hum of rides fill the air.

Cars park haphazardly, guided by makeshift signs and fluttering flags. Families unload strollers and blankets, their chatter mixing with the carnival sounds. Others linger in vehicles, preparing for the chilly evening.

Shadows from nearby trees create dark pockets pierced by the occasional flashlight. Near the entrance, an attendant collects fees at a weathered booth, coins jingling in the cash box.

Puddles from recent rain shimmer with reflected lights, while patches of mud cling to unwary shoes. At the far end, RVs and trailers sit quietly, their occupants watching the Ferris wheel spin lazily against the sky.

Alive with anticipation, the parking lot marks the transition from the ordinary to the magic of the carnival.

The midway is to the south. There is a blueberry bush here. There are blueberries on the bush.

You can see a Parking Attendant and a beater car (empty) here.

>help
> Introduction to Hell Ride
   Instructions for Play

>[enter]
Hell Ride - A Ride to remember...

In the early 1980"s, I had an Apple II Plus computer with 64K of RAM, dual 5.25" floppy disks, and a color monitor as big as a television. And the very first game I ever bought was Infocom's Zork I: The Great Underground Empire. This was cool. It was all text-based. The game described your surroundings and you interacted with commands that say what you wanted to do. This "Interactive Fiction" really evoked in a game what I appreciated most about reading: rich descriptions, colorful characters, and the like. After Zork I, there was Zork II and III. Enchanter, Moonmist, Suspect, and so many more. I played them all with my best friend Andy.

Andy and I were software developers at the time and we thought, "We can do this!" So we set out to do this. We developed a game engine with a natural language parser And it was pretty good. We could support most of the kinds of things they did, certainly less graceful but pretty good. In fact, our parser was better than theirs in a case where the sentence was ambiguous. e.g. "Walk into the room with the lamp." Is the player carrying the lamp? Or is the lamp in the room?

For fun, we reverse engineered parts of Infocom's game format. We found the dictionary, certain text tokens use for text substitution, the game text. We also discovered the first example of compression I had ever seen and it just about made my head explode. They stored all ASCII characters in five bits! Pow! Mind blown. I had never considered anything like that. Just another hook.

We developed two prototypes: Diner and Hell Ride. Diner was about bank robbers coming into the diner where you are a short order cook and have to save the day. Hell Ride was pretty close to what you find here. I decided to implement it using modern tools. It's pretty good.

I hope you enjoy it,

d.

Please press SPACE to continue.

* * *

>push indigo button
The monitor flickers for a second and the scene it displays changes to something different.
The monitor now shows a tableau of a guillotine. It has stopped rising and falling over the ride exit. The ride is safe again!
The indigo indicator is now on.

    *** You have won! ***

In that game you scored 100 out of a possible 100, in 185 turns.

Would you like to RESTART, RESTORE a saved game, QUIT, or UNDO the last command?

* * *

>test misc
(Testing.)

>[1] brief
Hell Ride is now in its "brief" printing mode, which gives long descriptions of places never before visited and short descriptions otherwise.

>[2] get blueberries
Good Job!

[Your score has just gone up by five points.]

>[3] xyzzy
A voice nearby says "Plugh".

>[4] hello sailor
Nothing happens here.

>[5] please get the dime
Please do not say please.

>[6] i
You are carrying:
  blueberries
  a wallet
    $20.00 in cash
    a coupon

>[7] score
You have so far scored 5 out of a possible 100, in 5 turns.

* * *

>test parking
(Testing.)

>[1] brief
Hell Ride is now in its "brief" printing mode, which gives long descriptions of places never before visited and short descriptions otherwise.

>[2] get blueberries
Good Job!

[Your score has just gone up by five points.]

>[3] give coupon to attendant
(first taking the coupon)
Given. The price of a parking ticket is now $3.00.

>[4] buy ticket
The attendant says, "Don't forget to leave the parking stub on your dashboard".

You fork over $3.00 for the parking ticket, leaving yourself with $17.00.

>[5] get in car
(the beater car)
You get into the beater car.

>[6] l under seat
You find the keys and the dime!
Taken.

[Your score has just gone up by five points.]

>[7] open glove box
(first unlocking the glove box)
(with the keys)
You open the glove box, revealing a gloves.

>[8] get gloves
Taken.

>[9] wear gloves
You put on the gloves.

>[10] put stub on the dashboard
You put the parking stub on the dashboard.

>[11] l at the dashboard
It looks like you could set something there.

On the dashboard is a parking stub.

>[12] s
You have to exit your car first.

>[13] exit
You get out of the beater car.

Parking Lot
You can see a Parking Attendant and a beater car (empty) here.

>test grues
(Testing.)

>[1] s

The ticket kiosk stands at the carnival entrance, a compact booth painted in bright red and yellow stripes with bold letters above the window reading "Tickets Here!" Twinkling lights outline its edges, blinking rhythmically to draw attention.

A single window serves visitors, where a smiling attendant dispenses colorful tickets from neatly arranged rolls. Beside the tickets, a cash drawer jingles as change is counted, and a digital payment system glows faintly for modern convenience.

Next to the kiosk, a vibrant signboard lists ticket prices with playful illustrations of rides and treats. Pennant flags flutter from the kiosk's roof, adding to the festive atmosphere, while the smell of popcorn and fried dough wafts from nearby stalls.

The worn ground around the kiosk shows the passage of eager carnival-goers. Families, couples, and friends form a buzzing line, their excitement building as they approach this first step into the magic of the carnival.

The midway continues east and west from here. There is a concession stand to the south west. There is a cashier here. The Cashier has a Hell Ride ticket. The price of a ticket is $3.00.
>[2] buy hell ride ticket
You fork over $3.00 for the Hell Ride ticket, leaving yourself with $14.00.

>[3] s

Head of the Line
You are standing in front of a ticket taker with his hand open waiting for your ticket. The entrance to the ride is south of here. The ride attendant tells you that you're lucky you showed up when you did because this will be the last trip through Hell Ride. You notice that all the other cars are empty.

You can see a Ride Attendant here.

>[4] give hell ride ticket to ride attendant
You give the Hell Ride ticket to the Ride Attendant.

>[5] s

Ride Entrance
The cars that will take you into the fearsome Hell Ride stop here for you to board.  To the south is the track that will take you into the ride. The safety bar is raised allowing you to enter the car. The darkness looks just a little bit darker.

You can see a Hell Ride car (empty) here.

>[6] e

Dark Passage
This room is backstage at the Hell Ride attraction. The room is littered with bags of trash, piles of junk, and dust bunnies so large they should be paying rent. West is back the way you came from. There an exit to the south.

[Your score has just gone up by five points.]

>[7] s

Darkness
It is pitch black.  You are likely to be eaten by a grue.

>[8] s
Oh no! You walked directly into the slavering fangs of a lurking grue!

    *** You have died! ***

In that game you scored 15 out of a possible 100, in 20 turns.

Would you like to RESTART, RESTORE a saved game, QUIT, or UNDO the last command?

* * *

>push indigo button
The monitor flickers for a second and the scene it displays changes to something different.
The monitor now shows a tableau of a guillotine. It has stopped rising and falling over the ride exit. The ride is safe again!
The indigo indicator is now on.

    *** You have won! ***

In that game you scored 95 out of a possible 100, in 145 turns.

Would you like to RESTART, RESTORE a saved game, QUIT, or UNDO the last command?