The carnival is in town and you had a date with your sweetie to visit it. After dinner and just as you arrive at the carnival, you and your date have a terrible fight. They storm off leaving you alone at the carnival. You decide to stay at the carnival anyway.

The midway is bustling with activity-lights flashing, the sounds of carnival music, and the laughter of children mix with the occasional shrill scream of a roller coaster. Various attractions line the street, promising thrills, challenges, and wonders.

Hell Ride
The ride of a lifetime... by No Shoes
Release 1 / Serial number 241203 / Inform 7 v10.1.2 / D

Parking Lot
You are in a parking lot full of cars. The midway is to the south. There is a blueberry bush here. There are blueberries on the bush

You can see a dime here.

>l
Parking Lot
You are in a parking lot full of cars. The midway is to the south. There is a blueberry bush here. There are blueberries on the bush

You can see a dime here.

* * *

>test concession
(Testing.)

>[1] get blueberries
Good Job!

[Your score has just gone up by five points.]

>[2] s

Kiosk
You are standing in line at a kiosk at the carnival. The kiosk sells tickets to the Hell Ride attraction. The line for the ride forms to the south and the midway continues east and west from here. There is a concession stand to the south west. The kiosk is garishly painted in purple and green sparkles. There is a cashier here. The Cashier has a Hell Ride ticket.

You can see a Cashier here.

>[3] sw

Concession Stand
You are standing in front of a brightly lit Concession Stand. There is a menu to the right of the window. You can see the treats inside the stand.

You can see a menu, a can of Cola, a bucket of popcorn, a candy apple, Cotton candy, and a soft pretzel here.

>[4] l at treats
There are a variety of things to eat here.

>[5] read menu

$1.00 Cola 
$2.50 Popcorn 
$1.50 Candy Apple 
$1.50 Cotton Candy 
$1.50 Soft Pretzel

>[6] buy cola
You fork over $1.00 for the can of Cola, leaving yourself with $14.00.

>[7] buy popcorn
You fork over $2.50 for the bucket of popcorn, leaving yourself with $11.50.

>[8] buy candy apple
You fork over $1.50 for the candy apple, leaving yourself with $10.00.

>[9] buy cotton candy
You fork over $1.50 for Cotton candy, leaving yourself with $8.50.

>[10] buy pretzel
You fork over $1.50 for the soft pretzel, leaving yourself with $7.00.

>[11] inventory
You are carrying:
  a soft pretzel
  Cotton candy
  a candy apple
  a bucket of popcorn
  a can of Cola
  blueberries
  a wallet
    $7.00 in cash

>[12] drink soda
You gulp down some Cola.

>[13] g
You gulp down some Cola.

>[14] g
You gulp down some Cola.

>[15] g
You gulp down some Cola.

>[16] g
You tip the can again only to find it empty.

>[17] i
You are carrying:
  a soft pretzel
  Cotton candy
  a candy apple
  a bucket of popcorn
  an empty can
  blueberries
  a wallet
    $7.00 in cash

>[18] ne

Kiosk
You are standing in line at a kiosk at the carnival. The kiosk sells tickets to the Hell Ride attraction. The line for the ride forms to the south and the midway continues east and west from here. There is a concession stand to the south west. The kiosk is garishly painted in purple and green sparkles. There is a cashier here. The Cashier has a Hell Ride ticket.

You can see a Cashier here.

>[19] n

Parking Lot
You are in a parking lot full of cars. The midway is to the south. There is a blueberry bush here. The bush has been picked clean.

You can see a dime here.

* * *

>test misc
(Testing.)

>[1] get blueberries
Good Job!

[Your score has just gone up by five points.]

>[2] xyzzy
A voice nearby says "Plugh".

>[3] hello sailor
Nothing happens here.

>[4] please get the dime
Please do not say please.