wallet has no description.
$15.00 in cash has no description.
Sailor has no description.
blueberry bush has no description.
screwdriver has no description.
Little Eygpt has no description.
drawer has no description.

The carnival is in town and you had a date with your sweetie to visit it. After dinner and just as you arrive at the carnival, you and your date have a terrible fight. They storm off leaving you alone at the carnival. You decide to stay at the carnival anyway.

The midway is bustling with activity-lights flashing, the sounds of carnival music, and the laughter of children mix with the occasional shrill scream of a roller coaster. Various attractions line the street, promising thrills, challenges, and wonders.

Hell Ride
The ride of a lifetime... by No Shoes
Release 1 / Serial number 241203 / Inform 7 v10.1.2 / D

Parking Lot
You are in a parking lot full of cars. The midway is to the south. There is a blueberry bush here. There are blueberries on the bush

You can see a dime here.

>l
Parking Lot
You are in a parking lot full of cars. The midway is to the south. There is a blueberry bush here. There are blueberries on the bush

You can see a dime here.

>l
Parking Lot
You are in a parking lot full of cars. The midway is to the south. There is a blueberry bush here. There are blueberries on the bush

You can see a dime here.

>s
Kiosk
You are standing in line at a kiosk at the carnival. The kiosk sells tickets to the Hell Ride attraction. The line for the ride forms to the south and the midway continues east and west from here. There is a concession stand to the south west. The kiosk is garishly painted in purple and green sparkles. There is a cashier here. The Cashier has a Hell Ride ticket.

You can see a Cashier here.

>n
Parking Lot
You are in a parking lot full of cars. The midway is to the south. There is a blueberry bush here. There are blueberries on the bush

You can see a dime here.

>look
Parking Lot
You are in a parking lot full of cars. The midway is to the south. There is a blueberry bush here. There are blueberries on the bush

You can see a dime here.

>test b
(Testing.)

>[1] s

Kiosk
You are standing in line at a kiosk at the carnival. The kiosk sells tickets to the Hell Ride attraction. The line for the ride forms to the south and the midway continues east and west from here. There is a concession stand to the south west. The kiosk is garishly painted in purple and green sparkles. There is a cashier here. The Cashier has a Hell Ride ticket.

You can see a Cashier here.

>[2] buy ticket
You fork over $2.50 for the Hell Ride ticket, leaving yourself with $12.50.

>[3] s

Head of the Line
You are standing in front of a ticket taker with his hand open waiting for your ticket. The entrance to the ride is south of here.

You can see a Ride Attendent here.

>[4] give ticket to attendent
You give the Hell Ride ticket to the Ride Attendent.

>[5] s

Ride Entrance
The cars that will take you into the fearsome Hell Ride stop here for you to board.  To the south is the track that will take you into the ride. The safety bar is raised allowing you to enter the car. East of here the darkness looks just a little bit darker.

You can see a car (empty) here.

>[6] e

Backstage Entrance
This room is backstage at the Hell Ride attraction. West is back the way you came from. There an exit to the south. There is a pile of junk in the corner.

>[7] get all
flashlight: Taken.

>[8] turn on flashlight
You flip a switch. A strong, narrow beam of light shines from the flashlight.

>[9] s

Maintenance Office
This appears to be the maintenance office, There is a desk here.

You can see a desk here.

>l at desk
It's a desk. There are coffee stains and cigarette burns from years of abuse. The single drawer is shut.

>open drawer
You open the drawer.

>l in drawer
The drawer is empty.

>l
Maintenance Office
This appears to be the maintenance office, There is a desk here.

You can see a desk here.

>i
You are carrying:
  a lit flashlight (providing light)
  a wallet
    $12.50 in cash

>put flashlight in drawer
You put the lit flashlight into the drawer.

>l
Maintenance Office
This appears to be the maintenance office, There is a desk here.

You can see a desk here.

>l at desk
It's a desk. There are coffee stains and cigarette burns from years of abuse. The single drawer is open.

>l at drawer
In the drawer is a lit flashlight.

>turn off flashlight
You switch the flashlight off.

It is now pitch dark in here!

>turn off flashlight
You can't see any such thing.

>turn on flashlight
You can't see any such thing.

>i
You are carrying:
  a wallet
    $12.50 in cash

>get flashlight from drawer
You can't see any such thing.

>restart
Are you sure you want to restart?

>y
wallet has no description.
$15.00 in cash has no description.
Sailor has no description.
blueberry bush has no description.
screwdriver has no description.
Little Eygpt has no description.
drawer has no description.

The carnival is in town and you had a date with your sweetie to visit it. After dinner and just as you arrive at the carnival, you and your date have a terrible fight. They storm off leaving you alone at the carnival. You decide to stay at the carnival anyway.

The midway is bustling with activity-lights flashing, the sounds of carnival music, and the laughter of children mix with the occasional shrill scream of a roller coaster. Various attractions line the street, promising thrills, challenges, and wonders.

Hell Ride
The ride of a lifetime... by No Shoes
Release 1 / Serial number 241203 / Inform 7 v10.1.2 / D

Parking Lot
You are in a parking lot full of cars. The midway is to the south. There is a blueberry bush here. There are blueberries on the bush

You can see a dime here.

>s
Kiosk
You are standing in line at a kiosk at the carnival. The kiosk sells tickets to the Hell Ride attraction. The line for the ride forms to the south and the midway continues east and west from here. There is a concession stand to the south west. The kiosk is garishly painted in purple and green sparkles. There is a cashier here. The Cashier has a Hell Ride ticket.

You can see a Cashier here.

* * *

>n
Parking Lot
You are in a parking lot full of cars. The midway is to the south. There is a blueberry bush here. There are blueberries on the bush

You can see a dime here.

>get dime
Taken.

>s
Kiosk
You are standing in line at a kiosk at the carnival. The kiosk sells tickets to the Hell Ride attraction. The line for the ride forms to the south and the midway continues east and west from here. There is a concession stand to the south west. The kiosk is garishly painted in purple and green sparkles. There is a cashier here. The Cashier has a Hell Ride ticket.

You can see a Cashier here.

>w
Show Facade
You head west through the midway, the bright lights of the carnival fading behind you as you approach a wooden booth. A sign above the entrance reads "Little Egypt Show - A Journey Into the Mysterious and Exotic!" A rotund attendent, wearing a fez and a dazzling smile, gestures to a small sign beside him that says "Dime Admission."

 You are standing in front of a dark and mysterious tent filled with illusions and exotic performers. Perhaps there's a fortune teller inside, offering cryptic clues about the player's journey or a hidden artifact that can be collected. There is a stage in front of the tent. The Barker is encouraging you to step up, pay for, and enjoy the Little Egypt Show.The barker cries: 

Ladies and gentlemen, boys and girls, gather "round! 
Step right up and witness the spectacle that's taken the world by storm! 
She walks, she talks, she crawls on her belly like a reptile. 
Behold the one, the only Little Egypt, performing her legendary Dance of the Pyramids-a dazzling display of mystery, grace, and exotic allure! 
For just a dime, a mere one tenth of a dollar, prepare to be transported to the sands of Cairo, where enchantment and wonder await!

You can see a Barker here.

>give dime to barker
You hand over a dime, and the attendent nods, waving you through. As you step past the entrance, the air feels thicker, almost humid, and the sounds of the carnival fade away. You've entered an entirely different world now-one filled with the scents of incense and exotic spices, and the low, hypnotic music of a faraway land. Before you, a series of dimly lit tents stretch out, their flaps slightly swaying in the breeze. Intrigued, you take your first step into the Little Egypt Show. You can now head west into the show.

>w
Show Tent
You are inside the Little Egypt Show. The attraction facade is to the east. There is a folding chair should you want to sit down and wait for the show to start.

>sit down
I didn't understand that sentence.

>sit in chair
You're much to entranced to do anything other than watch the show. You are riveted!

As you enter the dimly lit tent, you see that the stage is decorated to resemble an exotic Middle Eastern market or palace, featuring rich, colorful fabrics, brass ornaments, and lanterns casting a warm, flickering glow. Scents of incense waft through the air, enhancing the atmosphere of mystique. The backdrop displays painted scenes of pyramids, desert landscapes, and domed structures to evoking a sense of being transported to the "Middle East".

>l at little egypt
Little Egypt is an exotic looking, beautiful woman who is draped in flowing silk veils which she skillfully uses as part of the dance. Her attire consists of a sparkling, sequined bodice and a flowing skirt, adorned with jingling coin belts and jewelry that accentuate her movements.

Little Egypt emerges draped in flowing silk veils which she skillfully uses as part of the dance. Her attire consists of a sparkling, sequined bodice and a flowing skirt, adorned with jingling coin belts and jewelry that accentuate her movements.

>e
You're much to entranced to do anything other than watch the show. You are riveted!

The performance begins with slow, undulating movements, drawing the you into the rhythm of exotic live music played on traditional instruments like the oud, darbuka, or zurna. As the tempo builds, her hips, torso, and hands move in intricate, mesmerizing patterns, demonstrating remarkable control and fluidity. She incorporates dramatic spins, drops, and shimmies, often accentuating the beat of the music with a quick jingle of her coin belt.

>e
You're much to entranced to do anything other than watch the show. You are riveted!

Little Egypt makes eye contact with you and smiles enigmatically. During her performance she balances a sword on her head and accents her dance with finger cymbals.

>e
You're much to entranced to do anything other than watch the show. You are riveted!

The music alternates between hauntingly slow melodies and rapid, energetic drum beats, creating an emotional arc that keeps the you entranced. Little Egypt relies on the music's dynamic changes to tell a story with movements reflecting joy, sorrow, seduction, and celebration.

>e
You're much to entranced to do anything other than watch the show. You are riveted!

The performance concludes with a dramatic flourish of a fast-paced shimmy, a bold spin, and Little Egypt dramatically casts off her veils. The dancer takes a bow to enthusiastic applause, leaving you spellbound by the sensual yet artful display.

You applaud until your hands are sore. Did she wink at me?

[Your score has just gone up by five points.]

>e
Show Facade
 You are standing in front of a dark and mysterious tent filled with illusions and exotic performers. Perhaps there's a fortune teller inside, offering cryptic clues about the player's journey or a hidden artifact that can be collected. There is a stage in front of the tent. The Barker is encouraging you to step up, pay for, and enjoy the Little Egypt Show.

You can see a Barker here.

>e
Kiosk
You are standing in line at a kiosk at the carnival. The kiosk sells tickets to the Hell Ride attraction. The line for the ride forms to the south and the midway continues east and west from here. There is a concession stand to the south west. The kiosk is garishly painted in purple and green sparkles. There is a cashier here. The Cashier has a Hell Ride ticket.

You can see a Cashier here.

>n
Parking Lot
You are in a parking lot full of cars. The midway is to the south. There is a blueberry bush here. There are blueberries on the bush

>test b
(Testing.)

>[1] s

Kiosk
You are standing in line at a kiosk at the carnival. The kiosk sells tickets to the Hell Ride attraction. The line for the ride forms to the south and the midway continues east and west from here. There is a concession stand to the south west. The kiosk is garishly painted in purple and green sparkles. There is a cashier here. The Cashier has a Hell Ride ticket.

You can see a Cashier here.

>[2] buy ticket
You fork over $2.50 for the Hell Ride ticket, leaving yourself with $12.50.

>[3] s

Head of the Line
You are standing in front of a ticket taker with his hand open waiting for your ticket. The entrance to the ride is south of here.

You can see a Ride Attendent here.

>[4] give ticket to attendent
You give the Hell Ride ticket to the Ride Attendent.

>[5] s

Ride Entrance
The cars that will take you into the fearsome Hell Ride stop here for you to board.  To the south is the track that will take you into the ride. The safety bar is raised allowing you to enter the car. East of here the darkness looks just a little bit darker.

You can see a car (empty) here.

>[6] e

Backstage Entrance
This room is backstage at the Hell Ride attraction. West is back the way you came from. There an exit to the south. There is a pile of junk in the corner.

>[7] get all
flashlight: Taken.

>[8] turn on flashlight
You flip a switch. A strong, narrow beam of light shines from the flashlight.

>[9] s

Maintenance Office
This appears to be the maintenance office, There is a desk here.

You can see a desk here.

* * *

>test b
(Testing.)

>[1] s

Kiosk
You are standing in line at a kiosk at the carnival. The kiosk sells tickets to the Hell Ride attraction. The line for the ride forms to the south and the midway continues east and west from here. There is a concession stand to the south west. The kiosk is garishly painted in purple and green sparkles. There is a cashier here. The Cashier has a Hell Ride ticket.

You can see a Cashier here.

>[2] buy ticket
You fork over $2.50 for the Hell Ride ticket, leaving yourself with $12.50.

>[3] s

Head of the Line
You are standing in front of a ticket taker with his hand open waiting for your ticket. The entrance to the ride is south of here.

You can see a Ride Attendent here.

>[4] give ticket to attendent
You give the Hell Ride ticket to the Ride Attendent.

>[5] s

Ride Entrance
The cars that will take you into the fearsome Hell Ride stop here for you to board.  To the south is the track that will take you into the ride. The safety bar is raised allowing you to enter the car. East of here the darkness looks just a little bit darker.

You can see a car (empty) here.

>[6] e

Backstage Entrance
This room is backstage at the Hell Ride attraction. West is back the way you came from. There an exit to the south. There is a pile of junk in the corner.

>[7] get all
flashlight: Taken.

>[8] turn on flashlight
You flip a switch. A strong, narrow beam of light shines from the flashlight.

>[9] s

Maintenance Office
This appears to be the maintenance office, There is a desk here.

You can see a desk here.

>e
You can't go that way.

>s
Spinner
This room is oozing with electromagnetic energy. You can feel your hair stand on end and all your nerves twitching. This feels dangerous!

>e
E Quadrant
You are in a section of the electrical room. There is an exit to the west.

>w
Spinner
This room is oozing with electromagnetic energy. You can feel your hair stand on end and all your nerves twitching. This feels dangerous!

>ne
NE Quadrant
You are in a section of the electrical room. There is an exit to the south west.

You can see a key here.

* * *

>l at desk
It's a desk. There are coffee stains and cigarette burns from years of abuse. The single drawer is shut.

>open drawer
You open the drawer, revealing a scissors, a stapler, a ballpoint pen, and a pad of paper.

>l at draer
You can't see any such thing.

>l at drawer
In the drawer are a scissors, a stapler, a ballpoint pen, and a pad of paper.

>get all
scissors: Taken.
stapler: Taken.
ballpoint pen: Taken.
pad of paper: Taken.

>i
You are carrying:
  a pad of paper
  a ballpoint pen
  a stapler
  a scissors
  a lit flashlight (providing light)
  a wallet
    $12.50 in cash

>s
Spinner
This room is oozing with electromagnetic energy. You can feel your hair stand on end and all your nerves twitching. This feels dangerous!

>ne
NE Quadrant
You are in a section of the electrical room. There is an exit to the south west.

You can see a key here.

>get key
Taken.

>sw
Spinner
This room is oozing with electromagnetic energy. You can feel your hair stand on end and all your nerves twitching. This feels dangerous!

* * *

>s
Crawl Space
This crawl space is extremely small. You begin to feel claustrophobic in here.

>s
Mechanical Room

>s
Spinner
This room is oozing with electromagnetic energy. You can feel your hair stand on end and all your nerves twitching. This feels dangerous!

>s
S Quadrant
You are in a section of the electrical room. There is an exit to the north.

>s
Electrical Panel

>s
You can't go that way.

>w
Ride Exit

>n
Guillotine Room
There is a guillotine in this room. The guillotine is being raised and lowered by some mechanism. It appears that the timing of the guillotine is off and it is being lowered onto the cars instead of between them. If a person were to be in a car as it passed under the guillotine, they would be decapitated.

>n
Dungeon
This a dungeon with all the usual devices. There is a man stretched on the rack. His screams pierce the room. An iron maiden is occupied and you notice the blood seeping from the eyes, ears, and mouth. Another is strapped to a Saint Andrew's Cross and is being flogged harshly.

>n
Stake Room
Here you see a bonfire in full conflagration. The flames leap higher and higher consuming the woman tied to the stake. The townsfolk are here holding torches and  jeering at the sight of the poor soul being burnt alive.

>n
Gallows Room
The next room is dominated by a gallows made of strong hardwood. Standing on the gallows is an executioner wearing a hood protecting his identity. Next to him is a man with a noose around his neck standing on a hatch ready to open.

>n
Stocks Room
You pass into a room which displays mannequins in stocks in a public square. The stocks are made of heavy wood. The townsfolk are there solely to harrass and ridicule the individuals on display. The punishee's eyes are downcast as the shame and humiliation of their predicaments are realized. The wax figures are especially life like.

>n
Ride Entrance
The cars that will take you into the fearsome Hell Ride stop here for you to board.  To the south is the track that will take you into the ride. The safety bar is raised allowing you to enter the car. East of here the darkness looks just a little bit darker.

You can see a car (empty) here.

>e
Backstage Entrance
This room is backstage at the Hell Ride attraction. West is back the way you came from. There an exit to the south. There is a pile of junk in the corner.

>s
Maintenance Office
This appears to be the maintenance office, There is a desk here.

You can see a desk here.

>w
Stocks Room
You pass into a room which displays mannequins in stocks in a public square. The stocks are made of heavy wood. The townsfolk are there solely to harrass and ridicule the individuals on display. The punishee's eyes are downcast as the shame and humiliation of their predicaments are realized. The wax figures are especially life like.

>e
Maintenance Office
This appears to be the maintenance office, There is a desk here.

You can see a desk here.

>s
Crawl Space
This crawl space is extremely small. You begin to feel claustrophobic in here.

>w
Gallows Room
The next room is dominated by a gallows made of strong hardwood. Standing on the gallows is an executioner wearing a hood protecting his identity. Next to him is a man with a noose around his neck standing on a hatch ready to open.

>e
Crawl Space
This crawl space is extremely small. You begin to feel claustrophobic in here.

>s
Mechanical Room

>w
Stake Room
Here you see a bonfire in full conflagration. The flames leap higher and higher consuming the woman tied to the stake. The townsfolk are here holding torches and  jeering at the sight of the poor soul being burnt alive.

>e
Mechanical Room

>s
Spinner
This room is oozing with electromagnetic energy. You can feel your hair stand on end and all your nerves twitching. This feels dangerous!

>w
W Quadrant
You are in a section of the electrical room. There is an exit to the east.

>e
Spinner
This room is oozing with electromagnetic energy. You can feel your hair stand on end and all your nerves twitching. This feels dangerous!

* * *

>test concession
(Testing.)

>[1] get blueberries
Good Job!

[Your score has just gone up by five points.]

>[2] s

Kiosk
You are standing in line at a kiosk at the carnival. The kiosk sells tickets to the Hell Ride attraction. The line for the ride forms to the south and the midway continues east and west from here. There is a concession stand to the south west. The kiosk is garishly painted in purple and green sparkles. There is a cashier here. The Cashier has a Hell Ride ticket.

You can see a Cashier here.

>[3] sw

Concession Stand
You are standing in front of a brightly lit Concession Stand. There is a menu to the right of the window. You can see the treats inside the stand.

You can see a menu, a can of Cola, a bucket of popcorn, a candy apple, Cotton candy, and a soft pretzel here.

>[4] l at treats
There are a variety of things to eat here.

>[5] read menu

$1.00 Cola 
$2.50 Popcorn 
$1.50 Candy Apple 
$1.50 Cotton Candy 
$1.50 Soft Pretzel

>[6] buy cola
You fork over $1.00 for the can of Cola, leaving yourself with $14.00.

>[7] buy popcorn
You fork over $2.50 for the bucket of popcorn, leaving yourself with $11.50.

>[8] buy candy apple
You fork over $1.50 for the candy apple, leaving yourself with $10.00.

>[9] buy cotton candy
You fork over $1.50 for Cotton candy, leaving yourself with $8.50.

>[10] buy pretzel
You fork over $1.50 for the soft pretzel, leaving yourself with $7.00.

>[11] inventory
You are carrying:
  a soft pretzel
  Cotton candy
  a candy apple
  a bucket of popcorn
  a can of Cola
  blueberries
  a wallet
    $7.00 in cash

>[12] drink soda
You gulp down some Cola.

>[13] g
You gulp down some Cola.

>[14] g
You gulp down some Cola.

>[15] g
You gulp down some Cola.

>[16] g
You tip the can again only to find it empty.

>[17] i
You are carrying:
  a soft pretzel
  Cotton candy
  a candy apple
  a bucket of popcorn
  an empty can
  blueberries
  a wallet
    $7.00 in cash

>[18] ne

Kiosk
You are standing in line at a kiosk at the carnival. The kiosk sells tickets to the Hell Ride attraction. The line for the ride forms to the south and the midway continues east and west from here. There is a concession stand to the south west. The kiosk is garishly painted in purple and green sparkles. There is a cashier here. The Cashier has a Hell Ride ticket.

You can see a Cashier here.

>[19] n

Parking Lot
You are in a parking lot full of cars. The midway is to the south. There is a blueberry bush here. The bush has been picked clean.

You can see a dime here.

* * *

>test misc
(Testing.)

>[1] get blueberries
Good Job!

[Your score has just gone up by five points.]

>[2] xyzzy
A voice nearby says "Plugh".

>[3] hello sailor
Nothing happens here.

>[4] please get the dime
Please do not say please.