wallet has no description.
$15.00 in cash has no description.
Sailor has no description.
blueberry bush has no description.
Little Eygpt has no description.
drawer has no description.

The carnival is in town and you had a date with your sweetie to visit it. After dinner and just as you arrive at the carnival, you and your date have a terrible fight. They storm off leaving you alone at the carnival. You decide to stay at the carnival anyway.

The midway is bustling with activity-lights flashing, the sounds of carnival music, and the laughter of children mix with the occasional shrill scream of a roller coaster. Various attractions line the street, promising thrills, challenges, and wonders.

Hell Ride
The ride of a lifetime... by No Shoes
Release 1 / Serial number 241202 / Inform 7 v10.1.2 / D

Parking Lot
You are in a parking lot full of cars. The midway is to the south. There is a blueberry bush here. There are blueberries on the bush

You can see a dime here.

>get all
dime: Taken.
blueberries: Good Job!

[Your score has just gone up by five points.]

>s
Kiosk
You are standing in line at a kiosk at the carnival. The booth sells tickets to the Hell Ride attraction. The line for the ride forms to the south and the midway continues east and west from here. There is a concession stand to the south west. The kiosk is garishly painted in purple and green sparkles. There is a Ticket Seller here. The Ticket Seller has a Hell Ride ticket.

* * *

>s
Kiosk
You are standing in line at a kiosk at the carnival. The kiosk sells tickets to the Hell Ride attraction. The line for the ride forms to the south and the midway continues east and west from here. There is a concession stand to the south west. The kiosk is garishly painted in purple and green sparkles. There is a cashier here. The Cashier has a Hell Ride ticket.

You can see a Cashier here.

>buy ticket
You fork over $2.50 for the Hell Ride ticket, leaving yourself with $12.50.

>s
Head of the Line
You are standing in front of a ticket taker with his hand open waiting for your ticket. The entrance to the ride is south of here.

You can see a Ride Attendant here.

>n
Kiosk
You are standing in line at a kiosk at the carnival. The kiosk sells tickets to the Hell Ride attraction. The line for the ride forms to the south and the midway continues east and west from here. There is a concession stand to the south west. The kiosk is garishly painted in purple and green sparkles. There is a cashier here. 

You can see a Cashier here.

>s
Head of the Line
You are standing in front of a ticket taker with his hand open waiting for your ticket. The entrance to the ride is south of here.

You can see a Ride Attendant here.

>l at attendant
This is another bored teenager. His thoughts are entirely focused on a cheeseburger for lunch.

* * *

>sneak
I didn't understand that sentence.

>s
The Ticket Booth
You are standing in line at a ticket booth at the carnival. The booth sells tickets to the Hell Ride attraction. The line for the ride forms to the south and the midway continues east and west from here. There is a concession stand to the south west. The ticket booth is garishly painted in purple and green sparkles. There is a Ticket Seller here. The Ticket Seller has a Hell Ride ticket.

You can see a Ticket Seller here.

>get all from seller
That seems to belong to the Ticket Seller.

>buy ticket
(the Ticket Seller)
The Ticket Seller is yours already.

>buy ride ticket
You fork over $2.50 for the Hell Ride ticket, leaving yourself with $12.50.

* * *

>test b
(Testing.)

>[1] s

Kiosk
You are standing in line at a kiosk at the carnival. The kiosk sells tickets to the Hell Ride attraction. The line for the ride forms to the south and the midway continues east and west from here. There is a concession stand to the south west. The kiosk is garishly painted in purple and green sparkles. There is a cashier here. The Cashier has a Hell Ride ticket.

You can see a Cashier here.

>[2] buy ticket
You fork over $2.50 for the Hell Ride ticket, leaving yourself with $12.50.

>[3] s

Head of the Line
You are standing in front of a ticket taker with his hand open waiting for your ticket. The entrance to the ride is south of here.

You can see a Ride Attendent here.

>[4] give ticket to attendent
You give the Hell Ride ticket to the Ride Attendent.

>[5] s

Ride Entrance
The cars that will take you into the fearsome Hell Ride stop here for you to board.  To the south is the track that will take you into the ride. The safety bar is raised allowing you to enter the car. East of here the darkness looks just a little bit darker.

You can see a car (empty) here.

>[6] e

Backstage Entrance
This room is backstage at the Hell Ride attraction. West is back the way you came from. There an exit to the south. There is a pile of junk in the corner.

>[7] get all
flashlight: Taken.

>[8] turn on flashlight
You flip a switch. A strong, narrow beam of light shines from the flashlight.

>[9] s

Maintenance Office
This appears to be the maintenance office, There is a desk here,

The desk appears to have a drawer.

>e
Darkness
It is pitch dark, and you can't see a thing.

>l
Darkness
It is pitch dark, and you can't see a thing.

>e
You can't go that way.

>s
You can't go that way.

>w
Ride Entrance
The cars that will take you into the fearsome Hell Ride stop here for you to board.  To the south is the track that will take you into the ride. The safety bar is raised allowing you to enter the car. East of here is a gate with a sign that reads "Employees Only".

You can see a car (empty) here.

>e
Darkness
It is pitch dark, and you can't see a thing.

>n
You can't go that way.

* * *

>l
Darkness
It is pitch dark, and you can't see a thing.

>r
I didn't understand that sentence.

>e
You can't go that way.

>w
You can't go that way.

* * *

>s
You can't go that way.

>n
Darkness
It is pitch dark, and you can't see a thing.

>e
You can't go that way.

>w
Ride Entrance
The cars that will take you into the fearsome Hell Ride stop here for you to board.  To the south is the track that will take you into the ride. The safety bar is raised allowing you to enter the car. East of here is a gate with a sign that reads "Employees Only".

You can see a car (empty) here.

* * *

>e
Darkness
It is pitch dark, and you can't see a thing.

>e
You can't go that way.

* * *

>e
Darkness
It is pitch dark, and you can't see a thing.

>s
Darkness
It is pitch dark, and you can't see a thing.

>s
You can't go that way.

* * *

>n
Backstage Entrance
This room is backstage at the Hell Ride attraction. West is back the way you came from. There an exit to the south. There is a pile of junk in the corner.

>examine pile of junk
You can't see any such thing.

>l
Backstage Entrance
This room is backstage at the Hell Ride attraction. West is back the way you came from. There an exit to the south. There is a pile of junk in the corner.

>w
Ride Entrance
The cars that will take you into the fearsome Hell Ride stop here for you to board.  To the south is the track that will take you into the ride. The safety bar is raised allowing you to enter the car. East of here the darkness looks just a little bit darker.

You can see a car (empty) here.

>e
Backstage Entrance
This room is backstage at the Hell Ride attraction. West is back the way you came from. There an exit to the south. There is a pile of junk in the corner.

>s
Darkness
It is pitch dark, and you can't see a thing.

>n
Backstage Entrance
This room is backstage at the Hell Ride attraction. West is back the way you came from. There an exit to the south. There is a pile of junk in the corner.

>l at junk
You can't see any such thing.

* * *

>n
Backstage Entrance
This room is backstage at the Hell Ride attraction. West is back the way you came from. There an exit to the south. There is a pile of junk in the corner.

>get all
flashlight: Taken.

>l
Backstage Entrance
This room is backstage at the Hell Ride attraction. West is back the way you came from. There an exit to the south. In the corner you see a discarded flashlight.

* * *

>get all
flashlight: Taken.

>s
Darkness
It is pitch dark, and you can't see a thing.

>turn on flashlight
It isn't something you can switch.

* * *

>n
Backstage Entrance
This room is backstage at the Hell Ride attraction. West is back the way you came from. There an exit to the south. There is a pile of junk in the corner.

>n
You can't go that way.

>e
You can't go that way.

>s
Darkness
It is pitch dark, and you can't see a thing.

* * *

>n
Backstage Entrance
This room is backstage at the Hell Ride attraction. West is back the way you came from. There an exit to the south. There is a pile of junk in the corner.

>w
Ride Entrance
The cars that will take you into the fearsome Hell Ride stop here for you to board.  To the south is the track that will take you into the ride. The safety bar is raised allowing you to enter the car. East of here the darkness looks just a little bit darker.

You can see a car (empty) here.

* * *

>e
Backstage Entrance
This room is backstage at the Hell Ride attraction. West is back the way you came from. There an exit to the south. There is a pile of junk in the corner.

>w
Ride Entrance
The cars that will take you into the fearsome Hell Ride stop here for you to board.  To the south is the track that will take you into the ride. The safety bar is raised allowing you to enter the car. East of here the darkness looks just a little bit darker.

You can see a car (empty) here.

>n
Head of the Line
You are standing in front of a ticket taker with his hand open waiting for your ticket. The entrance to the ride is south of here.

You can see a Ride Attendant here.

>l
Head of the Line
You are standing in front of a ticket taker with his hand open waiting for your ticket. The entrance to the ride is south of here.

You can see a Ride Attendant here.

* * *

>restaret
I didn't understand that sentence.

>restart
Are you sure you want to restart?

>yu
Please answer yes or no.

>y
wallet has no description.
$15.00 in cash has no description.
Sailor has no description.
blueberry bush has no description.
Little Eygpt has no description.
drawer has no description.

The carnival is in town and you had a date with your sweetie to visit it. After dinner and just as you arrive at the carnival, you and your date have a terrible fight. They storm off leaving you alone at the carnival. You decide to stay at the carnival anyway.

The midway is bustling with activity-lights flashing, the sounds of carnival music, and the laughter of children mix with the occasional shrill scream of a roller coaster. Various attractions line the street, promising thrills, challenges, and wonders.

Hell Ride
The ride of a lifetime... by No Shoes
Release 1 / Serial number 241202 / Inform 7 v10.1.2 / D

Parking Lot
You are in a parking lot full of cars. The midway is to the south. There is a blueberry bush here. There are blueberries on the bush

You can see a dime here.

>s
Kiosk
You are standing in line at a kiosk at the carnival. The kiosk sells tickets to the Hell Ride attraction. The line for the ride forms to the south and the midway continues east and west from here. There is a concession stand to the south west. The kiosk is garishly painted in purple and green sparkles. There is a cashier here. The Cashier has a Hell Ride ticket.

You can see a Cashier here.

* * *

>s
Head of the Line
You are standing in front of a ticket taker with his hand open waiting for your ticket. The entrance to the ride is south of here.

You can see a Ride Attendant here.

>give ticket to attendent
You can't see any such thing.

>give ticket to attendant
You give the Hell Ride ticket to the Ride Attendant.

>s
Ride Entrance
The cars that will take you into the fearsome Hell Ride stop here for you to board.  To the south is the track that will take you into the ride. The safety bar is raised allowing you to enter the car. East of here the darkness looks just a little bit darker.

You can see a car (empty) here.

>e
Backstage Entrance
This room is backstage at the Hell Ride attraction. West is back the way you came from. There an exit to the south. There is a pile of junk in the corner.

* * *

>s
You can't go that way.

>w
You can't go that way.

>e
You can't go that way.

>n
Backstage Entrance
This room is backstage at the Hell Ride attraction. West is back the way you came from. There an exit to the south. There is a pile of junk in the corner.

>search junk
In the pile of junk is a flashlight.

>get flashlight
Taken.

>turn on flashlight
You flip a switch. A strong, narrow beam of light shines from the flashlight.

>s
Maintenance Office
This appears to be the maintenance office, There is a desk here,

The desk appears to have a drawer.

>turn off flashlight
You switch the flashlight off.

It is now pitch dark in here!

>l
Darkness
It is pitch dark, and you can't see a thing.

>z
Time passes.

* * *

>s
You can't go that way.

* * *

>e
You can't go that way.

>n
Darkness
It is pitch dark, and you can't see a thing.

>s
Darkness
It is pitch dark, and you can't see a thing.

>l
Darkness
It is pitch dark, and you can't see a thing.

>get akk
You can't see any such thing.

>get all
There are none at all available!

>open drawer
You can't see any such thing.

* * *

>turn off light
You switch the flashlight off.

It is now pitch dark in here!

>s
You can't go that way.

>e
You can't go that way.

* * *

>turn off light
You switch the flashlight off.

It is now pitch dark in here!

>turn off flashlight
You switch the flashlight off.

It is now pitch dark in here!

* * *

>l
Darkness
It is pitch dark, and you can't see a thing.

>z
It's pitch black. You might be eaten by a grue!

>turn onm flashlight
You can't see any such thing.

>turn on flashlight
You flip a switch. A strong, narrow beam of light shines from the flashlight.

Maintenance Office
This appears to be the maintenance office, There is a desk here,

The desk appears to have a drawer.

>turn off flashlight
You switch the flashlight off.

It is now pitch dark in here!

>light flashlight
This dangerous act would achieve little.

* * *

>w
You can't go that way.

* * *

>e
You can't go that way.

>n
Backstage Entrance
This room is backstage at the Hell Ride attraction. There an exit to the south.

>s
Darkness
It is pitch dark, and you can't see a thing.

* * *

>test concession
(Testing.)

>[1] get blueberries
Good Job!

[Your score has just gone up by five points.]

>[2] s

The Ticket Booth
You are standing in line at a ticket booth at the carnival. The booth sells tickets to the Hell Ride attraction. The line for the ride forms to the south and the midway continues east and west from here. There is a concession stand to the south west. The ticket booth is garishly painted in purple and green sparkles. There is a Ticket Seller here. The Ticket Seller has a Hell Ride ticket.

You can see a Ticket Seller here.

>[3] sw

Concession Stand
You are standing in front of a brightly lit Concession Stand. There is a menu to the right of the window. You can see the treats inside the stand.

You can see a menu, a can of Cola, a bucket of popcorn, a candy apple, Cotton candy, and a soft pretzel here.

>[4] l at treats
There are a variety of things to eat here.

>[5] read menu

$1.00 Cola 
$2.50 Popcorn 
$1.50 Candy Apple 
$1.50 Cotton Candy 
$1.50 Soft Pretzel

>[6] buy cola
You fork over $1.00 for the can of Cola, leaving yourself with $14.00.

>[7] buy popcorn
You fork over $2.50 for the bucket of popcorn, leaving yourself with $11.50.

>[8] buy candy apple
You fork over $1.50 for the candy apple, leaving yourself with $10.00.

>[9] buy cotton candy
You fork over $1.50 for Cotton candy, leaving yourself with $8.50.

>[10] buy pretzel
You fork over $1.50 for the soft pretzel, leaving yourself with $7.00.

>[11] inventory
You are carrying:
  a soft pretzel
  Cotton candy
  a candy apple
  a bucket of popcorn
  a can of Cola
  blueberries
  a wallet
    $7.00 in cash

>[12] drink soda
You gulp down some Cola.

>[13] g
You gulp down some Cola.

>[14] g
You gulp down some Cola.

>[15] g
You gulp down some Cola.

>[16] g
You tip the can again only to find it empty.

>[17] i
You are carrying:
  a soft pretzel
  Cotton candy
  a candy apple
  a bucket of popcorn
  an empty can
  blueberries
  a wallet
    $7.00 in cash

>[18] ne

The Ticket Booth
You are standing in line at a ticket booth at the carnival. The booth sells tickets to the Hell Ride attraction. The line for the ride forms to the south and the midway continues east and west from here. There is a concession stand to the south west. The ticket booth is garishly painted in purple and green sparkles. There is a Ticket Seller here. The Ticket Seller has a Hell Ride ticket.

You can see a Ticket Seller here.

>[19] n

Parking Lot
You are in a parking lot full of cars. The midway is to the south. There is a blueberry bush here. The bush has been picked clean.

You can see a dime here.

* * *

>test misc
(Testing.)

>[1] get blueberries
Good Job!

[Your score has just gone up by five points.]

>[2] xyzzy
A voice nearby says "Plugh".

>[3] hello sailor
Nothing happens here.

>[4] please get the dime
Please do not say please.

* * *

>test s
(Testing.)

>[1] s

The Ticket Booth
You are standing in line at a ticket booth at the carnival. The booth sells tickets to the Hell Ride attraction. The line for the ride forms to the south and the midway continues east and west from here. There is a concession stand to the south west. The ticket booth is garishly painted in purple and green sparkles. There is a Ticket Seller here. The Ticket Seller has a Hell Ride ticket.

You can see a Ticket Seller here.

>[2] e

High Striker
This area features a tall, eye-catching machine adorned with bright, colorful lights, typically red, yellow, and blue. A large sign at the top reads "Test Your Strength!" in bold, playful lettering. The machine's base is made of polished wood, with a polished, vintage appearance. At the center is a sturdy metal pole, with a large bell hanging at the top, signaling when a successful attempt has been made. Along the length of the pole are markings indicating how strong you are.  A nearby sign says, "Buy a mallet, strike the bell, win a prize."

Spectators gather around, cheering on participants and offering lighthearted jabs and encouragement, creating a lively, competitive atmosphere. The sound of the mallet hitting the target is followed by the resonant clang of the bell (if struck), alongside the buzz of carnival music in the background.

You can see a Strongman Attendant and a lever here.

>[3] buy mallet
You fork over $2.00 for the mallet, leaving yourself with $13.00.

>[4] hit target with mallet
You lift the mallet high and bring it down on the lever with all your might! The striker rises towards the bell stopping at "Getting Stronger".  C'mon! You can do better than that!

>[5] g
You lift the mallet high and bring it down on the lever with all your might! The striker rises towards the bell stopping at "Getting Stronger".  C'mon! You can do better than that!

>[6] g
You lift the mallet high and bring it down on the lever with all your might! The striker rises towards the bell stopping at "Weakling".  C'mon! You can do better than that!

>[7] g
You lift the mallet high and bring it down on the lever with all your might! The striker rises towards the bell stopping at "Getting Stronger".  C'mon! You can do better than that!

>[8] g
You lift the mallet high and bring it down on the lever with all your might! The striker rises towards the bell stopping at "Almost There".  C'mon! You can do better than that!

You swing the mallet one more time. The bell rings as the striker reaches the top of the pole. The attendant says, "You're a Muscle Man. Here's a prize for you."
Which prize would you like? 1) The stuffed teddy bear, 2) the Swiss Army knife, or 3) the poster of Taylor Swift?

[Your score has just gone up by five points.]