>s
The Booth
You are standing in line at a ticket booth at the carnival. The booth sells tickets to the Hell Ride attraction. The line for the ride forms to the south and the midway continues east and west from here. There is a concession stand to the south west. The ticket booth is garishly painted in purple and green sparkles. There is a Ticket Seller here. The Ticket Seller has a ticket.

You can see a Seller here.

>e
Strongman Booth
The Strongman Booth is a popular carnival game in which you swing a mallet against a base and cause a striker to hit a bell. Along the length of the pole are markings indicating how strong you are. You can see an over-sized mallet here.

You can see a base and a mallet here.

>buy mallet
You fork over $2.00 for the mallet, leaving yourself with $8.00.

>hit base with mallet
You lift the mallet high and bring it down on the base with all your might! The striker rises towards the bell stopping at "Average".
Well done
[Your score has just gone up by five points.]

* * *

>e
Strongman Booth
The Strongman Booth is a popular carnival game in which you swing a mallet against a base and cause a striker to hit a bell. Along the length of the pole are markings indicating how strong you are. You can see an over-sized mallet here.

You can see a base and a mallet here.

>hit base
Violence isn't the answer to this one.

>buy mallet
You fork over $2.00 for the mallet, leaving yourself with $8.00.

>drop mallet
Dropped.

* * *

>hit base
Violence isn't the answer to this one.

>hit dime
Violence isn't the answer to this one.

>hit dime with money
Nothing happens.

>hit base with dime
You can't hit base with that!

>hit dime with mallet
Nothing happens.

>hit base with mallet
You' not holding the mallet.

>buy mallet
You fork over $2.00 for the mallet, leaving yourself with $8.00.

>hit base with mallet
You lift the mallet high and bring it down on the base with all your might! The striker rises towards the bell.
Well done
[Your score has just gone up by five points.]

>restart
Are you sure you want to restart?

* * *

>y
The carnival is in town and you had a date with your sweetie to visit it. After dinner and just as you arrive at the carnival, you and your date have a terrible fight. They storm off leaving you alone at the carnival. You decide to stay at the carnival anyway.

Hell Ride
The ride of a lifetime... by No Shoes
Release 1 / Serial number 241201 / Inform 7 v10.1.2 / D

Parking Lot
You are in a parking lot full of cars. The midway is to the south. There is a blueberry bush here. There are blueberries on the bush

>test me
(Testing.)

>[1] s

The Booth
You are standing in line at a ticket booth at the carnival. The booth sells tickets to the Hell Ride attraction. The line for the ride forms to the south and the midway continues east and west from here. There is a concession stand to the south west. The ticket booth is garishly painted in purple and green sparkles. There is a Ticket Seller here. The Ticket Seller has a ticket.

You can see a Seller here.

>[2] e

Strongman Booth
The Strongman Booth is a popular carnival game in which you swing a mallet against a base and cause a striker to hit a bell. Along the length of the pole are markings indicating how strong you are. You can see an over-sized mallet here.

You can see a base and a mallet here.

>[3] buy mallet
You fork over $2.00 for the mallet, leaving yourself with $8.00.

>[4] hit base with mallet
You lift the mallet high and bring it down on the base with all your might! The striker rises towards the bell.
Well done
[Your score has just gone up by five points.]

* * *

>hit dime with money
Nothing happens.

>hit base with money
You can't hit base with that!

* * *

>hit dime
Violence isn't the answer to this one.

* * *

>e
Strongman Booth
The Strongman Booth is a popular carnival game in which you swing a mallet against a base and cause a striker to hit a bell. Along the length of the pole are markings indicating how strong you are. You can see an over-sized mallet here.

You can see a base and a mallet here.

>hit dime
Violence isn't the answer to this one.

>hit dime with money
Nothing happens. 1

>hist base with money
That's not a verb I recognize.

>hit base with money
You can't hit base with that!

* * *

>e
Strongman Booth
The Strongman Booth is a popular carnival game in which you swing a mallet against a base and cause a striker to hit a bell. Along the length of the pole are markings indicating how strong you are. You can see an over-sized mallet here.

You can see a base and a mallet here.

>l at booth
You can't see any such thing.

>l at markings
There are five levels marked on the pole: Weakling, Below Average, Average, Above Average, and Strong Man.

* * *

>e
Strongman Booth
The Strongman Booth is a popular carnival game in which you swing a mallet against a base and cause a striker to hit a bell. Along the length of the pole are markings indicating how strong you are. You can see an over-sized mallet here.

You can see a base and a mallet here.

>w
The Booth
You are standing in line at a ticket booth at the carnival. The booth sells tickets to the Hell Ride attraction. The line for the ride forms to the south and the midway continues east and west from here. There is a concession stand to the south west. The ticket booth is garishly painted in purple and green sparkles. There is a Ticket Seller here. The Ticket Seller has a ticket.

You can see a Seller here.

>n
Parking Lot
You are in a parking lot full of cars. The midway is to the south. There is a blueberry bush here. There are blueberries on the bush

>test me
(Testing.)

>[1] s

The Booth
You are standing in line at a ticket booth at the carnival. The booth sells tickets to the Hell Ride attraction. The line for the ride forms to the south and the midway continues east and west from here. There is a concession stand to the south west. The ticket booth is garishly painted in purple and green sparkles. There is a Ticket Seller here. The Ticket Seller has a ticket.

You can see a Seller here.

>[2] e

Strongman Booth
The Strongman Booth is a popular carnival game in which you swing a mallet against a base and cause a striker to hit a bell. Along the length of the pole are markings indicating how strong you are. You can see an over-sized mallet here.

You can see a base and a mallet here.

>[3] buy mallet
You fork over $2.00 for the mallet, leaving yourself with $8.00.

>[4] hit base with mallet
You lift the mallet high and bring it down on the base with all your might! The striker rises towards the bell stopping at Almost There.
Well done
[Your score has just gone up by five points.]

* * *

>w
The Booth
You are standing in line at a ticket booth at the carnival. The booth sells tickets to the Hell Ride attraction. The line for the ride forms to the south and the midway continues east and west from here. There is a concession stand to the south west. The ticket booth is garishly painted in purple and green sparkles. There is a Ticket Seller here. The Ticket Seller has a ticket.

You can see a Seller here.

>w
Little Egypt Facade
You are standing in front of a trailer. There is a stage in front of the trailer. The Barker is encouraging you to step up, pay for, and enjoy the Little Egypt Show.

You can see a Barker here.

The barker cries: 

Ladies and gentlemen, boys and girls, gather "round! 
Step right up and witness the spectacle that's taken the world by storm! 
She walks, she talks, she crawls on her belly like a reptile. 
Behold the one, the only Little Egypt, performing her legendary Dance of the Pyramids-a dazzling display of mystery, grace, and exotic allure! 
For just a dime, one tenth of a dollar, prepare to be transported to the sands of Cairo, where enchantment and wonder await!

>give dime to barker
You can now head west into the show.

The barker cries: 

Ladies and gentlemen, boys and girls, gather "round! 
Step right up and witness the spectacle that's taken the world by storm! 
She walks, she talks, she crawls on her belly like a reptile. 
Behold the one, the only Little Egypt, performing her legendary Dance of the Pyramids-a dazzling display of mystery, grace, and exotic allure! 
For just a dime, one tenth of a dollar, prepare to be transported to the sands of Cairo, where enchantment and wonder await!

>w
Little Egypt Show
As you enter the tent, you see that The stage is decorated to resemble an exotic Middle Eastern market or palace, featuring rich, colorful fabrics, brass ornaments, and lanterns casting a warm, flickering glow. Scents of incense waft through the air, enhancing the atmosphere of mystique. The backdrop displays painted scenes of pyramids, desert landscapes, or domed structures to evoking a sense of being transported to the "Middle East". 

Little Egypt emerges draped in a flowing silk veils which she skillfully uses as part of the dance. Her attire consists of a sparkling, sequined bodice and harem pants, adorned with jingling coin belts and jewelry that accentuate her movements.

The performance begins with slow, undulating movements, drawing the you into the rhythm of exotic live music played on traditional instruments like the oud, darbuka, or zurna. As the tempo builds, her hips, torso, and hands move in intricate, mesmerizing patterns, demonstrating remarkable control and fluidity. She incorporates dramatic spins, drops, and shimmies, often accentuating the beat of the music with a quick jingle of her coin belt.

Little Egypt makes eye contact with you and smiles enigmatically. During her performance she balances a sword on her head and accents her dance with finger cymbals.

The music alternates between hauntingly slow melodies and rapid, energetic drum beats, creating an emotional arc that keeps the you entranced. Little Egypt relies on the music's dynamic changes to tell a story with movements reflecting joy, sorrow, seduction, and celebration.

The performance concludes with a dramatic flourish of a fast-paced shimmy, a bold spin, and Little Egypt dramatically casts off her veils. The dancer takes a bow to enthusiastic applause, leaving you spellbound by the sensual yet artful display.

>l
Little Egypt Show
There are folding chairs set up in rows in front of a low stage. There is an empty chair in the front row. Perhaps you could sit there.

>sit in chair
You get onto the Folding Chair.

>z
Time passes.

I beg your pardon?

>z
Time passes.

>quit
Are you sure you want to quit?

* * *

>s
You'll need a ticket to go that way.

* * *

>s
The Booth
You are standing in line at a ticket booth at the carnival. The booth sells tickets to the Hell Ride attraction. The line for the ride forms to the south and the midway continues east and west from here. There is a concession stand to the south west. The ticket booth is garishly painted in purple and green sparkles. There is a Ticket Seller here. The Ticket Seller has a ticket.

You can see a Seller here.

>s
Head of the Line
You are standing in front of a ticket taker with his hand open waiting for your ticket. The entrance to the ride is south of here.

You can see an Attendant here.

>s
Ride Entrance
The cars that will take you into the fearsome Hell Ride stop here for you to board.  To the west is the track that will take you into the ride. The safety bar is raised allowing you to entering the car.

You can see a car (empty) here.

>get in car
You get into the car.

>z
Time passes.

>s
Stocks (in the car)
You see stocks here.

* * *

>s
Ride Entrance
The cars that will take you into the fearsome Hell Ride stop here for you to board.  To the west is the track that will take you into the ride. The safety bar is raised allowing you to entering the car.

You can see a car (empty) here.

>s
You can't go that way.

* * *

>s
The Booth
You are standing in line at a ticket booth at the carnival. The booth sells tickets to the Hell Ride attraction. The line for the ride forms to the south and the midway continues east and west from here. There is a concession stand to the south west. The ticket booth is garishly painted in purple and green sparkles. There is a Ticket Seller here. The Ticket Seller has a ticket.

You can see a Seller here.

>w
Little Egypt Facade
You are standing in front of a trailer. There is a stage in front of the trailer. The Barker is encouraging you to step up, pay for, and enjoy the Little Egypt Show.

You can see a Barker here.

>s
You'll need a ticket to go that way.

You can't go that way.

* * *

>w
Little Egypt Facade
You are standing in front of a trailer. There is a stage in front of the trailer. The Barker is encouraging you to step up, pay for, and enjoy the Little Egypt Show.

You can see a Barker here.

>w
It'll cost you a dime to go that way.

* * *

>give dime to barker
You can now head west into the show.

>w
Little Egypt Show
As you enter the tent, you see that The stage is decorated to resemble an exotic Middle Eastern market or palace, featuring rich, colorful fabrics, brass ornaments, and lanterns casting a warm, flickering glow. Scents of incense waft through the air, enhancing the atmosphere of mystique. The backdrop displays painted scenes of pyramids, desert landscapes, or domed structures to evoking a sense of being transported to the "Middle East". 

Little Egypt emerges draped in a flowing silk veils which she skillfully uses as part of the dance. Her attire consists of a sparkling, sequined bodice and harem pants, adorned with jingling coin belts and jewelry that accentuate her movements.

The performance begins with slow, undulating movements, drawing the you into the rhythm of exotic live music played on traditional instruments like the oud, darbuka, or zurna. As the tempo builds, her hips, torso, and hands move in intricate, mesmerizing patterns, demonstrating remarkable control and fluidity. She incorporates dramatic spins, drops, and shimmies, often accentuating the beat of the music with a quick jingle of her coin belt.

Little Egypt makes eye contact with you and smiles enigmatically. During her performance she balances a sword on her head and accents her dance with finger cymbals.

The music alternates between hauntingly slow melodies and rapid, energetic drum beats, creating an emotional arc that keeps the you entranced. Little Egypt relies on the music's dynamic changes to tell a story with movements reflecting joy, sorrow, seduction, and celebration.

The performance concludes with a dramatic flourish of a fast-paced shimmy, a bold spin, and Little Egypt dramatically casts off her veils. The dancer takes a bow to enthusiastic applause, leaving you spellbound by the sensual yet artful display.

* * *

>l
Little Egypt Show
There are folding chairs set up in rows in front of a low stage. There is an empty chair in the front row. Perhaps you could sit there.

>l at barker
You can't see any such thing.

>e
Little Egypt Facade
You are standing in front of a trailer. There is a stage in front of the trailer. The Barker is encouraging you to step up, pay for, and enjoy the Little Egypt Show.

You can see a Barker here.

>l at barker
Here is a man dressed in black pants, a white shirt, and a striped vest.  He calls out: 

Ladies and gentlemen, boys and girls, gather "round! Step right up and witness the spectacle that's taken the world by storm! She walks, she talks, she crawls on her belly like a reptile. Behold the one, the only Little Egypt, performing her legendary Dance of the Pyramids-a dazzling display of mystery, grace, and exotic allure! For just a dime, prepare to be transported to the sands of Cairo, where enchantment and wonder await!

* * *

>sit in chair
You get onto the Folding Chair.

>l
Little Egypt Show (on the Folding Chair)
As you enter the tent, you see that The stage is decorated to resemble an exotic Middle Eastern market or palace, featuring rich, colorful fabrics, brass ornaments, and lanterns casting a warm, flickering glow. Scents of incense waft through the air, enhancing the atmosphere of mystique. The backdrop displays painted scenes of pyramids, desert landscapes, or domed structures to evoking a sense of being transported to the "Middle East". 

Little Egypt emerges draped in a flowing silk veils which she skillfully uses as part of the dance. Her attire consists of a sparkling, sequined bodice and harem pants, adorned with jingling coin belts and jewelry that accentuate her movements.

The performance begins with slow, undulating movements, drawing the you into the rhythm of exotic live music played on traditional instruments like the oud, darbuka, or zurna. As the tempo builds, her hips, torso, and hands move in intricate, mesmerizing patterns, demonstrating remarkable control and fluidity. She incorporates dramatic spins, drops, and shimmies, often accentuating the beat of the music with a quick jingle of her coin belt.

Little Egypt makes eye contact with you and smiles enigmatically. During her performance she balances a sword on her head and accents her dance with finger cymbals.

The music alternates between hauntingly slow melodies and rapid, energetic drum beats, creating an emotional arc that keeps the you entranced. Little Egypt relies on the music's dynamic changes to tell a story with movements reflecting joy, sorrow, seduction, and celebration.

The performance concludes with a dramatic flourish of a fast-paced shimmy, a bold spin, and Little Egypt dramatically casts off her veils. The dancer takes a bow to enthusiastic applause, leaving you spellbound by the sensual yet artful display.

There are folding chairs set up in rows in front of a low stage. There is an empty chair in the front row. Perhaps you could sit there.

>s
You would have to get off the Folding Chair first.

>w
You would have to get off the Folding Chair first.

>exit
You get off the Folding Chair.

Little Egypt Show
As you enter the tent, you see that The stage is decorated to resemble an exotic Middle Eastern market or palace, featuring rich, colorful fabrics, brass ornaments, and lanterns casting a warm, flickering glow. Scents of incense waft through the air, enhancing the atmosphere of mystique. The backdrop displays painted scenes of pyramids, desert landscapes, or domed structures to evoking a sense of being transported to the "Middle East". 

Little Egypt emerges draped in a flowing silk veils which she skillfully uses as part of the dance. Her attire consists of a sparkling, sequined bodice and harem pants, adorned with jingling coin belts and jewelry that accentuate her movements.

The performance begins with slow, undulating movements, drawing the you into the rhythm of exotic live music played on traditional instruments like the oud, darbuka, or zurna. As the tempo builds, her hips, torso, and hands move in intricate, mesmerizing patterns, demonstrating remarkable control and fluidity. She incorporates dramatic spins, drops, and shimmies, often accentuating the beat of the music with a quick jingle of her coin belt.

Little Egypt makes eye contact with you and smiles enigmatically. During her performance she balances a sword on her head and accents her dance with finger cymbals.

The music alternates between hauntingly slow melodies and rapid, energetic drum beats, creating an emotional arc that keeps the you entranced. Little Egypt relies on the music's dynamic changes to tell a story with movements reflecting joy, sorrow, seduction, and celebration.

The performance concludes with a dramatic flourish of a fast-paced shimmy, a bold spin, and Little Egypt dramatically casts off her veils. The dancer takes a bow to enthusiastic applause, leaving you spellbound by the sensual yet artful display.

There are folding chairs set up in rows in front of a low stage. There is an empty chair in the front row. Perhaps you could sit there.

* * *

>w
It'll cost you a dime to go that way.

>w
You'll need a ticket to go that way.

>give dime to barker
You can now head west into the show.

>w
Little Egypt Show
As you enter the tent, you see that The stage is decorated to resemble an exotic Middle Eastern market or palace, featuring rich, colorful fabrics, brass ornaments, and lanterns casting a warm, flickering glow. Scents of incense waft through the air, enhancing the atmosphere of mystique. The backdrop displays painted scenes of pyramids, desert landscapes, or domed structures to evoking a sense of being transported to the "Middle East". 

Little Egypt emerges draped in a flowing silk veils which she skillfully uses as part of the dance. Her attire consists of a sparkling, sequined bodice and harem pants, adorned with jingling coin belts and jewelry that accentuate her movements.

The performance begins with slow, undulating movements, drawing the you into the rhythm of exotic live music played on traditional instruments like the oud, darbuka, or zurna. As the tempo builds, her hips, torso, and hands move in intricate, mesmerizing patterns, demonstrating remarkable control and fluidity. She incorporates dramatic spins, drops, and shimmies, often accentuating the beat of the music with a quick jingle of her coin belt.

Little Egypt makes eye contact with you and smiles enigmatically. During her performance she balances a sword on her head and accents her dance with finger cymbals.

The music alternates between hauntingly slow melodies and rapid, energetic drum beats, creating an emotional arc that keeps the you entranced. Little Egypt relies on the music's dynamic changes to tell a story with movements reflecting joy, sorrow, seduction, and celebration.

The performance concludes with a dramatic flourish of a fast-paced shimmy, a bold spin, and Little Egypt dramatically casts off her veils. The dancer takes a bow to enthusiastic applause, leaving you spellbound by the sensual yet artful display.

There are folding chairs set up in rows in front of a low stage. There is an empty chair in the front row. Perhaps you could sit there.

>l
Little Egypt Show
As you enter the tent, you see that The stage is decorated to resemble an exotic Middle Eastern market or palace, featuring rich, colorful fabrics, brass ornaments, and lanterns casting a warm, flickering glow. Scents of incense waft through the air, enhancing the atmosphere of mystique. The backdrop displays painted scenes of pyramids, desert landscapes, or domed structures to evoking a sense of being transported to the "Middle East". 

Little Egypt emerges draped in a flowing silk veils which she skillfully uses as part of the dance. Her attire consists of a sparkling, sequined bodice and harem pants, adorned with jingling coin belts and jewelry that accentuate her movements.

The performance begins with slow, undulating movements, drawing the you into the rhythm of exotic live music played on traditional instruments like the oud, darbuka, or zurna. As the tempo builds, her hips, torso, and hands move in intricate, mesmerizing patterns, demonstrating remarkable control and fluidity. She incorporates dramatic spins, drops, and shimmies, often accentuating the beat of the music with a quick jingle of her coin belt.

Little Egypt makes eye contact with you and smiles enigmatically. During her performance she balances a sword on her head and accents her dance with finger cymbals.

The music alternates between hauntingly slow melodies and rapid, energetic drum beats, creating an emotional arc that keeps the you entranced. Little Egypt relies on the music's dynamic changes to tell a story with movements reflecting joy, sorrow, seduction, and celebration.

The performance concludes with a dramatic flourish of a fast-paced shimmy, a bold spin, and Little Egypt dramatically casts off her veils. The dancer takes a bow to enthusiastic applause, leaving you spellbound by the sensual yet artful display.

There are folding chairs set up in rows in front of a low stage. There is an empty chair in the front row. Perhaps you could sit there.

* * *

>w
You'll need a ticket to go that way.

>w
You'll need a ticket to go that way.

I beg your pardon?

>s
You can't go that way.

I beg your pardon?

>w
You'll need a ticket to go that way.

>give barker the dime
The Barker doesn't seem interested.

* * *

>w
You'll need a ticket to go that way.

>give dime to barker
You can now head west into the show.

You give the dime to the Barker.

>w
Little Egypt Show
As you enter the tent, you see that The stage is decorated to resemble an exotic Middle Eastern market or palace, featuring rich, colorful fabrics, brass ornaments, and lanterns casting a warm, flickering glow. Scents of incense waft through the air, enhancing the atmosphere of mystique. The backdrop displays painted scenes of pyramids, desert landscapes, or domed structures to evoking a sense of being transported to the "Middle East". 

Little Egypt emerges draped in a flowing silk veils which she skillfully uses as part of the dance. Her attire consists of a sparkling, sequined bodice and harem pants, adorned with jingling coin belts and jewelry that accentuate her movements.

The performance begins with slow, undulating movements, drawing the you into the rhythm of exotic live music played on traditional instruments like the oud, darbuka, or zurna. As the tempo builds, her hips, torso, and hands move in intricate, mesmerizing patterns, demonstrating remarkable control and fluidity. She incorporates dramatic spins, drops, and shimmies, often accentuating the beat of the music with a quick jingle of her coin belt.

Little Egypt makes eye contact with you and smiles enigmatically. During her performance she balances a sword on her head and accents her dance with finger cymbals.

The music alternates between hauntingly slow melodies and rapid, energetic drum beats, creating an emotional arc that keeps the you entranced. Little Egypt relies on the music's dynamic changes to tell a story with movements reflecting joy, sorrow, seduction, and celebration.

The performance concludes with a dramatic flourish of a fast-paced shimmy, a bold spin, and Little Egypt dramatically casts off her veils. The dancer takes a bow to enthusiastic applause, leaving you spellbound by the sensual yet artful display.

There are folding chairs set up in rows in front of a low stage. There is a spotlight shining on the stage. There is an empty chair in the front row. Perhaps you could sit there.

>w
You can't go that way.

>e
Little Egypt Facade
You are standing in front of a trailer. There is a stage in front of the trailer. The Barker is encouraging you to step up, pay for, and enjoy the Little Egypt Show.

You can see a Barker here.

>w
Little Egypt Show
There are folding chairs set up in rows in front of a low stage. There is a spotlight shining on the stage. There is an empty chair in the front row. Perhaps you could sit there.

You would have to get out of Little Egypt Show first.

>e
Little Egypt Facade
You are standing in front of a trailer. There is a stage in front of the trailer. The Barker is encouraging you to step up, pay for, and enjoy the Little Egypt Show.

You can see a Barker here.

* * *

The carnival is in town and you had a date with your sweetie to visit it. After dinner and just as you arrive at the carnival, you and your date have a terrible fight. They storm off leaving you alone at the carnival. You decide to stay at the carnival anyway.

Hell Ride
The ride of a lifetime... by No Shoes
Release 1 / Serial number 241201 / Inform 7 v10.1.2 / D

Parking Lot
You are in a parking lot full of cars. The midway is to the south. There is a blueberry bush here. There are blueberries on the bush

>test malle
>--> The following tests are available:
'test mallet'

>test mallet
(Testing.)

>[1] s

The Booth
You are standing in line at a ticket booth at the carnival. The booth sells tickets to the Hell Ride attraction. The line for the ride forms to the south and the midway continues east and west from here. There is a concession stand to the south west. The ticket booth is garishly painted in purple and green sparkles. There is a Ticket Seller here. The Ticket Seller has a ticket.

You can see a Seller here.

>[2] e

Strongman Booth
The Strongman Booth is a popular carnival game in which you swing a mallet against a base and cause a striker to hit a bell. Along the length of the pole are markings indicating how strong you are. You can see an over-sized mallet here.

You can see a base and a mallet here.

>[3] buy mallet
You fork over $2.00 for the mallet, leaving yourself with $8.00.

>[4] hit base with mallet

>hit dime
Violence isn't the answer to this one.

>hit dime with money
Nothing happens.
Nothing happens.

* * *

The carnival is in town and you had a date with your sweetie to visit it. After dinner and just as you arrive at the carnival, you and your date have a terrible fight. They storm off leaving you alone at the carnival. You decide to stay at the carnival anyway.

Hell Ride
The ride of a lifetime... by No Shoes
Release 1 / Serial number 241201 / Inform 7 v10.1.2 / D

Parking Lot
You are in a parking lot full of cars. The midway is to the south. There is a blueberry bush here. There are blueberries on the bush

>test mallet
(Testing.)

>[1] s

The Booth
You are standing in line at a ticket booth at the carnival. The booth sells tickets to the Hell Ride attraction. The line for the ride forms to the south and the midway continues east and west from here. There is a concession stand to the south west. The ticket booth is garishly painted in purple and green sparkles. There is a Ticket Seller here. The Ticket Seller has a ticket.

You can see a Seller here.

>[2] e

Strongman Booth
The Strongman Booth is a popular carnival game in which you swing a mallet against a base and cause a striker to hit a bell. Along the length of the pole are markings indicating how strong you are. You can see an over-sized mallet here.

You can see a base and a mallet here.

>[3] buy mallet
You fork over $2.00 for the mallet, leaving yourself with $8.00.

>[4] hit base with mallet

* * *

>hit dime
Violence isn't the answer to this one.

>hit dime with mallet
Nothing happens.

>hit wallet with mallet
Nothing happens.

* * *

>hit dime with money
Nothing happens.

I beg your pardon?

* * *

>hit dime with mallet
Nothing happens.

* * *

The carnival is in town and you had a date with your sweetie to visit it. After dinner and just as you arrive at the carnival, you and your date have a terrible fight. They storm off leaving you alone at the carnival. You decide to stay at the carnival anyway.

Hell Ride
The ride of a lifetime... by No Shoes
Release 1 / Serial number 241201 / Inform 7 v10.1.2 / D

Parking Lot
You are in a parking lot full of cars. The midway is to the south. There is a blueberry bush here. There are blueberries on the bush

>test me
(Testing.)

>[1] s

The Booth
You are standing in line at a ticket booth at the carnival. The booth sells tickets to the Hell Ride attraction. The line for the ride forms to the south and the midway continues east and west from here. There is a concession stand to the south west. The ticket booth is garishly painted in purple and green sparkles. There is a Ticket Seller here. The Ticket Seller has a ticket.

You can see a Seller here.

>[2] e

Strongman Booth
The Strongman Booth is a popular carnival game in which you swing a mallet against a base and cause a striker to hit a bell. Along the length of the pole are markings indicating how strong you are. You can see an over-sized mallet here.

You can see a base and a mallet here.

>[3] buy mallet
You fork over $2.00 for the mallet, leaving yourself with $8.00.

>[4] hit base with mallet
You lift the mallet high and bring it down on the base with all your might! The striker rises towards the bell stopping at "Average".
Well done
[Your score has just gone up by five points.]

>drop mallet
Dropped.

* * *

>hit base with mallet
Nothing happens.

>w
The Booth
You are standing in line at a ticket booth at the carnival. The booth sells tickets to the Hell Ride attraction. The line for the ride forms to the south and the midway continues east and west from here. There is a concession stand to the south west. The ticket booth is garishly painted in purple and green sparkles. There is a Ticket Seller here. The Ticket Seller has a ticket.

You can see a Seller here.

>s
Head of the Line
You are standing in front of a ticket taker with his hand open waiting for your ticket. The entrance to the ride is south of here.

You can see an Attendant here.

>n
The Booth
You are standing in line at a ticket booth at the carnival. The booth sells tickets to the Hell Ride attraction. The line for the ride forms to the south and the midway continues east and west from here. There is a concession stand to the south west. The ticket booth is garishly painted in purple and green sparkles. There is a Ticket Seller here. The Ticket Seller has a ticket.

You can see a Seller here.

>buy ticket
You fork over $2.50 for the ticket, leaving yourself with $5.50.

>s
Head of the Line
You are standing in front of a ticket taker with his hand open waiting for your ticket. The entrance to the ride is south of here.

You can see an Attendant here.

>s
Ride Entrance
The cars that will take you into the fearsome Hell Ride stop here for you to board.  To the south is the track that will take you into the ride. The safety bar is raised allowing you to entering the car.

You can see a car (empty) here.

>n
Head of the Line
You are standing in front of a ticket taker with his hand open waiting for your ticket. The entrance to the ride is south of here.

You can see an Attendant here.

>give ticket to the attendant
The Attendant doesn't seem interested.

* * *

>hit dime with mallet
Nothing happens.