The carnival is in town and you had a date with your sweetie to visit it. After dinner and just as you arrive at the carnival, you and your date have a terrible fight. They storm off leaving you alone at the carnival. You decide to stay at the carnival anyway.

Hell Ride
The ride of a lifetime... by No Shoes
Release 1 / Serial number 241206 / Inform 7 v10.1.2 / D

Parking Lot
The carnival parking lot sprawls across an open field, its uneven gravel surface crunching under the tires of arriving cars. The lot is lit by a mix of temporary floodlights mounted on poles and the colorful glow of the carnival itself, which spills across the area in flashes of red, blue, and gold. The distant sounds of laughter, music, and the mechanical whir of rides drift across the lot, creating an air of excitement even before reaching the main grounds.

Rows of vehicles, from dusty sedans to pickup trucks with weathered paint, are parked haphazardly, guided by makeshift wooden signs and strings of flags fluttering in the breeze. Some families unload children, strollers, and blankets from their cars, their voices mingling with the distant carnival noise. Others sit in their vehicles, adjusting their jackets and preparing for the chilly evening ahead.

The edges of the lot are lined with trees and bushes, their shadows stretching across the ground, creating pockets of darkness. The occasional glow of a phone screen or flashlight pierces the dim corners as latecomers search for empty spots. Near the entrance, a weathered booth manned by a lone attendant collects parking fees, the cash box jingling with loose change.

Puddles from a recent rain reflect the flashing carnival lights, creating a surreal, shimmering effect on the ground. The smell of damp earth mixes with the distant aroma of popcorn and funnel cakes wafting from the midway. In some areas, patches of mud threaten to swallow unwary shoes, marked by the faint tread of earlier visitors.

At the far end of the lot, a handful of RVs and trailers are parked, their occupants relaxing in folding chairs, watching the lights of the Ferris wheel spin lazily against the night sky. Generators hum softly, providing power to the trailers, a subtle background noise beneath the larger symphony of the carnival.

The parking lot, while utilitarian, is alive with anticipation, serving as the gateway to the magic of the carnival. It's a place of transition, where the mundane gives way to the extraordinary, and the humdrum rhythms of daily life are momentarily forgotten.

The midway is to the south. There is a blueberry bush here. There are blueberries on the bush.  You see something shiny on the ground.

You can see a dime here.

>l
Parking Lot
The carnival parking lot sprawls across an open field, its uneven gravel surface crunching under the tires of arriving cars. The lot is lit by a mix of temporary floodlights mounted on poles and the colorful glow of the carnival itself, which spills across the area in flashes of red, blue, and gold. The distant sounds of laughter, music, and the mechanical whir of rides drift across the lot, creating an air of excitement even before reaching the main grounds.

Rows of vehicles, from dusty sedans to pickup trucks with weathered paint, are parked haphazardly, guided by makeshift wooden signs and strings of flags fluttering in the breeze. Some families unload children, strollers, and blankets from their cars, their voices mingling with the distant carnival noise. Others sit in their vehicles, adjusting their jackets and preparing for the chilly evening ahead.

The edges of the lot are lined with trees and bushes, their shadows stretching across the ground, creating pockets of darkness. The occasional glow of a phone screen or flashlight pierces the dim corners as latecomers search for empty spots. Near the entrance, a weathered booth manned by a lone attendant collects parking fees, the cash box jingling with loose change.

Puddles from a recent rain reflect the flashing carnival lights, creating a surreal, shimmering effect on the ground. The smell of damp earth mixes with the distant aroma of popcorn and funnel cakes wafting from the midway. In some areas, patches of mud threaten to swallow unwary shoes, marked by the faint tread of earlier visitors.

At the far end of the lot, a handful of RVs and trailers are parked, their occupants relaxing in folding chairs, watching the lights of the Ferris wheel spin lazily against the night sky. Generators hum softly, providing power to the trailers, a subtle background noise beneath the larger symphony of the carnival.

The parking lot, while utilitarian, is alive with anticipation, serving as the gateway to the magic of the carnival. It's a place of transition, where the mundane gives way to the extraordinary, and the humdrum rhythms of daily life are momentarily forgotten.

The midway is to the south. There is a blueberry bush here. There are blueberries on the bush.  You see something shiny on the ground.

You can see a dime here.

* * *

>test misc
(Testing.)

>[1] brief
Hell Ride is now in its "brief" printing mode, which gives long descriptions of places never before visited and short descriptions otherwise.

>[2] get blueberries
Good Job!

[Your score has just gone up by five points.]

>[3] xyzzy
A voice nearby says "Plugh".

>[4] hello sailor
Nothing happens here.

>[5] please get the dime
Please do not say please.

>[6] score
You have so far scored 5 out of a possible 80, in 4 turns.

* * *

>test b4
(Testing.)

>[1] n

Generator Room
You can see an Indigo Door here.

>[2] n

Mechanical Room South
You can see a Grey Door here.

>[3] n

Mechanical Room North
You can see an Emerald Door and a toolbox (empty) here.

>[4] n

Crawl Space
You can see a Crimson Door here.

>[5] n

Maintenance Office
The radio burbles on.

You can see an Aqua Door, a desk, a cans of paint, grease, and lubricant here.

"Folsom Prison Blues" by Johnny Cash is on the air."

>[6] n

Dark Passage

>[7] w

Ride Entrance
You can see a car (empty) here.

>[8] n

Head of the Line
You can see a Ride Attendant here.

>[9] n

Kiosk
You can see a Cashier here.

>[10] n

Parking Lot
You can see a dime here.

>[11] score
You have so far scored 75 out of a possible 80, in 112 turns.