Type "Images On" to display images. Type "Help" for hints about Hell Ride and general information about playing interactive fiction games.

You're a part-time reporter for The Tribune, the local paper. Earlier in the day, your editor called you and told you of a conversation he overheard between the Chief of Police and his Deputy about Whidbey Amusements. It seems there has been a rash of accidents and mishaps at the carnival. Sounds like there could be something suspicious going on. He wants you to collect evidence and write a hard hitting piece about it. If you do a good job, maybe the paper will hire you one full-time.

Hell Ride
The ride of a lifetime... by No Shoes
Release 201 / Serial number 250218 / Inform 7 v10.1.2 / D

Parking Lot
The carnival parking lot stretches across an open field, its gravel crunching under arriving cars. Temporary floodlights and the carnival's colorful glow light the area, while distant laughter, music, and the hum of rides fill the air.

Cars park haphazardly, guided by makeshift signs and fluttering flags. Families unload strollers and blankets, their chatter mixing with the carnival sounds. Others linger in vehicles, preparing for the chilly evening.

Shadows from nearby trees create dark pockets pierced by the occasional flashlight. Near the entrance, an attendant collects fees at a weathered booth, coins jingling in the cash box.

Puddles from recent rain shimmer with reflected lights, while patches of mud cling to unwary shoes. At the far end, RVs and trailers sit quietly, their occupants watching the Ferris wheel spin lazily against the sky.

Alive with anticipation, the parking lot marks the transition from the ordinary to the magic of the carnival.

The midway is to the south. There is a blueberry bush here. There are blueberries on the bush.

Your car is here. It's a bit of a beater. Inside the car, you can see the glove box, the seat, the rear view mirror, the ignition, and the dashboard.

You can see a Parking Attendant here.

The attendant has a parking ticket. The price of a parking ticket is $5.00.

* * *

>display fuses
an indigo colored fuse is in the Carnival Office.
a gray colored fuse is in the Bumper Cars.
a magenta colored fuse is in the High Striker.
a khaki colored fuse is in Behind the Concession Stand.
a crimson colored fuse is in the Pitchers Mound.
an orange colored fuse is in the Dime Toss Game.
a quartz colored fuse is in the Stake Room.
an emerald colored fuse is in the Mechanical Room South.
an aqua colored fuse is in the Ride Exit.
9 items.

>display attendants
a Parking Attendant is an attendant in the Parking Lot.
a Hell Ride Attendant is an attendant in the Head of the Line.
a Cashier is an attendant in the Ticket Booth.
a Concession Attendant is an attendant in the Concession Stand.
a Carousel Attendant is an attendant in the Carousel.
a Bumper Cars attendant is an attendant in the Bumper Cars.
a Strongman attendant is an attendant in the High Striker.
a Pitchers Mound attendant is an attendant in the Pitchers Mound.
a Ferris Wheel Attendant is an attendant in the Ferris Wheel.
a Dime Toss attendant is an attendant in the Dime Toss Game.
a Merchandise Attendant is an attendant in the Ride Exit.
11 items.

>display containers
0kg *** 25kg yourself
2kg *** 15kg a wallet
0kg *** 15kg a fanny pack
0kg *** 25kg a Parking Attendant
1kg *** 15kg a beater car
1kg *** 15kg a blueberry bush
0kg *** 25kg a janitor
0kg *** 15kg a brass ring
0kg *** 25kg a Hell Ride Attendant
0kg *** 25kg Mr Whidbey
3kg *** 15kg a safe
0kg *** 15kg a messy desk
5kg *** 15kg a filing cabinet
1kg *** 15kg an envelope
2kg *** 15kg a glove box
0kg *** 15kg a seat
0kg *** 15kg Electrical Panel 1
0kg *** 15kg an emergency shutdown panel
0kg *** 15kg Electrical Panel 3
0kg *** 15kg Electrical Panel 5
0kg *** 15kg Electrical Panel 7
0kg *** 15kg Electrical Panel 9
0kg *** 15kg Electrical Panel 11
0kg *** 15kg socket 1
0kg *** 15kg socket 3
0kg *** 15kg socket 5
0kg *** 15kg socket 7
0kg *** 15kg socket 9
0kg *** 15kg socket 11
0kg *** 15kg Control Panel One
0kg *** 15kg Control Panel Three
0kg *** 15kg Control Panel Five
0kg *** 15kg Control Panel Seven
0kg *** 15kg Control Panel Nine
0kg *** 15kg Control Panel Eleven
0kg *** 25kg a Cashier
0kg *** 15kg an ignition
0kg *** 15kg a dashboard
0kg *** 15kg a round table
0kg *** 25kg Esmeralda the Mysterious
0kg *** 25kg a Concession Attendant
0kg *** 15kg a Drink of Cola
0kg *** 25kg a Barker
0kg *** 25kg a Carousel Attendant
0kg *** 25kg a Bumper Cars attendant
0kg *** 25kg a Strongman attendant
1kg *** 15kg a trash can
0kg *** 15kg a chair
0kg *** 25kg a Pitchers Mound attendant
0kg *** 25kg a Ferris Wheel Attendant
0kg *** 25kg a Dime Toss attendant
0kg *** 15kg a plate
0kg *** 25kg Little Egypt
1kg *** 15kg a wall
0kg *** 15kg a folding chair
0kg *** 15kg a Hell Ride car
1kg *** 15kg a pile of junk
0kg *** 15kg a stool
0kg *** 15kg a desk
4kg *** 15kg a drawer
0kg *** 15kg a wooden stocks
0kg *** 15kg a gallows platform
3kg *** 15kg a toolbox
1kg *** 15kg a pyre
1kg *** 15kg a grate
0kg *** 15kg an iron chair
0kg *** 15kg a guillotine platform
5kg *** 15kg a merchandise stand
0kg *** 25kg a Merchandise Attendant
69 items.

>display missing descriptions
$35.00 in cash has no description.
1 items.

*** Run-time problem P10: Since nothing is not allowed the property "color", it is against the rules to try to use it.

* * *

>help
Sometimes the temptation to rely on hints becomes overwhelming, and you may prefer to turn off hints now. If you do so, your further requests for guidance will be denied. Turn off hints?

>n
(If you're using a screen reader, press S to turn on Screen Reader mode. This message only appears on the front page of the menu system.)

     1. Introduction to Hell Ride
     2. Hell Ride Origins
     3. Introduction to Interactive Fiction
     4. Settings
     5. Credits
     6. ----- These Hints Below Contain Out Right Spoilers -----
     7. The Parking Lot
     8. The Attractions
     9. The Games
     0. The Carnival Office
     A. Back Stage
     B. Hell Ride
     C. The Electrical Area
     D. Where Are The Fuses?
     E. The Control Room
     F. How Points Are Awarded (Spoilers)

>1
( - Introduction to Hell Ride)

Hell Ride - A ride to remember...

You're a part-time reporter for The Tribune, the local paper. Earlier in the day, your editor called you and told you of a conversation he overheard between the Chief of Police and his Deputy about Whidbey Amusements. It seems there has been a rash of accidents and mishaps at the carnival. Sounds like there could be something suspicious going on. He wants you to collect evidence and write a hard hitting piece about it. If you do a good job, maybe the paper will hire you one full-time.

As you explore the carnival, you learn (the hard way) that the Hell Ride attraction is malfunctioning with the potential for serious injuries to the riders. You must disable the ride and prevent any loss of life... including your own.

------------------------

>[esc]
(If you're using a screen reader, press S to turn on Screen Reader mode. This message only appears on the front page of the menu system.)

     1. Introduction to Hell Ride
     2. Hell Ride Origins
     3. Introduction to Interactive Fiction
     4. Settings
     5. Credits
     6. ----- These Hints Below Contain Out Right Spoilers -----
     7. The Parking Lot
     8. The Attractions
     9. The Games
     0. The Carnival Office
     A. Back Stage
     B. Hell Ride
     C. The Electrical Area
     D. Where Are The Fuses?
     E. The Control Room
     F. How Points Are Awarded (Spoilers)

>2
( - Hell Ride Origins)

Hell Ride - A ride to remember...

In the early 1980's, I had an Apple ][  Plus computer with 64K of RAM, dual 5.25" floppy disks, and a color monitor as big as a television. And the very first game I ever bought was Infocom's Zork I: The Great Underground Empire. This was cool. It was all text-based. The game described your surroundings and you interacted with commands that say what you wanted to do. This "Interactive Fiction" really evoked in a game what I appreciated most about reading: rich descriptions, colorful characters, and the like. After Zork I, there was Zork II and III. Enchanter, Moonmist, Suspect, and so many more. I played them all with my best friend Andy.

Andy and I were software developers at the time and we thought, "We can do this!" So we set out to do this. We developed a game engine with a natural language parser. And it was pretty good. We could support most of the kinds of things they did, certainly less graceful but pretty good. In fact, our parser was better than Infocom's in one case where the sentence was ambiguous. e.g. "Walk into the room with the lamp." Is the player carrying the lamp? Or is the lamp in the room?

For fun, we reverse engineered parts of Infocom's game format. We found the dictionary, certain text tokens used for text substitution, the game text. We also discovered the first example of compression I had ever seen and it just about made my head explode. They stored all ASCII characters in five bits! Pow! Mind blown. I had never considered anything like that. Just another hook.

We developed two prototypes: Diner and Hell Ride. Diner was about bank robbers coming into the diner where you are a short order cook and you have to save the day. Hell Ride was pretty close to what you find here. I decided to implement it using modern tools. It's pretty good. Maybe.

I hope you enjoy it.

d.
 (dmontgom22@gmail.com)

------------------------

>[esc]
(If you're using a screen reader, press S to turn on Screen Reader mode. This message only appears on the front page of the menu system.)

     1. Introduction to Hell Ride
     2. Hell Ride Origins
     3. Introduction to Interactive Fiction
     4. Settings
     5. Credits
     6. ----- These Hints Below Contain Out Right Spoilers -----
     7. The Parking Lot
     8. The Attractions
     9. The Games
     0. The Carnival Office
     A. Back Stage
     B. Hell Ride
     C. The Electrical Area
     D. Where Are The Fuses?
     E. The Control Room
     F. How Points Are Awarded (Spoilers)

>4
(Settings)

     1: The room description style is currently VERBOSE
     2: Score notification is currently ON
     3: Image presentation is currently OFF
     4: Transcript is currently OFF

>1
Hell Ride is now in its "brief" printing mode, which gives long descriptions of places never before visited and short descriptions otherwise.

(Settings)

     1: The room description style is currently BRIEF
     2: Score notification is currently ON
     3: Image presentation is currently OFF
     4: Transcript is currently OFF

>2
Score notification off.

(Settings)

     1: The room description style is currently BRIEF
     2: Score notification is currently OFF
     3: Image presentation is currently OFF
     4: Transcript is currently OFF

>2
Score notification on.

(Settings)

     1: The room description style is currently BRIEF
     2: Score notification is currently ON
     3: Image presentation is currently OFF
     4: Transcript is currently OFF

>3
(Settings)

     1: The room description style is currently BRIEF
     2: Score notification is currently ON
     3: Image presentation is currently ON
     4: Transcript is currently OFF

>3
(Settings)

     1: The room description style is currently BRIEF
     2: Score notification is currently ON
     3: Image presentation is currently OFF
     4: Transcript is currently OFF

>4
Attempt to begin transcript failed.

(Settings)

     1: The room description style is currently BRIEF
     2: Score notification is currently ON
     3: Image presentation is currently OFF
     4: Transcript is currently ON

>[esc]
(If you're using a screen reader, press S to turn on Screen Reader mode. This message only appears on the front page of the menu system.)

     1. Introduction to Hell Ride
     2. Hell Ride Origins
     3. Introduction to Interactive Fiction
     4. Settings
     5. Credits
     6. ----- These Hints Below Contain Out Right Spoilers -----
     7. The Parking Lot
     8. The Attractions
     9. The Games
     0. The Carnival Office
     A. Back Stage
     B. Hell Ride
     C. The Electrical Area
     D. Where Are The Fuses?
     E. The Control Room
     F. How Points Are Awarded (Spoilers)

>5
( - Credits)

Hell Ride, Copyright 2025, Dana Montgomery.

Extensions used in Hell Ride:
Basic Inform version 1 by Graham Nelson
English Language version 1 by Graham Nelson
Standard Rules version 6 by Graham Nelson
Modified Exit version 6 by Emily Short
Locksmith version 13 by Emily Short
Basic Help Menu version 4 by Wade Clarke
Basic Screen Effects version 8 by Emily Short
Menus version 5 by Wade Clarke
Object Response Tests version 7 by Juhana Leinonen

Additional Credits:
Caitlyn Caluya-Bilbrick for her editing and proofreading super powers.
The amazing Inform community over at https://IntFiction.org.

The following awesome individuals for their beta testing, excellent feedback, and ideas:
Joey Acrimonious
Ryan Allocco
Andy Broding
Drew Cook
RJ Kowalski
John Montgomery

------------------------

>[esc]
(If you're using a screen reader, press S to turn on Screen Reader mode. This message only appears on the front page of the menu system.)

     1. Introduction to Hell Ride
     2. Hell Ride Origins
     3. Introduction to Interactive Fiction
     4. Settings
     5. Credits
     6. ----- These Hints Below Contain Out Right Spoilers -----
     7. The Parking Lot
     8. The Attractions
     9. The Games
     0. The Carnival Office
     A. Back Stage
     B. Hell Ride
     C. The Electrical Area
     D. Where Are The Fuses?
     E. The Control Room
     F. How Points Are Awarded (Spoilers)

>6
( - ----- These Hints Below Contain Out Right Spoilers -----)

Part of the enjoyment of Interactive Fiction comes from the solving of the puzzles. For the most part all Hell Ride puzzles are solved within these hints. The hints are often blunt, especially at the end of a topic. I would, however, encourage you to play for the fun of it and reserve the hints for when you're truly stuck.

------------------------

>[esc]
(If you're using a screen reader, press S to turn on Screen Reader mode. This message only appears on the front page of the menu system.)

     1. Introduction to Hell Ride
     2. Hell Ride Origins
     3. Introduction to Interactive Fiction
     4. Settings
     5. Credits
     6. ----- These Hints Below Contain Out Right Spoilers -----
     7. The Parking Lot
     8. The Attractions
     9. The Games
     0. The Carnival Office
     A. Back Stage
     B. Hell Ride
     C. The Electrical Area
     D. Where Are The Fuses?
     E. The Control Room
     F. How Points Are Awarded (Spoilers)

>7
(The Parking Lot)

     1. What about the glove box?
     2. Why can't I leave the parking lot?
     3. What do I do with the string?
     4. Why does my car get towed?

* * *

>h
(The Parking Lot - Why does my car get towed?)

1/6: Why might your car get towed?

2/6: Is your car parked legally?

3/6: Are you sure?

Press H to reveal another hint.

------------------------

>h
(The Parking Lot - Why does my car get towed?)

1/6: Why might your car get towed?

2/6: Is your car parked legally?

3/6: Are you sure?

4/6: What about the parking stub

Press H to reveal another hint.

------------------------

>h
(The Parking Lot - Why does my car get towed?)

1/6: Why might your car get towed?

2/6: Is your car parked legally?

3/6: Are you sure?

4/6: What about the parking stub

5/6: The parking attendant knows something about the stub

Press H to reveal another hint.

------------------------

>h
(The Parking Lot - Why does my car get towed?)

1/6: Why might your car get towed?

2/6: Is your car parked legally?

3/6: Are you sure?

4/6: What about the parking stub

5/6: The parking attendant knows something about the stub

6/6: Put the parking stub on the dashboard.

(You have revealed all the hints on this page.)

------------------------

>[esc]
(The Parking Lot)

     1. What about the glove box?
     2. Why can't I leave the parking lot?
     3. What do I do with the string?
     4. Why does my car get towed?

>[esc]
(If you're using a screen reader, press S to turn on Screen Reader mode. This message only appears on the front page of the menu system.)

     1. Introduction to Hell Ride
     2. Hell Ride Origins
     3. Introduction to Interactive Fiction
     4. Settings
     5. Credits
     6. ----- These Hints Below Contain Out Right Spoilers -----
     7. The Parking Lot
     8. The Attractions
     9. The Games
     0. The Carnival Office
     A. Back Stage
     B. Hell Ride
     C. The Electrical Area
     D. Where Are The Fuses?
     E. The Control Room
     F. How Points Are Awarded (Spoilers)

>8
(The Attractions)

     1. Can I ride the rides?
     2. Why are tickets so expensive?
     3. The rides are boring.
     4. The Carousel
     5. The Bumper Cars
     6. The Ferris Wheel
     7. Fortune Teller

>1
(The Attractions - Can I ride the rides?)

Press H to reveal the first hint.

------------------------

* * *

>h
(The Attractions - Can I ride the rides?)

1/3: You'll need a ticket.

2/3: Tickets are expensive though.

3/3: You can buy tickets at the Ticket Kiosk.

(You have revealed all the hints on this page.)

------------------------

>[esc]
(The Attractions)

     1. Can I ride the rides?
     2. Why are tickets so expensive?
     3. The rides are boring.
     4. The Carousel
     5. The Bumper Cars
     6. The Ferris Wheel
     7. Fortune Teller

>2
(The Attractions - Why are tickets so expensive?)

Press H to reveal the first hint.

------------------------

* * *

>h
(The Attractions - Why are tickets so expensive?)

1/2: What? You were expecting wrist bands?

2/2: To remind you to spend your money wisely.

(You have revealed all the hints on this page.)

------------------------

>[esc]
(The Attractions)

     1. Can I ride the rides?
     2. Why are tickets so expensive?
     3. The rides are boring.
     4. The Carousel
     5. The Bumper Cars
     6. The Ferris Wheel
     7. Fortune Teller

>3
(The Attractions - The rides are boring.)

Press H to reveal the first hint.

------------------------

* * *

>h
(The Attractions - The rides are boring.)

1/3: Surely not ALL the rides are boring.

2/3: It's a small carnival, what do you expect?

3/3: Have you ridden Hell Ride?

(You have revealed all the hints on this page.)

------------------------

>[esc]
(The Attractions)

     1. Can I ride the rides?
     2. Why are tickets so expensive?
     3. The rides are boring.
     4. The Carousel
     5. The Bumper Cars
     6. The Ferris Wheel
     7. Fortune Teller

>4
(The Attractions - The Carousel)

Press H to reveal the first hint.

------------------------

* * *

>h
(The Attractions - The Carousel)

1/3: What a wonderful childhood memory!

2/3: What animal did you choose to ride?

3/3: Sometimes I get dizzy on the merry-go-round.

(You have revealed all the hints on this page.)

------------------------

>[esc]
(The Attractions)

     1. Can I ride the rides?
     2. Why are tickets so expensive?
     3. The rides are boring.
     4. The Carousel
     5. The Bumper Cars
     6. The Ferris Wheel
     7. Fortune Teller

>5
(The Attractions - The Bumper Cars)

Press H to reveal the first hint.

------------------------

* * *

>h
(The Attractions - The Bumper Cars)

1/4: The bumper cars are a great way to get your aggression out.

2/4: Great fun crashing into others.

3/4: And getting hit by others.

4/4: Just enjoy yourself

(You have revealed all the hints on this page.)

------------------------

>[esc]
(The Attractions)

     1. Can I ride the rides?
     2. Why are tickets so expensive?
     3. The rides are boring.
     4. The Carousel
     5. The Bumper Cars
     6. The Ferris Wheel
     7. Fortune Teller

>6
(The Attractions - The Ferris Wheel)

Press H to reveal the first hint.

------------------------

* * *

>h
(The Attractions - The Ferris Wheel)

1/5: Such a relaxing and romantic ride!

2/5: You can see the entire carnival from here.

3/5: Do you see anything from the top of the Ferris wheel?

4/5: There is a hidden area in the carnival.

Press H to reveal another hint.

------------------------

>h
(The Attractions - The Ferris Wheel)

1/5: Such a relaxing and romantic ride!

2/5: You can see the entire carnival from here.

3/5: Do you see anything from the top of the Ferris wheel?

4/5: There is a hidden area in the carnival.

5/5: It's to the west behind the Concession Stand.

(You have revealed all the hints on this page.)

------------------------

>[esc]
(The Attractions)

     1. Can I ride the rides?
     2. Why are tickets so expensive?
     3. The rides are boring.
     4. The Carousel
     5. The Bumper Cars
     6. The Ferris Wheel
     7. Fortune Teller

>7
(The Attractions - Fortune Teller)

Press H to reveal the first hint.

------------------------

>h
(The Attractions - Fortune Teller)

1/4: Esmeralda the Mysterious is our most popular attraction after Hell Ride.

Press H to reveal another hint.

------------------------

>h
(The Attractions - Fortune Teller)

1/4: Esmeralda the Mysterious is our most popular attraction after Hell Ride.

2/4: You can buy a ticket at the ticket booth.

Press H to reveal another hint.

------------------------

>h
(The Attractions - Fortune Teller)

1/4: Esmeralda the Mysterious is our most popular attraction after Hell Ride.

2/4: You can buy a ticket at the ticket booth.

3/4: Get a tarot reading and learn you fortune.

Press H to reveal another hint.

------------------------

>h
(The Attractions - Fortune Teller)

1/4: Esmeralda the Mysterious is our most popular attraction after Hell Ride.

2/4: You can buy a ticket at the ticket booth.

3/4: Get a tarot reading and learn you fortune.

4/4: Pay attention to any advice she may give you.

(You have revealed all the hints on this page.)

------------------------

>[esc]
(The Attractions)

     1. Can I ride the rides?
     2. Why are tickets so expensive?
     3. The rides are boring.
     4. The Carousel
     5. The Bumper Cars
     6. The Ferris Wheel
     7. Fortune Teller

>[esc]
(If you're using a screen reader, press S to turn on Screen Reader mode. This message only appears on the front page of the menu system.)

     1. Introduction to Hell Ride
     2. Hell Ride Origins
     3. Introduction to Interactive Fiction
     4. Settings
     5. Credits
     6. ----- These Hints Below Contain Out Right Spoilers -----
     7. The Parking Lot
     8. The Attractions
     9. The Games
     0. The Carnival Office
     A. Back Stage
     B. Hell Ride
     C. The Electrical Area
     D. Where Are The Fuses?
     E. The Control Room
     F. How Points Are Awarded (Spoilers)

>9
(The Games)

     1. Are the prizes important?
     2. Why do the games only cost a dime?
     3. I've found a Mercury dime. What is it?
     4. The High Striker Game
     5. The Dime Toss Game
     6. The Pitcher's Mound

* * *

>[esc]
(The Games)

     1. Are the prizes important?
     2. Why do the games only cost a dime?
     3. I've found a Mercury dime. What is it?
     4. The High Striker Game
     5. The Dime Toss Game
     6. The Pitcher's Mound

>[esc]
(If you're using a screen reader, press S to turn on Screen Reader mode. This message only appears on the front page of the menu system.)

     1. Introduction to Hell Ride
     2. Hell Ride Origins
     3. Introduction to Interactive Fiction
     4. Settings
     5. Credits
     6. ----- These Hints Below Contain Out Right Spoilers -----
     7. The Parking Lot
     8. The Attractions
     9. The Games
     0. The Carnival Office
     A. Back Stage
     B. Hell Ride
     C. The Electrical Area
     D. Where Are The Fuses?
     E. The Control Room
     F. How Points Are Awarded (Spoilers)

>0
(The Carnival Office)

     1. What about the Invoices?
     2. What about the Filing Cabinet?
     3. What about the Safe?

* * *

>[esc]
(The Carnival Office)

     1. What about the Invoices?
     2. What about the Filing Cabinet?
     3. What about the Safe?

>[esc]
(If you're using a screen reader, press S to turn on Screen Reader mode. This message only appears on the front page of the menu system.)

     1. Introduction to Hell Ride
     2. Hell Ride Origins
     3. Introduction to Interactive Fiction
     4. Settings
     5. Credits
     6. ----- These Hints Below Contain Out Right Spoilers -----
     7. The Parking Lot
     8. The Attractions
     9. The Games
     0. The Carnival Office
     A. Back Stage
     B. Hell Ride
     C. The Electrical Area
     D. Where Are The Fuses?
     E. The Control Room
     F. How Points Are Awarded (Spoilers)

>a
(Back Stage)

     1. Why do I get eaten by a grue?
     2. Are the doors important?

* * *

>[esc]
(Back Stage)

     1. Why do I get eaten by a grue?
     2. Are the doors important?

>[esc]
(If you're using a screen reader, press S to turn on Screen Reader mode. This message only appears on the front page of the menu system.)

     1. Introduction to Hell Ride
     2. Hell Ride Origins
     3. Introduction to Interactive Fiction
     4. Settings
     5. Credits
     6. ----- These Hints Below Contain Out Right Spoilers -----
     7. The Parking Lot
     8. The Attractions
     9. The Games
     0. The Carnival Office
     A. Back Stage
     B. Hell Ride
     C. The Electrical Area
     D. Where Are The Fuses?
     E. The Control Room
     F. How Points Are Awarded (Spoilers)

>b
(Hell Ride)

     1. Why do I die?
     2. What about the different rooms

* * *

>[esc]
(Hell Ride)

     1. Why do I die?
     2. What about the different rooms

>[esc]
(If you're using a screen reader, press S to turn on Screen Reader mode. This message only appears on the front page of the menu system.)

     1. Introduction to Hell Ride
     2. Hell Ride Origins
     3. Introduction to Interactive Fiction
     4. Settings
     5. Credits
     6. ----- These Hints Below Contain Out Right Spoilers -----
     7. The Parking Lot
     8. The Attractions
     9. The Games
     0. The Carnival Office
     A. Back Stage
     B. Hell Ride
     C. The Electrical Area
     D. Where Are The Fuses?
     E. The Control Room
     F. How Points Are Awarded (Spoilers)

>c
(The Electrical Area)

     1. What's going on in the Electrical Room?
     2. What about the electrical panels?
     3. Are the fuses important?

* * *

>h
(The Electrical Area - What's going on in the Electrical Room?)

1/7: There are exits in all directions

2/7: Can you go in the direction you intend?

3/7: The room is electromagnetic.

4/7: Maybe that's causing the problem.

Press H to reveal another hint.

------------------------

>h
(The Electrical Area - What's going on in the Electrical Room?)

1/7: There are exits in all directions

2/7: Can you go in the direction you intend?

3/7: The room is electromagnetic.

4/7: Maybe that's causing the problem.

5/7: You end up in a random room every time you try to move.

Press H to reveal another hint.

------------------------

>h
(The Electrical Area - What's going on in the Electrical Room?)

1/7: There are exits in all directions

2/7: Can you go in the direction you intend?

3/7: The room is electromagnetic.

4/7: Maybe that's causing the problem.

5/7: You end up in a random room every time you try to move.

6/7: Maybe you can make it so it's not electromagnetic.

Press H to reveal another hint.

------------------------

>h
(The Electrical Area - What's going on in the Electrical Room?)

1/7: There are exits in all directions

2/7: Can you go in the direction you intend?

3/7: The room is electromagnetic.

4/7: Maybe that's causing the problem.

5/7: You end up in a random room every time you try to move.

6/7: Maybe you can make it so it's not electromagnetic.

7/7: Turn off the big switch in the Control Room.

(You have revealed all the hints on this page.)

------------------------

>[esc]
(The Electrical Area)

     1. What's going on in the Electrical Room?
     2. What about the electrical panels?
     3. Are the fuses important?

>[esc]
(If you're using a screen reader, press S to turn on Screen Reader mode. This message only appears on the front page of the menu system.)

     1. Introduction to Hell Ride
     2. Hell Ride Origins
     3. Introduction to Interactive Fiction
     4. Settings
     5. Credits
     6. ----- These Hints Below Contain Out Right Spoilers -----
     7. The Parking Lot
     8. The Attractions
     9. The Games
     0. The Carnival Office
     A. Back Stage
     B. Hell Ride
     C. The Electrical Area
     D. Where Are The Fuses?
     E. The Control Room
     F. How Points Are Awarded (Spoilers)

>d
(Where Are The Fuses?)

     1. Where's the Aqua fuse?
     2. Where's the Crimson fuse?
     3. Where's the Emerald fuse?
     4. Where's the Gray fuse?
     5. Where's the Indigo fuse?
     6. Where's the Khaki fuse?
     7. Where's the Magenta fuse?
     8. Where's the Orange fuse?
     9. Where's the Quartz fuse?

* * *

>[esc]
(Where Are The Fuses?)

     1. Where's the Aqua fuse?
     2. Where's the Crimson fuse?
     3. Where's the Emerald fuse?
     4. Where's the Gray fuse?
     5. Where's the Indigo fuse?
     6. Where's the Khaki fuse?
     7. Where's the Magenta fuse?
     8. Where's the Orange fuse?
     9. Where's the Quartz fuse?

>[esc]
(If you're using a screen reader, press S to turn on Screen Reader mode. This message only appears on the front page of the menu system.)

     1. Introduction to Hell Ride
     2. Hell Ride Origins
     3. Introduction to Interactive Fiction
     4. Settings
     5. Credits
     6. ----- These Hints Below Contain Out Right Spoilers -----
     7. The Parking Lot
     8. The Attractions
     9. The Games
     0. The Carnival Office
     A. Back Stage
     B. Hell Ride
     C. The Electrical Area
     D. Where Are The Fuses?
     E. The Control Room
     F. How Points Are Awarded (Spoilers)

>e
(The Control Room)

     1. Tell me about the big switch.
     2. What about the control panels?

* * *

>2
(The Control Room - What about the control panels?)

Press H to reveal the first hint.

------------------------

>h
(The Control Room - What about the control panels?)

1/8: There's a dial, a button, and a light in each one.

Press H to reveal another hint.

------------------------

>h
(The Control Room - What about the control panels?)

1/8: There's a dial, a button, and a light in each one.

2/8: These are pretty colors.

Press H to reveal another hint.

------------------------

>h
(The Control Room - What about the control panels?)

1/8: There's a dial, a button, and a light in each one.

2/8: These are pretty colors.

3/8: Have you seen these colors anywhere else?

Press H to reveal another hint.

------------------------

>h
(The Control Room - What about the control panels?)

1/8: There's a dial, a button, and a light in each one.

2/8: These are pretty colors.

3/8: Have you seen these colors anywhere else?

4/8: Try spinning the dials.

Press H to reveal another hint.

------------------------

>h
(The Control Room - What about the control panels?)

1/8: There's a dial, a button, and a light in each one.

2/8: These are pretty colors.

3/8: Have you seen these colors anywhere else?

4/8: Try spinning the dials.

5/8: Spin the dials to the right number.

Press H to reveal another hint.

------------------------

>h
(The Control Room - What about the control panels?)

1/8: There's a dial, a button, and a light in each one.

2/8: These are pretty colors.

3/8: Have you seen these colors anywhere else?

4/8: Try spinning the dials.

5/8: Spin the dials to the right number.

6/8: Is there a number that corresponds to each color?

Press H to reveal another hint.

------------------------

>h
(The Control Room - What about the control panels?)

1/8: There's a dial, a button, and a light in each one.

2/8: These are pretty colors.

3/8: Have you seen these colors anywhere else?

4/8: Try spinning the dials.

5/8: Spin the dials to the right number.

6/8: Is there a number that corresponds to each color?

7/8: Aqua = A = 1, Crimson = C = 3, etc.

Press H to reveal another hint.

------------------------

>h
(The Control Room - What about the control panels?)

1/8: There's a dial, a button, and a light in each one.

2/8: These are pretty colors.

3/8: Have you seen these colors anywhere else?

4/8: Try spinning the dials.

5/8: Spin the dials to the right number.

6/8: Is there a number that corresponds to each color?

7/8: Aqua = A = 1, Crimson = C = 3, etc.

8/8: Push the indigo button.

(You have revealed all the hints on this page.)

------------------------

>[esc]
(The Control Room)

     1. Tell me about the big switch.
     2. What about the control panels?

>[esc]
(If you're using a screen reader, press S to turn on Screen Reader mode. This message only appears on the front page of the menu system.)

     1. Introduction to Hell Ride
     2. Hell Ride Origins
     3. Introduction to Interactive Fiction
     4. Settings
     5. Credits
     6. ----- These Hints Below Contain Out Right Spoilers -----
     7. The Parking Lot
     8. The Attractions
     9. The Games
     0. The Carnival Office
     A. Back Stage
     B. Hell Ride
     C. The Electrical Area
     D. Where Are The Fuses?
     E. The Control Room
     F. How Points Are Awarded (Spoilers)

>f
( - How Points Are Awarded (Spoilers))

Note that not all of these points are awarded. Some are mutually exclusive of others.

5 - Eating the blueberries
5 - Finding the coins and keys
5 - Buying the Hell Ride ticket
5 - Wearing the sheer veil
5 - Finding the Cash 'N' Carry invoice
5 - Finding the Oriental Trading invoice
5 - Finding the Frank's Market invoice
5 - Finding the Mystic Industries invoice
5 - Finding the insurance policy
5 - Acquiring the brass key
10 - Acquiring the cashier's check
5 - Acquiring the pliers
5 - Taking the lantern
5 - Taking the flashlight
5 - Taking the Mercury dime
10 - Turning off the big switch
5 - Finding the Control Room
5 - Finding the Dark Passage
5 - Bringing the wrench to the Bumper Cars
10 - Acquiring the Aqua fuse
10 - Acquiring the Emerald fuse
10 - Acquiring the Gray fuse
10 - Acquiring the Indigo fuse
10 - Acquiring the Khaki fuse
5 - Flipping the Aqua switch
5 - Flipping the Crimson switch
5 - Flipping the Emerald switch
5 - Flipping the Gray switch
5 - Flipping the Indigo switch
5 - Flipping the Khaki switch
5 - Winning the teddy bear
10 - Winning the Swiss Army knife
5 - Winning the poster of Taylor Swift
5 - Winning the Magenta fuse
5 - Winning the stuffed monkey
5 - Winning the Orange fuse
5 - Winning the poster of Billie Eilish
5 - Winning the horseshoe magnet
5 - Winning the Crimson fuse
5 - Winning the a plush donkey
5 - Winning the goldfish in a bowl
5 - Winning the poster of Lourde

------------------------

>[esc]
(If you're using a screen reader, press S to turn on Screen Reader mode. This message only appears on the front page of the menu system.)

     1. Introduction to Hell Ride
     2. Hell Ride Origins
     3. Introduction to Interactive Fiction
     4. Settings
     5. Credits
     6. ----- These Hints Below Contain Out Right Spoilers -----
     7. The Parking Lot
     8. The Attractions
     9. The Games
     0. The Carnival Office
     A. Back Stage
     B. Hell Ride
     C. The Electrical Area
     D. Where Are The Fuses?
     E. The Control Room
     F. How Points Are Awarded (Spoilers)

>[esc]
Parking Lot
The carnival parking lot stretches across an open field, its gravel crunching under arriving cars. Temporary floodlights and the carnival's colorful glow light the area, while distant laughter, music, and the hum of rides fill the air.

Cars park haphazardly, guided by makeshift signs and fluttering flags. Families unload strollers and blankets, their chatter mixing with the carnival sounds. Others linger in vehicles, preparing for the chilly evening.

Shadows from nearby trees create dark pockets pierced by the occasional flashlight. Near the entrance, an attendant collects fees at a weathered booth, coins jingling in the cash box.

Puddles from recent rain shimmer with reflected lights, while patches of mud cling to unwary shoes. At the far end, RVs and trailers sit quietly, their occupants watching the Ferris wheel spin lazily against the sky.

Alive with anticipation, the parking lot marks the transition from the ordinary to the magic of the carnival.

The midway is to the south. There is a blueberry bush here. There are blueberries on the bush.

Your car is here. It's a bit of a beater. Inside the car, you can see the glove box, the seat, the rear view mirror, the ignition, and the dashboard.

You can see a Parking Attendant here.

The attendant has a parking ticket. The price of a parking ticket is $5.00.

* * *

>purloin all fuses
[Purloined.]
[Purloined.]
[Purloined.]
[Purloined.]
[Purloined.]
[Purloined.]
[Purloined.]
[Purloined.]
[Purloined.]

>purloin all invoices
[Purloined.]
[Purloined.]
[Purloined.]
[Purloined.]

>purloin pliers
[Purloined.]

>purloin cashier's check
[Purloined.]

>gonear janitor
Head of the Line
You are standing in front of an attendant with his hand open waiting for your ticket. The entrance to the ride is south of here. The ride operator tells you that you're lucky you showed up when you did because this will be the last trip through Hell Ride for the night. You notice that all the other cars are empty. The Ticket Kiosk is north of here.

You can see a janitor and a Hell Ride Attendant here.

[Your score has just gone up by five points.]

[Your score has just gone up by five points.]

[Your score has just gone up by five points.]

[Your score has just gone up by five points.]

[Your score has just gone up by ten points.]

[Your score has just gone up by five points.]

[Your score has just gone up by ten points.]

[Your score has just gone up by ten points.]

[Your score has just gone up by ten points.]

[Your score has just gone up by ten points.]

[Your score has just gone up by ten points.]

[Your score has just gone up by five points.]

[Your score has just gone up by five points.]

[Your score has just gone up by five points.]

>ask janitor about hell ride
The janitor looks bored as he waits for you to speak.

"Hell Ride is a finicky ride. I'm fixing something there every week. Last week, Mr. Whidbey asked me to skip Hell Ride's maintenance slot. There was a real fire in the Stakes Room last month. And just yesterday I caught him creeping around the guillotine room" says the janitor.

>ask janitor about mr whidbey
The janitor looks at you and waits for you to proceed.

The janitor says , "Mr. Whidbey? He creeps me out. It always seems like he's hiding something. Just yesterday I caught him sneaking around the guillotine room in Hell Ride."

>ask janitor about invoices
The janitor looks bored as he waits for you to speak.

The janitor says, "Wow! These don't look good. Looks like the carnival owes a lot of money! Cash 'N' Carry provides every day supplies. Why is this overdue? I hope I don't lose my job!"

>ask janitor about insurance policy
The janitor looks at you expectantly.

"An insurance policy? For a million bucks? Maybe that fire last month wasn't an accident" the janitor says.

>ask janitor about ferris wheel
The janitor looks bored as he waits for you to speak.

The janitor remarks, "The other day, I found a bolt on one of the gondolas so loose it had almost come off. That would have been a tragedy!"

>ask janitor about bumper cars
The janitor looks at you and waits for you to proceed.

The janitor says, "That reminds me. Not long ago, one of the bumper cars was shorting out and electrifying the car. A visitor got hurt. A young lad, what was his name? Fred something, I think."

>ask janitor about esmeralda
The janitor looks at you expectantly.

"Her fortunes are always crazy accurate. She's spooky and so pretty. I wonder if I should ask her out on a date?" the janitor asks.

>ask janitor about dime toss
The janitor looks bored as he waits for you to speak.

The janitor says, "The problem with that one is that a modern dime weighs 2.268 grams and isn't heavy enough to land on the plate. The trick with that one is to find a Mercury dime. It weighs 2.50 grams."

>ask janitor about pitchers mound
The janitor looks at you expectantly.

The janitor says "That's a tricky one. You have to aim at just the right bottle. Throw the baseball at bottle 5."

>ask janitor about high striker
The janitor looks bored as he waits for you to speak.

"Another rigged game. The mallet isn't heavy enough to strike the bell. Find something heavier" says the janitor.

>ask janitor about fuses
The janitor looks at you and waits for you to proceed.

The janitor says "Funny thing about that. The fuses that belong in the electrical panels in the electrical area of backstage seem to be missing. Finding them might help with disabling Hell Ride."

>ask janitor about fire
The janitor looks at you expectantly.

"The very real fire in the Stakes Room in Hell Ride was a scary event. I couldn't put it out with a fire extinguisher. We had to wait for the fire department and by then there was a lot of damage done" says the janitor.

>ask janitor about accidents
The janitor looks bored as he waits for you to speak.

The janitor says "The fire, the Ferris wheel, the Bumper Cars... That's a lot of suspicious accidents."

>ask janitor about rides
The janitor looks at you and waits for you to proceed.

"Almost every ride is falling apart. I do what I can to keep things in good repair but it's a lot of work" says the janitor.

>ask janitor about games
The janitor looks at you expectantly.

"Crooked! Everyone of them. There's a secret to each one of them" the janitor says.

>showme total evidence
There seems to be no such object anywhere in the model world.

>display evidence
total evidence: 31.
Evidence acquired by asking the janitor about:
- Hell Ride.
- Mr Whidbey.
- Invoices.
- Insurance Policy.
- Ferris Wheel.
- Bumper Cars.
- The Stake Room Fire.
- Accidents.
- Attractions.

Evidence acquired by showing something to the janitor:

Evidence acquired by asking Mr Whidbey about:

Evidence acquired by showing something to Mr Whidbey:

>show cash 'n' carry to janitor
The janitor says, "Man, this doesn't look good for the carnival."

>show frank's market to janitor
The janitor says, "Looks like the carnival is in some financial trouble."

The janitor heads to the Bumper Cars.

>gonear janitor
Bumper Cars
The bumper cars is a bustling hub of excitement and laughter, set beneath a canopy of flashing lights and colorful decorations. The rectangular arena is surrounded by padded barriers, ensuring a safe yet thrilling experience for riders. The floor, slick and metallic, allows the brightly colored cars - painted in shades of red, blue, yellow, and green - to glide effortlessly in all directions.

Each car is equipped with a steering wheel and a padded bumper, designed to absorb the impact of playful collisions. As the ride begins, drivers of all ages eagerly maneuver their cars, aiming for friends, family, or strangers with mischievous grins. The air is filled with the sound of bumpers colliding, laughter, and the occasional squeal of surprise.

Overhead, a web of electric poles connects the cars to the ceiling, sparking faintly as they supply power to the vehicles. The ride operator watches from a booth, ensuring everyone enjoys the chaos safely. Surrounding the bumper cars are cheering onlookers, carnival lights, and the lively hum of the fairground.

The bumper cars perfectly captures the playful spirit of the carnival, offering a mix of harmless competition, shared laughter, and nostalgic fun for all ages. The Ticket Kiosk is southeast of here.

You can see a janitor and a Bumper Cars attendant here.

>show oriental trading to janitor
The janitor says, "These prizes are cheaper and flimsier than usual."

>show mystic industries to janitor
The janitor says, That fire in Hell Ride was very really bad. It took almost two weeks to get it fully repaired. But it shouldn't have cost this much. I think Mr Whidbey got ripped off."

>purloin paperwork
[Purloined.]

>purloin insurance policy
[Purloined.]

>show paperwork to janitor
The janitor says, "This all points the finger at mismanagement. I sure hope Mr Whidbey has a plan."

[Your score has just gone up by five points.]

>show insurance policy to janitor
"An insurance policy? For a million dollars? SOmething is fishy for sure!" the janitor says.

The janitor heads to the Ticket Booth.

>gonear janitor
Ticket Booth
The ticket kiosk stands at the carnival entrance, a compact booth painted in bright red and yellow stripes with bold letters above the window reading "Tickets Here!" Twinkling lights outline its edges, blinking rhythmically to draw attention.

A single window serves visitors, where a smiling cashier dispenses colorful tickets from neatly arranged rolls. Beside the tickets, a cash drawer jingles as change is counted, and a digital payment system glows faintly for modern convenience. Too bad you don't have a debit card.

Next to the kiosk, a vibrant signboard lists ticket prices with playful illustrations of rides. Pennant flags flutter from the kiosk's roof, adding to the festive atmosphere, while the smell of popcorn and pretzels wafts from the southwest.

The worn ground around the kiosk shows the passage of eager carnival-goers. Families, couples, and friends form a buzzing line, their excitement building as they approach this first step into the magic of the carnival.

The midway continues in all directions from here. There is a cashier here. A price list for attraction tickets is on the signboard. The cashier has Hell Ride ticket, Fortune Teller ticket, Ferris Wheel ticket, Bumper Cars ticket, and Carousel ticket.

You can see a janitor, Mr Whidbey, a Cashier, and a ticket kiosk here.

>show pliers to janitor
"I've been missing those. Where did you find them?" asks the janitor.

>show cashier's check to janitor
The janitor says "What?! That's the name of the kid who got hurt in the Bumper Cars incident."

Mr Whidbey heads to the Head of the Line.

>show aqua fuse to janitor
"Hey! That's important. It should be in an electrical panel", the janitor says.

>show indigo fuse to janitor
"Hey! That's important. It should be in an electrical panel" the janitor asks.

The janitor heads to the Carousel.

>display evidence
total evidence: 53.
Evidence acquired by asking the janitor about:
- Hell Ride.
- Mr Whidbey.
- Invoices.
- Insurance Policy.
- Ferris Wheel.
- Bumper Cars.
- The Stake Room Fire.
- Accidents.
- Attractions.

Evidence acquired by showing something to the janitor:
- Cash 'N' Carry Invoice
- Frank's Market Invoice
- Oriental Trading Invoice
- Mystic Industries Invoice
- Paperwork
- Insurance Policy
- The Pliers
- Cashier's Check
- Aqua Fuse
- Indigo Fuse

Evidence acquired by asking Mr Whidbey about:

Evidence acquired by showing something to Mr Whidbey:

>gonear mr whidbey
Head of the Line
You are standing in front of an attendant with his hand open waiting for your ticket. The entrance to the ride is south of here. The ride operator tells you that you're lucky you showed up when you did because this will be the last trip through Hell Ride for the night. You notice that all the other cars are empty. The Ticket Kiosk is north of here.

You can see Mr Whidbey and a Hell Ride Attendant here.

>confront whidbey about fraud
Mr Whidbey nervously shifts his weight from one foot to the other.

Mr Whidbey says, "OK, maybe there's enough evidence to have me charged with fraud but they'll never make it stick."

>ask whidbey about hell ride
Mr Whidbey looks at you expectantly.

"Hell Ride is the premier attraction here at  Whidbey Amusements. It's both spooky and fun! The visitors love it! The fire last month was unfortunate and expensive" says Mr Whidbey.

Mr. Whidbey's eyes dart up and to the left.

>ask whidbey about invoices
Mr Whidbey waits for you to speak.

Mr Whidbey says, "I know this doesn't look good but the cost of consumables go up every week and attendance is down. I have to pinch pennies somehow, don't I? And that fire was very expensive to repair."

>ask whidbey about insurance policy
Mr Whidbey looks at you expectantly.

"An insurance policy? Of course, all reputable businesses have insurance. Even small time carnivals" Mr Whidbey stammers.

>ask whidbey about carnival
Mr Whidbey nervously shifts his weight from one foot to the other.

"The Whidbey family has owned this carnival since the 1957", Mr Whidbey says. "Unfortunately, I am an only child and never married. Alas, the carnival will close when I am gone. But for now, it's making a comeback!"

>ask whidbey about ferris wheel
Mr Whidbey looks at you expectantly.

Mr Whidbey says "The Ferris Wheel is my favorite ride. It's always relaxing and romantic."

Mr. Whidbey quickly changes the subject

>ask whidbey about carousel
Mr Whidbey nervously shifts his weight from one foot to the other.

"The carousel is just one of the many rides that thrill and delight our visitors every day," says Mr Whidbey

>ask whidbey about bumper cars
Mr Whidbey waits for you to speak.

"That incident the other week with that Needleman kids was unfortunate" says Mr Whidbey.

>ask whidbey about esmeralda
Mr Whidbey looks at you expectantly.

Mr Whidbey says "I see her regularly to have my fortune told. We're lucky to have her here. She's very beautiful. It's a wonder she's never been married."

>ask whidbey about dime toss
Mr Whidbey waits for you to speak.

"The Dime Toss is is one of the many games that thrill and delight our visitors every day!" says Mr Whidbey.

Mr. Whidbey meets your eyes and quickly looks away.

>ask whidbey about pitchers mound
Mr Whidbey looks at you expectantly.

"The Pitchers Mound is is one of the many games that thrill and delight our visitors every day!" says Mr Whidbey.

>ask whidbey about high striker
Mr Whidbey waits for you to speak.

"The High Striker is is one of the many games that thrill and delight our visitors every day!" says Mr Whidbey.

>ask whidbey about fuses
Mr Whidbey looks at you expectantly.

"I know nothing about fuses", Mr Whidbey says.

>ask whidbey about indigo fuse
Mr Whidbey waits for you to speak.

"Where did you get that?" Mr Whidbey asks.

Mr. Whidbey's eyes dart up and to the left.

>ask whidbey about fire
Mr Whidbey nervously shifts his weight from one foot to the other.

The fire was most unfortunate. It put Hell Ride out of commission for two weeks. Not only did it cost me $22,500 to repair but I lost revenue while it was closed.

>ask whidbey about pliers
Mr Whidbey waits for you to speak.

"Oh! I thought I lost... um, those belong to the janitor. Where did you find them?" asks Mr Whidbey.

>ask whidbey about fred needleman
Mr Whidbey looks at you expectantly.

Mr Whidbey says "Uh, Fred is a special... contractor... We paid him. For services rendered."

>ask whidbey about services rendered
Mr Whidbey nervously shifts his weight from one foot to the other.

"Fred did some work over at the bumper cars" says Mr Whidbey.

Mr. Whidbey quickly changes the subject

>display evidence
total evidence: 78.
Evidence acquired by asking the janitor about:
- Hell Ride.
- Mr Whidbey.
- Invoices.
- Insurance Policy.
- Ferris Wheel.
- Bumper Cars.
- The Stake Room Fire.
- Accidents.
- Attractions.

Evidence acquired by showing something to the janitor:
- Cash 'N' Carry Invoice
- Frank's Market Invoice
- Oriental Trading Invoice
- Mystic Industries Invoice
- Paperwork
- Insurance Policy
- The Pliers
- Cashier's Check
- Aqua Fuse
- Indigo Fuse

Evidence acquired by asking Mr Whidbey about:
- Invoices
- Insurance Policy
- Carnival
- Bumper Cars
- The Indigo Fuse
- The Stake Room Fire
- The Pliers
- Fred Needleman
- Services Rendered

Evidence acquired by showing something to Mr Whidbey:

>confront whidbey about fraud
Mr Whidbey waits for you to speak.

Mr Whidbey says, "OK, maybe there's enough evidence to have me charged with fraud but they'll never make it stick."

>show cash 'n' carry to whidbey
Mr Whidbey says, "Money's a little tight. The cost of consumables go up every week."

>show oriental trading to whidbey
Mr Whidbey says, "There must be prizes for the games otherwise visitors wouldn't play them. Maybe people won't win so often."

>ne
You can't go that way.

Mr Whidbey heads to the Gallows Room.

>purloin tickets
[Purloined.]
[Purloined.]
[Purloined.]
[Purloined.]
[Purloined.]

>s
You'll need a ticket to go that way.

[Your score has just gone up by five points.]

>give ticket
(the Hell Ride ticket to the Hell Ride Attendant)
You give the Hell Ride ticket to the Hell Ride Attendant.

>s
Ride Entrance
The cars that will take you into the fearsome Hell Ride stop here for you to board and then move forward, the safety bar locked in place, as the entrance to Hell Ride looms ahead - a grotesque facade of twisted metal and carved wood, illuminated by flickering blood-red lights. The air carries a faint sulfuric tang mingled with the sweet aroma of carnival popcorn.

A towering archway of flames, spikes, and grinning skulls frames the entrance, crowned by flickering letters that read "HELL RIDE", pulsing like a heartbeat. Below, crouching demon sculptures extend clawed hands in a sinister invitation. Wooden doors cover the entrance, whispering with faint, menacing chuckles as distorted organ music grows louder, punctuated by shrieks and grinding machinery.

Inside, near-total darkness is broken by flashes of sickly green light revealing twisted paths and grotesque shapes. Beyond the threshold lies only uncertainty and terror. To one side, the darkness looks a little bit darker than the rest of the room.

You can see a Hell Ride car (empty) here.

>e
Dark Passage
This room is backstage at the Hell Ride attraction. The room is littered with bags of trash, piles of junk, and dust bunnies so large they should be paying rent. There an exit to the south and west.

[Your score has just gone up by five points.]

>i
You are carrying:
  a Bumper Cars ticket
  a Carousel ticket
  a Ferris Wheel ticket
  a Fortune Teller ticket
  an insurance policy
  some paperwork
  a cashier's check
  some pliers
  a Mystic Industries invoice
  an Oriental Trading invoice
  a Frank's Market invoice
  a Cash 'N' Carry invoice
  an aqua colored fuse
  an emerald colored fuse
  a quartz colored fuse
  an orange colored fuse
  a crimson colored fuse
  a khaki colored fuse
  a magenta colored fuse
  a gray colored fuse
  an indigo colored fuse
  a wallet
    a coupon
    $35.00 in cash
  a fanny pack (being worn, and open but empty)

>put all tickets in fanny pack
Bumper Cars ticket: Done.
Carousel ticket: Done.
Ferris Wheel ticket: Done.
Fortune Teller ticket: Done.

>l under pile
This is a pile of assorted flotsam and jetsam from the carnival. None of it looks very interesting.

In the pile of junk is a flashlight.

>get flashlight
Taken.

[Your score has just gone up by five points.]

* * *

>turn it on
You flip a switch. A strong, narrow beam of light shines from the lit flashlight.

>s
Maintenance Office
The maintenance office, hidden behind the carnival's bright facade, is a dim and cluttered space reeking of grease, sweat, and faint traces of popcorn from the midway. The air hangs heavy with oil and stirred-up dust.

The walls are lined with shelves holding tools and parts in disarray - screws and mismatched jars with faded labels. Paint cans and grease jars clutter the workbenches, many left half-open. In the center, a battered desk is strewn with wires, gears, and springs, a bent piece of metal held in a vise. Overhead, a single flickering fluorescent light struggles to illuminate the room.

In one corner, a disassembled ride mechanism lies exposed, chains and pulleys dangling from hooks above, faintly clinking with the vibrations of the rides. A grease-stained manual and a half-drained mug of coffee sit abandoned on a nearby stool.

The walls display faded safety posters, a cork board with maintenance schedules and notes, and a worn photo of the carnival in its prime. A clock ticks faintly, its hands out of sync with reality. The floor, gritty with dust and scattered nails, adds to the room's chaotic charm.

Despite the mess, the room buzzes with purpose - a hidden hub where the carnival's magic is sustained through sweat, ingenuity, and the hum of machinery.

Exits lead north and south.

Nearby a ladder leads up.

Nearby an aqua colored door leads west.

You can also see a worn photo and a desk (on which are a coffee mug and a radio) here.

>purloin silver key
[Purloined.]

>w
(first opening the aqua colored door)
(first unlocking the aqua colored door)
(with the silver key)

Stocks Room
The public square is a cobblestone expanse bordered by weathered timber-framed buildings. The air carries the mingling scents of chimney smoke, damp earth, and the faint tang of a nearby smithy. At its center, crude wooden stocks stand as a grim focal point, their beams weathered and stained from years of use. Iron clasps lock captives in degrading postures, their tattered clothing offering little protection from the biting wind.

The animatronics and wax figures are extremely life like. Hell Ride sure lives up to its name.

The punished individuals hang their heads in shame, their faces etched with despair. Around them, the crowd revels in cruelty - a wiry man spits insults with gleeful laughter, while a stout woman throws overripe vegetables, each impact sparking jeers. Even children join in, pointing and mocking with mischievous delight.

The square hums with noise: the crowd's taunts, the crack of objects hitting wood, and the quiet murmurs of the suffering captives. Overhead, a gray sky threatens rain, indifferent to the spectacle below. The jeering mob ignores its ominous weight, too engrossed in their shared cruelty to notice nature's disapproval.

Nearby an aqua colored door leads east to the Maintenance Office.

You can also see a wooden stocks here.

>gonear whidbey
Dungeon
The dungeon is a dark, suffocating chamber carved into the earth, its stone walls slick with moisture and grime. The air reeks of sweat, blood, mildew, and burning oil from flickering torches mounted on rusted sconces. Shadows twist on the walls, creating grotesque, unsettling shapes in the dim light.

Chains hang from walls and ceilings, their faint clinking blending with the moans and occasional screams of prisoners. Water drips rhythmically from a cracked ceiling, adding to the chamber's eerie ambiance.

The room is littered with instruments of torment: a splintered rack, a glowing brazier holding bloodstained tools, and a spiked chair gleaming faintly in the light. Prisoners endure their own horrors - one stretched on the rack, another hanging limply from manacles, and a third gasping weakly in the spiked chair.

The hooded torturer moves with detached precision, their leather apron stained with the evidence of countless victims. They work silently, indifferent to the agony surrounding them.

Above, rats scuttle in the shadows, and the low ceiling presses down like the weight of despair. This is a realm of suffering and hopelessness, where life and death blur, and torment is the only certainty.

Nearby a gray colored door leads east.

You can also see Mr Whidbey, an iron chair, a splintered rack, and a glowing brazier here.

>show frank's to whidbey
Mr Whidbey says, "I can't keep up with the cost of ingredients. Everything costs so much!"

>show mystic industries to whidbey
Mr Whidbey says, That fire in Hell Ride was very expensive to repair. And it put the ride out of commission for two weeks."

Mr. Whidbey's eyes dart up and to the left.

>purloin paperwork
[Purloined.]

>show paperwork to whidbey
Mr Whidbey says, "I know this doesn't look good but the cost of consumables go up every week and attendance is down. I have to pinch pennies somehow, don't I? And that fire was very expensive to repair."

Mr Whidbey heads to the Guillotine Room.

>purloin policy
[Purloined.]

>gonear whidbey
Guillotine Room
The public square buzzes with tense anticipation, a crowd gathered under gray skies that cast a somber light on the cobblestones. At the center, a stark wooden platform looms, its purpose grim and unavoidable.

A lone figure stands on the scaffold, bound hands behind their back and head bowed low, avoiding the crowd's gaze. Their tattered clothing, once fine, reflects the fall that led them to this moment.

The crowd encircles the platform, emotions ranging from jeers and curses to silent, grim observation. Children sit on shoulders, their curious eyes unaware of the event's gravity. Near the edge of the platform, the town crier proclaims the crime: "High treason against the crown. Let this be a warning to all who defy the realm!"

The condemned flinches but remains silent as the executioner - a hooded figure in black - stands ready beside the guillotine, its blade gleaming faintly in the dim light. The murmurs of the crowd fall into silence at the executioner's signal, leaving only the rustle of wind and the creak of the scaffold.

As the condemned approaches the guillotine, a crow caws sharply from a nearby rooftop, its cry echoing through the square like an omen. The crowd leans forward, breath held, as justice and mortality converge on the scene.

There is just one problem: the guillotine is being raised and lowered by some mechanism. It appears that the timing of the guillotine is off and it is being lowered onto the cars instead of between them. If a person were to be in a car as it passed under the guillotine, they would be seriously injured.  You're glad you're not in one of those cars now. 

Nearby an indigo colored door leads east.

You can also see Mr Whidbey and a guillotine platform here.

>show insurance policy to whidbey
"An insurance policy? Of course, all reputable business have insurance. Even small time carnivals", Mr Whidbey stammers.

>i
You are carrying:
  an insurance policy
  some paperwork
  a silver key
  a lit flashlight (providing light)
  a cashier's check
  some pliers
  a Mystic Industries invoice
  an Oriental Trading invoice
  a Frank's Market invoice
  a Cash 'N' Carry invoice
  an aqua colored fuse
  an emerald colored fuse
  a quartz colored fuse
  an orange colored fuse
  a crimson colored fuse
  a khaki colored fuse
  a magenta colored fuse
  a gray colored fuse
  an indigo colored fuse
  a wallet
    a coupon
    $35.00 in cash
  a fanny pack (being worn, and open)
    a Fortune Teller ticket
    a Ferris Wheel ticket
    a Carousel ticket
    a Bumper Cars ticket

>s
Ride Exit
The exit of Hell Ride is designed to leave riders with lingering unease. Emerging from a dark corridor with peeling black and red-streaked walls, flickering lights cast erratic shadows on the uneven floor. The air is cool and damp, carrying a faint metallic tang, while faint whispers and distant screams echo softly in the background.

Riders step into a small courtyard enclosed by jagged, rusted fencing draped with cobwebs and plastic skulls. Overhead, a weathered sign reads, "You've Survived… For Now." Nearby, carnival workers in tattered costumes watch silently, occasionally muttering cryptic remarks like, "Not everyone makes it out."

A merchandise display glows red, selling items like Hell Ride Survivor t-shirts and key chains. Beyond the fencing, the cheerful carnival lights and sounds feel jarring, contrasting sharply with the ride's oppressive atmosphere.

The exit ensures Hell Ride isn't just an experience - it lingers, blurring the line between thrill and fear.

There is a price list next to the cash register. An attendant is here to assist you with your purchases. The stand has Plastic Bones, Devil Horns, Key Chains, and T-Shirts for sale.

Nearby a khaki colored door leads east.

You can also see a Merchandise Attendant here.

>gonear whidbey
Guillotine Room
The public square buzzes with tense anticipation, a crowd gathered under gray skies that cast a somber light on the cobblestones. At the center, a stark wooden platform looms, its purpose grim and unavoidable.

A lone figure stands on the scaffold, bound hands behind their back and head bowed low, avoiding the crowd's gaze. Their tattered clothing, once fine, reflects the fall that led them to this moment.

The crowd encircles the platform, emotions ranging from jeers and curses to silent, grim observation. Children sit on shoulders, their curious eyes unaware of the event's gravity. Near the edge of the platform, the town crier proclaims the crime: "High treason against the crown. Let this be a warning to all who defy the realm!"

The condemned flinches but remains silent as the executioner - a hooded figure in black - stands ready beside the guillotine, its blade gleaming faintly in the dim light. The murmurs of the crowd fall into silence at the executioner's signal, leaving only the rustle of wind and the creak of the scaffold.

As the condemned approaches the guillotine, a crow caws sharply from a nearby rooftop, its cry echoing through the square like an omen. The crowd leans forward, breath held, as justice and mortality converge on the scene.

There is just one problem: the guillotine is being raised and lowered by some mechanism. It appears that the timing of the guillotine is off and it is being lowered onto the cars instead of between them. If a person were to be in a car as it passed under the guillotine, they would be seriously injured.  You're glad you're not in one of those cars now. 

Nearby an indigo colored door leads east.

You can also see Mr Whidbey and a guillotine platform here.

Mr Whidbey heads to the Carnival Office.

>s
Ride Exit
The exit of Hell Ride is designed to leave riders with lingering unease. Emerging from a dark corridor with peeling black and red-streaked walls, flickering lights cast erratic shadows on the uneven floor. The air is cool and damp, carrying a faint metallic tang, while faint whispers and distant screams echo softly in the background.

Riders step into a small courtyard enclosed by jagged, rusted fencing draped with cobwebs and plastic skulls. Overhead, a weathered sign reads, "You've Survived… For Now." Nearby, carnival workers in tattered costumes watch silently, occasionally muttering cryptic remarks like, "Not everyone makes it out."

A merchandise display glows red, selling items like Hell Ride Survivor t-shirts and key chains. Beyond the fencing, the cheerful carnival lights and sounds feel jarring, contrasting sharply with the ride's oppressive atmosphere.

The exit ensures Hell Ride isn't just an experience - it lingers, blurring the line between thrill and fear.

There is a price list next to the cash register. An attendant is here to assist you with your purchases. The stand has Plastic Bones, Devil Horns, Key Chains, and T-Shirts for sale.

Nearby a khaki colored door leads east.

You can also see a Merchandise Attendant here.

>gonear whidbey
Carnival Office
Dim, yellow light from an overhead bulb casts long shadows over the room, A single desk lamp, flickering provides additional light. A few carnival-themed knick-knacks sit atop the desk. A framed photograph hangs askew on the wall.

The desk is covered in stacks of paperwork, old receipts, invoices, and faded carnival brochures. A locked cabinet is tucked away against one wall. Next to it, there's a small, heavy safe.

Nearby a sturdy door leads north.

On the messy desk are a mini Ferris wheel and a mini carousel.

You can also see Mr Whidbey, a safe (closed), a filing cabinet (closed), and a framed photograph here.

As you enter the room, you see Mr Whidbey with his back to the door. He's talking on the telephone.

"Hello? Oh, it's you." says Mr. Whidbey.

>z
Time passes.

Mr. Whidbey listens to the other end of the conversation.

>z
Time passes.

"I know, I know, but what am I supposed to do. That Needleman kid isn't happy with the payout we gave him. He wants $15,000 more."

>z
Time passes.

Mr Whidbey heads to the Concession Stand.

Isn't this why I buy insurance? Don't worry. You'll get your piece.

>z
Time passes.

Mr. Whidbey says "I need that money in a hurry though or he's going to go to the authorities. And then you're going down too."

>z
Time passes.

"Ok, I'll try to stall him but I won't be able to do it for long."

>z
Time passes.

"Hey! What are you doing here? This is an employees only area," Mr. Whidbey shouts at you. "Get out of here. Now!"

Concession Stand
The concession stand, perched along the midway, is a colorful and bustling hub. Painted in bright reds, blues, and yellows, it features bold lettering announcing treats like "SODA! POPCORN! CANDY APPLES!" Strings of twinkling lights frame the stand, making it a glowing beacon amid the carnival excitement.

Behind the counter, a popcorn machine churns out golden kernels, filling the air with a buttery aroma. Candy apples gleam under the lights, and cotton candy machines spin fluffy clouds of pink and blue. Warm pretzels sit under a heat lamp, their buttery, salted scent mingling with the sugary treats. A cooler holds sodas, their colorful labels visible through the frosted glass.

The counter is lively with stacks of paper bags, napkins, and cups of cheese and sugar sprinkles. A handwritten chalkboard menu lists prices in playful lettering. Workers in colorful aprons quickly hand out snacks, their movements efficient amid the cheerful chaos.

In front of the stand, kids tug at their parents, teens share pretzels, and the crowd buzzes with energy. More than just a snack stop, the stand is a sensory delight, adding flavor and charm to the carnival experience.

To the south is the Carnival Office. The trailer's exterior is painted in dull, peeling shades of red and white, with old carnival advertisements that are barely legible due to sun damage. A string of dimly lit, flickering bulbs hang above the door, and an old "Private" sign is half-hanging on the side, clearly neglected.

There is a menu to the right of the window. You can see the treats inside the stand. There is an exit to the south and northeast. 

Nearby a sturdy door leads south to the Carnival Office.

You can also see Mr Whidbey, a Concession Attendant, a menu, a Drink of Cola, some Bubblegum, a Bucket of Popcorn, a Candy Apple, Cotton Candy, and a Soft Pretzel here.

You suddenly find yourself unceremoniously out of the Carnival Office and into the Concession Stand.

>purloin brass key
[Purloined.]

>s
(first opening the sturdy door)
(first unlocking the sturdy door)
(with the brass key)

Carnival Office
Dim, yellow light from an overhead bulb casts long shadows over the room, A single desk lamp, flickering provides additional light. A few carnival-themed knick-knacks sit atop the desk. A framed photograph hangs askew on the wall.

The desk is covered in stacks of paperwork, old receipts, invoices, and faded carnival brochures. A locked cabinet is tucked away against one wall. Next to it, there's a small, heavy safe.

Nearby a sturdy door leads north to the Concession Stand.

On the messy desk are a mini Ferris wheel and a mini carousel.

You can also see a safe (closed), a filing cabinet (closed), and a framed photograph here.

[Your score has just gone up by five points.]

>purloin policy
[Purloined.]

>gonear whidbey
Concession Stand
The concession stand, perched along the midway, is a colorful and bustling hub. Painted in bright reds, blues, and yellows, it features bold lettering announcing treats like "SODA! POPCORN! CANDY APPLES!" Strings of twinkling lights frame the stand, making it a glowing beacon amid the carnival excitement.

Behind the counter, a popcorn machine churns out golden kernels, filling the air with a buttery aroma. Candy apples gleam under the lights, and cotton candy machines spin fluffy clouds of pink and blue. Warm pretzels sit under a heat lamp, their buttery, salted scent mingling with the sugary treats. A cooler holds sodas, their colorful labels visible through the frosted glass.

The counter is lively with stacks of paper bags, napkins, and cups of cheese and sugar sprinkles. A handwritten chalkboard menu lists prices in playful lettering. Workers in colorful aprons quickly hand out snacks, their movements efficient amid the cheerful chaos.

In front of the stand, kids tug at their parents, teens share pretzels, and the crowd buzzes with energy. More than just a snack stop, the stand is a sensory delight, adding flavor and charm to the carnival experience.

To the south is the Carnival Office. The trailer's exterior is painted in dull, peeling shades of red and white, with old carnival advertisements that are barely legible due to sun damage. A string of dimly lit, flickering bulbs hang above the door, and an old "Private" sign is half-hanging on the side, clearly neglected.

There is a menu to the right of the window. You can see the treats inside the stand. There is an exit to the south and northeast. 

Nearby a sturdy door leads south to the Carnival Office.

You can also see Mr Whidbey, a Concession Attendant, a menu, a Drink of Cola, some Bubblegum, a Bucket of Popcorn, a Candy Apple, Cotton Candy, and a Soft Pretzel here.

Mr Whidbey heads to the Ticket Booth.

>ne
Ticket Booth
The ticket kiosk stands at the carnival entrance, a compact booth painted in bright red and yellow stripes with bold letters above the window reading "Tickets Here!" Twinkling lights outline its edges, blinking rhythmically to draw attention.

A single window serves visitors, where a smiling cashier dispenses colorful tickets from neatly arranged rolls. Beside the tickets, a cash drawer jingles as change is counted, and a digital payment system glows faintly for modern convenience. Too bad you don't have a debit card.

Next to the kiosk, a vibrant signboard lists ticket prices with playful illustrations of rides. Pennant flags flutter from the kiosk's roof, adding to the festive atmosphere, while the smell of popcorn and pretzels wafts from the southwest.

The worn ground around the kiosk shows the passage of eager carnival-goers. Families, couples, and friends form a buzzing line, their excitement building as they approach this first step into the magic of the carnival.

The midway continues in all directions from here. There is a cashier here. A price list for attraction tickets is on the signboard. The cashier has nothing.

You can see Mr Whidbey, a Cashier, and a ticket kiosk here.

>show insurance policy to whidbey
"An insurance policy? Of course, all reputable business have insurance. Even small time carnivals", Mr Whidbey stammers.

The janitor arrives from the Bumper Cars.

>show pliers to whidbey
"Oh! I thought I lost... I mean those belong to the janitor. Where did you find them?" asks Mr Whidbey.

Mr. Whidbey quickly changes the subject

>show cashier's check to whidbey
Mr Whidbey says "Uh, Fred is a special... contractor... We paid him. For services rendered."

>gonear whidbey
Ticket Booth
The ticket kiosk stands at the carnival entrance, a compact booth painted in bright red and yellow stripes with bold letters above the window reading "Tickets Here!" Twinkling lights outline its edges, blinking rhythmically to draw attention.

A single window serves visitors, where a smiling cashier dispenses colorful tickets from neatly arranged rolls. Beside the tickets, a cash drawer jingles as change is counted, and a digital payment system glows faintly for modern convenience. Too bad you don't have a debit card.

Next to the kiosk, a vibrant signboard lists ticket prices with playful illustrations of rides. Pennant flags flutter from the kiosk's roof, adding to the festive atmosphere, while the smell of popcorn and pretzels wafts from the southwest.

The worn ground around the kiosk shows the passage of eager carnival-goers. Families, couples, and friends form a buzzing line, their excitement building as they approach this first step into the magic of the carnival.

The midway continues in all directions from here. There is a cashier here. A price list for attraction tickets is on the signboard. The cashier has nothing.

You can see a janitor, Mr Whidbey, a Cashier, and a ticket kiosk here.

Mr Whidbey heads to the Head of the Line.

>s
Head of the Line
You are standing in front of an attendant. The entrance to the ride is south of here. The ride operator tells you that you're lucky you showed up when you did because this will be the last trip through Hell Ride for the night. You notice that all the other cars are empty. The Ticket Kiosk is north of here.

You can see Mr Whidbey and a Hell Ride Attendant here.

>show indigo fuse to whidbey
"Oh, um, where did you get that?" Mr Whidbey asks.

>display evidence
total evidence: 115.
Evidence acquired by asking the janitor about:
- Hell Ride.
- Mr Whidbey.
- Invoices.
- Insurance Policy.
- Ferris Wheel.
- Bumper Cars.
- The Stake Room Fire.
- Accidents.
- Attractions.

Evidence acquired by showing something to the janitor:
- Cash 'N' Carry Invoice
- Frank's Market Invoice
- Oriental Trading Invoice
- Mystic Industries Invoice
- Paperwork
- Insurance Policy
- The Pliers
- Cashier's Check
- Aqua Fuse
- Indigo Fuse

Evidence acquired by asking Mr Whidbey about:
- Invoices
- Insurance Policy
- Carnival
- Bumper Cars
- The Indigo Fuse
- The Stake Room Fire
- The Pliers
- Fred Needleman
- Services Rendered

Evidence acquired by showing something to Mr Whidbey:
- Cash 'N' Carry Invoice
- Oriental Trading Invoice
- Frank's Market Invoice
- Mystic Industries Invoice
- Paperwork
- Insurance Policy
- The Pliers
- Cashier's Check
- Indigo Fuse

>accuse whidbey of fraud
Mr Whidbey looks at you expectantly.

"Looks like you've caught me red-handed" says Mr Whidbey.

>accuse whidbey of bribery
Mr Whidbey waits for you to speak.

The bumper cars injured that Needleman kid with an electrical shock. He was going to report the carnival to the authorities. So, I had to pay him off to keep him quiet.

>accuse whidbey of extortion
Mr Whidbey looks at you expectantly.

Not satisfied with the first payment, Needleman wanted more money. His latest demand is $15,000.

>confront whidbey about insurance policy
Mr Whidbey waits for you to speak.

I needed the money to cover for Needleman somehow.

* * *

>score
You have not yet achieved anything of note.

>l under seat
You find the three quarters, the nickel, the five dimes, and your keys!

[Your score has just gone up by five points.]

>score
Wow, you've received 5 points out of a possible 200 in 2 moves! I'm very proud of you. This was a triumph. I'm being so sincere right now.

You have received points for the following: 

•  Eating the blueberries:                  : 5 points.
•  Buying the Hell Ride ticket:             : 5 points.
•  Wearing the sheer veil:                  : 5 points.
•  Finding the Cash 'N' Carry invoice:      : 5 points.
•  Finding the Oriental Trading invoice:    : 5 points.
•  Finding the Frank's Market invoice:      : 5 points.
•  Finding the Mystic Industries invoice:   : 5 points.
•  Finding the insurance policy:            : 5 points.
•  Acquiring the brass key:                 : 5 points.
•  Acquiring the cashier's check:           : 10 points.
•  Acquiring the pliers:                    : 5 points.
•  Taking the lantern:                      : 5 points.
•  Taking the flashlight:                   : 5 points.
•  Taking the Mercury dime:                 : 5 points.
•  Turning off the big switch:              : 10 points.
•  Finding the Control Room:                : 5 points.
•  Finding the Dark Passage:                : 5 points.
•  Bringing the wrench to the Bumper Cars:  : 5 points.
•  Acquiring the Aqua fuse:                 : 10 points.
•  Acquiring the Emerald fuse:              : 10 points.
•  Acquiring the Gray fuse:                 : 10 points.
•  Acquiring the Indigo fuse:               : 10 points.
•  Acquiring the Khaki fuse:                : 10 points.
•  Flipping the Aqua switch:                : 5 points.
•  Flipping the Crimson switch:             : 5 points.
•  Flipping the Emerald switch:             : 5 points.
•  Flipping the Gray switch:                : 5 points.
•  Flipping the Indigo switch:              : 5 points.
•  Flipping the Khaki switch:               : 5 points.
•  Winning the teddy bear:                  : 5 points.
•  Winning the Swiss Army knife:            : 10 points.
•  Winning the poster of Taylor Swift:      : 5 points.
•  Winning the Magenta fuse:                : 5 points.
•  Winning the stuffed monkey:              : 5 points.
•  Winning the Orange fuse:                 : 5 points.
•  Winning the poster of Billie Eilish:     : 5 points.
•  Winning the horseshoe magnet:            : 5 points.
•  Winning the Crimson fuse:                : 5 points.
•  Winning the a plush donkey:              : 5 points.
•  Winning the goldfish in a bowl:          : 5 points.
•  Winning the poster of Lourde:            : 5 points.
•  Finding the coins and keys:              : 5 points.

* * *

>test misc
(Testing.)

>[1] brief
Hell Ride is now in its "brief" printing mode, which gives long descriptions of places never before visited and short descriptions otherwise.

>[2] xyzzy
A  hollow voice says "Plugh".

>[3] plugh
Nothing happens.

>[4] hello sailor
Nothing happens here.

>[5] please get the dime
Please do not say "please."

>[6] i
You are carrying:
  an indigo colored fuse
  a khaki colored fuse
  some Bubblegum
  a Soft Pretzel
  Cotton Candy
  a Candy Apple
  a Bucket of Popcorn
  an empty Drink
  a brass ring
    a brass key (which opens the sturdy door)
  a gray colored fuse
  a Swiss Army knife
  a sledgehammer
  a crimson colored fuse
  a horseshoe magnet
  a mallet
  a lit lantern (providing light)
  a sheer veil (being worn)
  an air freshener
  a pair of gloves (being worn)
  a 14" long piece of string
  a dime
  a parking ticket
  a fanny pack (being worn, and open)
    a wallet
      $10.00 in cash

>[7] score
Wow, you've received 95 points out of a possible 200 in 168 moves! I'm very proud of you. This was a triumph. I'm being so sincere right now.

You have received points for the following: 

•  Eating the blueberries: 5 points.
•  Finding the coins and keys: 5 points.
•  Taking the lantern: 5 points.
•  Wearing the sheer veil: 5 points.
•  Taking the Mercury dime: 5 points.
•  Winning the horseshoe magnet: 5 points.
•  Winning the Crimson fuse: 5 points.
•  Buying the Hell Ride ticket: 5 points.
•  Finding the Dark Passage: 5 points.
•  Taking the flashlight: 5 points.
•  Winning the Swiss Army knife: 10 points.
•  Bringing the wrench to the Bumper Cars: 5 points.
•  Acquiring the Gray fuse: 10 points.
•  Acquiring the Khaki fuse: 10 points.
•  Acquiring the Indigo fuse: 10 points.

>[8] bite fingernails
That's a bad habit. You should really try to stop biting your fingernails.

>[9] clip fingernails
Your fingernails look much neater now that you've trimmed them.

* * *

>push indigo button
You switch the indigo button on.

The monitor flickers for a second and the scene it displays changes to something different.
The monitor now shows a tableau of a guillotine rising and falling over the ride exit.
The indigo light is now on.

As you push the indigo button, the monitor switches to a view of the guillotine room. You can still see the blade rising and falling over the cars. Suddenly, you see the blade slowing down, taking longer and longer to fall. Until it finally comes to a complete rest.

The room is heavy with uneasy silence. Hell Ride, once a thrilling spectacle, now looms motionless, as the guillotine blade is frozen halfway down its track. Moments ago, chaos erupted as the malfunctioning mechanism sent the blade crashing unpredictably, ripping through the roofs of cars on the track.

A single car, its roof gashed open, sits under the still blade - a grim reminder of the disaster narrowly averted. Above, a black crow lands on the guillotine's frame, its sharp caw cutting through the murmurs of anger and fear.

Two mechanics climb the scaffolding with tools in hand, their appearance met with wary hope. A crowd has gathered and is watching, holding their breath, as the cursed ride's fate hangs in the balance.

As you exit the ride, the carnival owner and the mayor are present and extending their undying gratitude for saving the day, not to mention lives!

*** You have won! ***

You've received 160 points out of a possible 200 in 293 moves!

You have received points for the following: 

•  Eating the blueberries: 5 points.
•  Finding the coins and keys: 5 points.
•  Taking the lantern: 5 points.
•  Wearing the sheer veil: 5 points.
•  Taking the Mercury dime: 5 points.
•  Winning the horseshoe magnet: 5 points.
•  Winning the Crimson fuse: 5 points.
•  Buying the Hell Ride ticket: 5 points.
•  Finding the Dark Passage: 5 points.
•  Taking the flashlight: 5 points.
•  Winning the Swiss Army knife: 10 points.
•  Bringing the wrench to the Bumper Cars: 5 points.
•  Acquiring the Gray fuse: 10 points.
•  Acquiring the Khaki fuse: 10 points.
•  Acquiring the Indigo fuse: 10 points.
•  Finding the Control Room: 5 points.
•  Turning off the big switch: 10 points.
•  Acquiring the Emerald fuse: 10 points.
•  Acquiring the Aqua fuse: 10 points.
•  Flipping the Aqua switch: 5 points.
•  Flipping the Crimson switch: 5 points.
•  Flipping the Emerald switch: 5 points.
•  Flipping the Gray switch: 5 points.
•  Flipping the Indigo switch: 5 points.
•  Flipping the Khaki switch: 5 points.

Would you like to RESTART, RESTORE a saved game, QUIT, or UNDO the last command?

* * *

>transcript on
Start of a transcript of:

Hell Ride
The ride of a lifetime... by No Shoes
Release 201 / Serial number 250218 / Inform 7 v10.1.2 / D
Inform 7 v10.1.2
Identification number: //E0A5AFB9-18BF-4485-B083-426CA51CCE70//
Interpreter version 0.6.0 / VM 3.1.3
Basic Help Menu version 4 by Wade Clarke
Menus version 5 by Wade Clarke
Object Response Tests version 7 by Juhana Leinonen

>brief
Hell Ride is now in its "brief" printing mode, which gives long descriptions of places never before visited and short descriptions otherwise.

>get berries
Taken.

* * *

>put stub on dashboard
You put the parking stub on the dashboard.

>s
Ticket Booth
The ticket kiosk stands at the carnival entrance, a compact booth painted in bright red and yellow stripes with bold letters above the window reading "Tickets Here!" Twinkling lights outline its edges, blinking rhythmically to draw attention.

A single window serves visitors, where a smiling cashier dispenses colorful tickets from neatly arranged rolls. Beside the tickets, a cash drawer jingles as change is counted, and a digital payment system glows faintly for modern convenience. Too bad you don't have a debit card.

Next to the kiosk, a vibrant signboard lists ticket prices with playful illustrations of rides. Pennant flags flutter from the kiosk's roof, adding to the festive atmosphere, while the smell of popcorn and pretzels wafts from the southwest.

The worn ground around the kiosk shows the passage of eager carnival-goers. Families, couples, and friends form a buzzing line, their excitement building as they approach this first step into the magic of the carnival.

The midway continues in all directions from here. There is a cashier here. A price list for attraction tickets is on the signboard. The cashier has Hell Ride ticket, Fortune Teller ticket, Ferris Wheel ticket, Bumper Cars ticket, and Carousel ticket.

You can see a Cashier and a ticket kiosk here.

>buy tickets
Hell Ride ticket: You fork over $4.00 for the Hell Ride ticket, leaving yourself with $28.00.
Fortune Teller ticket: You fork over $3.00 for the Fortune Teller ticket, leaving yourself with $25.00.
Ferris Wheel ticket: You fork over $2.00 for the Ferris Wheel ticket, leaving yourself with $23.00.
Bumper Cars ticket: You fork over $2.00 for the Bumper Cars ticket, leaving yourself with $21.00.
Carousel ticket: You fork over $1.00 for the Carousel ticket, leaving yourself with $20.00.

[Your score has just gone up by five points.]

>e
High Striker
This area features a tall, eye-catching machine adorned with bright, colorful lights, typically red, yellow, and blue. A large sign at the top reads "Test Your Strength!" in bold, playful lettering. The machine's base is made of polished wood, giving it a vintage appearance. At the center is a sturdy metal pole, with a large bell hanging at the top, signaling when a successful attempt has been made. Along the length of the pole are markings indicating how strong you are.  A nearby sign says, "Buy a mallet, strike the bell, win a prize."

Spectators gather around, cheering on participants and offering lighthearted jabs and encouragement, creating a lively, competitive atmosphere. The sound of the mallet hitting the target is followed by the resonant clang of the bell (if struck), alongside the buzz of carnival music in the background.

The Ticket Kiosk is to the west. Other games are northeast and southeast of here. The Ferris Wheel lies to the east.

You can see a Strongman attendant, a lever, and some High Striker prizes here.

The attendant is holding a mallet.

>l at prizes
The prizes are a teddy bear, a Swiss Army knife, a magenta colored fuse, and a poster of Taylor Swift.

>buy mallet
You fork over $2.00 for the mallet, leaving yourself with $18.00.

>hit bullseye with mallet
You lift the mallet high and bring it down on the lever with all your might! The striker rises towards the bell stopping at "Weakling".

>g
You lift the mallet high and bring it down on the lever with all your might! The striker rises towards the bell stopping at "Getting Stronger".

>g
You lift the mallet high and bring it down on the lever with all your might! The striker rises towards the bell stopping at "Getting Stronger".

>g
You lift the mallet high and bring it down on the lever with all your might! The striker rises towards the bell stopping at "Average".
 
You can't be sure of it but it seems as if the mallet isn't heavy enough to ring the bell.

>ne
Dime Toss Game
The game booth is adorned with vibrant colors - red-and-white striped awnings, twinkling lights, and eye-catching signage that reads "TOSS A DIME - WIN A PRIZE!". You can see prizes of all shapes and sizes hang around the booth, from stuffed animals and novelty toys to shiny trinkets and quirky collectibles. The larger prizes are prominently displayed to entice passersby. Rows of gleaming plates sparkle under overhead lights, their glass surfaces reflecting the surrounding glow.

The distinctive "ping" of dimes hitting plates creates a rhythmic soundtrack, punctuated by the occasional satisfying "plop" when a dime lands perfectly. Victorious shouts mix with playful groans of near-misses, creating a symphony of excitement. Nearby, the hum of other booths, upbeat carnival music, and the distant laughter of children add to the lively backdrop. The booth operator calls out enthusiastically, "Step right up! Test your skill! Win big!" Their energetic pitch draws in curious onlookers. You thought you caught a flash of something coming from the area of the booth.

You're surprised to see that this game only costs a dime. The exit is to the southwest.

You can see a Dime Toss attendant, some Dime Toss prizes, and a plate here.

>look under booth
You find the Mercury dime!

* * *

>get mercury dime
Taken.

[Your score has just gone up by five points.]

>flip mercury dime on plate
You toss the dime. The heavier Mercury dime hits the plate, starts to spins, and lands in the center of the plate. The attendant shouts out, "Winner! Winner!"

Which prize would you like? 1) a stuffed monkey, 2) an orange colored fuse, 3) a poster of Billie Eilish, 4) a horseshoe magnet?

* * *

>4
You are now holding a horseshoe magnet.

[Your score has just gone up by five points.]

>sw
High Striker
You can see a Strongman attendant, a lever, and some High Striker prizes here.

>se
Pitchers Mound
The milk bottle ball toss is a classic carnival game that combines skill, strength, and a bit of luck. The setup features a pyramid of brightly colored milk bottles stacked on a sturdy platform - three on the bottom, two in the middle, and one on top. Players stand behind a marked line and toss baseballs, aiming to knock down as many bottles as possible. Clearing the entire stack wins a prize.

The booth buzzes with energy, its colorful banners and flashing lights drawing a lively crowd. The satisfying clatter of falling bottles mixes with cheers and groans from players and spectators. A carnival attendant calls out, "Step right up and test your aim! Three balls for just a dime." Prizes - ranging from small toys to giant stuffed animals - hang prominently, enticing players to take a shot. With every toss, the game delivers moments of suspense, joy, and fun, making it a favorite at the carnival.

You're surprised to see that this game only costs a dime. The High Striker is to the northwest.

The milk bottles are stacked in three neat rows: three bottles on the bottom, two in the middle, and one on top.

         1         
       2   3     
     4   5   6     

You can also see a Pitchers Mound attendant and some Pitchers Mound prizes here.

>give dime to attendant
The attendant gives you three baseballs in return and says, "Throw the baseball at bottle X where X is the bottle number you want to hit. The bottles are numbered one to six".

>throw baseball at bottle 5
You wind up and throw the baseball at the milk bottles. The ball hits the bottles in the sweet spot and they topple over onto the platform. The attendant shouts out, "Winner! Winner!"

Which prize would you like? 1) a crimson colored fuse, 2) a plush donkey, 3) a goldfish in a bowl, 4) a poster of Lourde?

>1
You are now holding a crimson colored fuse.

[Your score has just gone up by five points.]

>nw
High Striker
You can see a Strongman attendant, a lever, and some High Striker prizes here.

>e
Ferris Wheel
The Ferris wheel is the towering centerpiece of the carnival, its vibrant lights and graceful rotations drawing the attention of visitors from every corner of the fairgrounds. The wheel's massive steel frame arches high into the sky, its intricate network of beams glinting under the colorful glow of bulbs strung along its circumference. Each gondola, painted in bright hues like red, yellow, and blue, dangles from the wheel, swaying gently as it turns.

At night, the Ferris wheel transforms into a dazzling spectacle, with hundreds of synchronized lights creating patterns and ripples that pulse outward like waves. The bulbs flash in bursts of red, green, and white, casting playful reflections on nearby attractions and the surrounding crowd.

The air around the wheel is filled with a mix of excited chatter, the hum of its motor, and the occasional squeal of laughter or nervousness from riders high above. The ride operator, standing in a small booth at the base, keeps a steady rhythm of loading and unloading passengers, their voice occasionally calling out, "Step right up! The best view of the carnival awaits!"

The Ferris wheel offers an ever-changing perspective of the carnival below. From its peak, riders can see the entire fairground: the spinning lights of the rides, the colorful stripes of game booths, and the winding paths of visitors navigating the midway. Beyond the carnival, the view stretches to the horizon, with city lights adding to the magical experience.

Whether it's a romantic ride for couples, a thrilling adventure for friends, or a calming retreat for families, the Ferris wheel captures the spirit of the carnival - an iconic blend of excitement, wonder, and timeless charm.

Hey! Is that a two dollar bill on the ground?

You can also see a Ferris Wheel Attendant here.

>give ticket to attendant
(the Ferris Wheel ticket to the Ferris Wheel Attendant)
You give the Ferris Wheel ticket to the Ferris Wheel Attendant.

As you step into the gently swaying gondola, a faint creak accompanies the safety bar locking into place. The Ferris wheel begins its slow ascent, the hum of its machinery blending with the distant sounds of carnival games and laughter below. A soft breeze brushes against your face as the gondola rises higher, offering an ever-expanding view of the fairgrounds.

With each rotation, the world transforms. At the peak, the carnival sprawls beneath you like a miniature village, its vibrant lights twinkling against the twilight sky. The sound of the midway fades into a soft murmur, replaced by the serene quiet of being high above the bustling crowd. Beyond the carnival, the horizon stretches endlessly, framed by the glow of distant city lights.

From the top you can see something to the west behind the concession stand.

The gondola sways gently, adding a hint of thrill to the tranquil ride. You exchange smiles with your companions, pointing out tiny figures darting between booths and the dizzying motion of other rides below. The Ferris wheel begins its descent, and the lively carnival sounds grow louder once again, bringing you back into the heart of the action.

Whether you're seeking a moment of calm, a romantic view, or the sheer wonder of seeing the world from above, the Ferris wheel delivers an unforgettable ride that captures the magic of the carnival.

>w
High Striker
You can see a Strongman attendant, a lever, and some High Striker prizes here.

>w
Ticket Booth
You can see a Cashier and a ticket kiosk here.

>z
Time passes.

The janitor arrives from the Carousel.

>steal brass ring
The janitor says, "Hey! What do you think you're doing?!

>steal brass ring
The janitor slaps your hand away as you reach for the key.

>steal brass ring
Out of the corner of his eye, the janitor sees you reach for his key ring.

>steal brass ring
The janitor catches you as he turns to face you.

>steal brass ring
While the janitor is distracted, you manage to steal the brass ring from the janitor.

Taken.

The janitor heads to the High Striker.

>sw
Concession Stand
The concession stand, perched along the midway, is a colorful and bustling hub. Painted in bright reds, blues, and yellows, it features bold lettering announcing treats like "SODA! POPCORN! CANDY APPLES!" Strings of twinkling lights frame the stand, making it a glowing beacon amid the carnival excitement.

Behind the counter, a popcorn machine churns out golden kernels, filling the air with a buttery aroma. Candy apples gleam under the lights, and cotton candy machines spin fluffy clouds of pink and blue. Warm pretzels sit under a heat lamp, their buttery, salted scent mingling with the sugary treats. A cooler holds sodas, their colorful labels visible through the frosted glass.

The counter is lively with stacks of paper bags, napkins, and cups of cheese and sugar sprinkles. A handwritten chalkboard menu lists prices in playful lettering. Workers in colorful aprons quickly hand out snacks, their movements efficient amid the cheerful chaos.

In front of the stand, kids tug at their parents, teens share pretzels, and the crowd buzzes with energy. More than just a snack stop, the stand is a sensory delight, adding flavor and charm to the carnival experience.

To the south is the Carnival Office. The trailer's exterior is painted in dull, peeling shades of red and white, with old carnival advertisements that are barely legible due to sun damage. A string of dimly lit, flickering bulbs hang above the door, and an old "Private" sign is half-hanging on the side, clearly neglected.

There is a menu to the right of the window. You can see the treats inside the stand. There is an exit to the south and northeast. 

Nearby a sturdy door leads south.

You can also see a Concession Attendant, a menu, a Drink of Cola, some Bubblegum, a Bucket of Popcorn, a Candy Apple, Cotton Candy, and a Soft Pretzel here.

>buy bubblegum
You fork over $1.00 for the Bubblegum, leaving yourself with $17.00.

>w
Behind the Concession Stand
Behind the concession stand, to one side, is the trash generated from the day's activities and to the other side boxes of supplies. There is a chair here surrounded by cigarette butts. There is an exit to the east.

You can see a trash can (closed) and some concession boxes here.

* * *

>get khaki fuse
Taken.

[Your score has just gone up by ten points.]

>e
Concession Stand
Nearby a sturdy door leads south.

You can also see a Concession Attendant, a menu, a Drink of Cola, a Bucket of Popcorn, a Candy Apple, Cotton Candy, and a Soft Pretzel here.

>s
(first opening the sturdy door)
(first unlocking the sturdy door)
(with the brass key)

Carnival Office
Dim, yellow light from an overhead bulb casts long shadows over the room, A single desk lamp, flickering provides additional light. A few carnival-themed knick-knacks sit atop the desk. A framed photograph hangs askew on the wall.

The desk is covered in stacks of paperwork, old receipts, invoices, and faded carnival brochures. A locked cabinet is tucked away against one wall. Next to it, there's a small, heavy safe.

Nearby a sturdy door leads north to the Concession Stand.

On the messy desk are a mini Ferris wheel and a mini carousel.

You can also see a safe (closed), a filing cabinet (closed), and a framed photograph here.

As you enter the room, you see Mr Whidbey with his back to the door. He's talking on the telephone.

"Hello? Oh, it's you." says Mr. Whidbey.

* * *

>z
Time passes.

Mr. Whidbey listens to the other end of the conversation.

>listen
You are completely focused on the conversation you are overhearing.

"I know, I know, but what am I supposed to do. That Needleman kid isn't happy with the payout we gave him. He wants $15,000 more."

>z
Time passes.

Isn't this why I buy insurance? Don't worry. You'll get your piece.

>z
Time passes.

Mr. Whidbey says "I need that money in a hurry though or he's going to go to the authorities. And then you're going down too."

>n
You're afraid if you move too much, Mr Whidbey will notice you!

"Ok, I'll try to stall him but I won't be able to do it for long."

>z
Time passes.

"Hey! What are you doing here? This is an employees only area," Mr. Whidbey shouts at you. "Get out of here. Now!"

Concession Stand
The concession stand, perched along the midway, is a colorful and bustling hub. Painted in bright reds, blues, and yellows, it features bold lettering announcing treats like "SODA! POPCORN! CANDY APPLES!" Strings of twinkling lights frame the stand, making it a glowing beacon amid the carnival excitement.

Behind the counter, a popcorn machine churns out golden kernels, filling the air with a buttery aroma. Candy apples gleam under the lights, and cotton candy machines spin fluffy clouds of pink and blue. Warm pretzels sit under a heat lamp, their buttery, salted scent mingling with the sugary treats. A cooler holds sodas, their colorful labels visible through the frosted glass.

The counter is lively with stacks of paper bags, napkins, and cups of cheese and sugar sprinkles. A handwritten chalkboard menu lists prices in playful lettering. Workers in colorful aprons quickly hand out snacks, their movements efficient amid the cheerful chaos.

In front of the stand, kids tug at their parents, teens share pretzels, and the crowd buzzes with energy. More than just a snack stop, the stand is a sensory delight, adding flavor and charm to the carnival experience.

To the south is the Carnival Office. The trailer's exterior is painted in dull, peeling shades of red and white, with old carnival advertisements that are barely legible due to sun damage. A string of dimly lit, flickering bulbs hang above the door, and an old "Private" sign is half-hanging on the side, clearly neglected.

There is a menu to the right of the window. You can see the treats inside the stand. There is an exit to the south and northeast. 

Nearby a sturdy door leads south to the Carnival Office.

You can also see a Concession Attendant, a menu, a Drink of Cola, a Bucket of Popcorn, a Candy Apple, Cotton Candy, and a Soft Pretzel here.

You suddenly find yourself unceremoniously out of the Carnival Office and into the Concession Stand.

>s
Carnival Office
Nearby a sturdy door leads north to the Concession Stand.

On the messy desk are a mini Ferris wheel and a mini carousel.

You can also see a safe (closed), a filing cabinet (closed), and a framed photograph here.

>turn dial to 62
You turn the knob to 62.

>turn dial to 22
You turn the knob to 22.

>turn dial to 3
You turn the knob to 3, and you hear a click.

>open safe
You open the safe, revealing an indigo colored fuse, a gold key, and an insurance policy.

>get all from safe
indigo colored fuse: Taken.
gold key: Taken.
insurance policy: (putting the wallet into the fanny pack to make room)
Taken.

[Your score has just gone up by five points.]

[Your score has just gone up by ten points.]

>open filing cabinet
(first unlocking the filing cabinet)
(with the gold key)
You open the filing cabinet, revealing an envelope, a Cash 'N' Carry invoice, a Frank's Market invoice, an Oriental Trading invoice, and a Mystic Industries invoice.

>get all invoices
Cash 'N' Carry invoice: (putting the dime into the fanny pack to make room)
Taken.
Frank's Market invoice: (putting the dime into the fanny pack to make room)
Taken.
Oriental Trading invoice: (putting the dime into the fanny pack to make room)
Taken.
Mystic Industries invoice: (putting the dime into the fanny pack to make room)
Taken.

[Your score has just gone up by five points.]

[Your score has just gone up by five points.]

[Your score has just gone up by five points.]

[Your score has just gone up by five points.]

>get envelope
(putting your keys into the fanny pack to make room)
Taken.

>open envelope
You open the envelope, revealing a cashier's check.

>get check
(putting the 14" long piece of string into the fanny pack to make room)
Taken.

[Your score has just gone up by ten points.]

>l at check
This cashier's check is made payable to "Fred Needleman". The amount is $10,000 and the memo line reads "For services rendered."

>n
Concession Stand
Nearby a sturdy door leads south to the Carnival Office.

You can also see a Concession Attendant, a menu, a Drink of Cola, a Bucket of Popcorn, a Candy Apple, Cotton Candy, and a Soft Pretzel here.

>ne
Ticket Booth
You can see a janitor, a Cashier, and a ticket kiosk here.

>w
The barker cries:

Ladies and gentlemen, boys and girls, gather 'round! 
Step right up and witness the spectacle that's taken the world by storm! 
She walks, she talks, she crawls on her belly like a reptile. 
Behold the one, the only Little Egypt, performing her legendary Dance of the Pyramids - a dazzling display of mystery, grace, and allure! 
For just a dime, a mere one tenth of a dollar, prepare to be transported to the sands of Cairo, where enchantment and wonder await!

Show Facade
You head west through the midway, the bright lights of the carnival fading behind you as you approach a tent. A sign above the entrance reads "Little Egypt Show - A Journey Into the Mysterious and the Unknown!" A rotund barker, wearing a fez and a dazzling smile, gestures to a small sign beside him. The Ticket Kiosk is back the way you came.

There is a stage in front of the tent. The Barker is encouraging you to step up and enjoy the Little Egypt Show.

You can see a Barker here.

>give dime to barker
(first taking the dime)
(putting the parking ticket into the fanny pack to make room)
You hand over a dime, and the barker nods, waving you through. As you step past the entrance, the air feels thicker, almost humid, and the sounds of the carnival fade away. You've entered an entirely different world now - one filled with the scents of incense and unfamiliar spices, and the low, hypnotic music of a faraway land. Before you, a series of dimly lit tents stretch out, their flaps slightly swaying in the breeze. Intrigued, you take your first step into the Little Egypt Show. You can now head west into the show.

>w
Show Tent
You are inside the Little Egypt Show. The attraction's facade is to the east. There are folding chairs organized neatly in rows. The show should start soon.

In the dimly lit tent, you see that the stage is decorated to resemble a Middle Eastern palace, featuring rich, colorful fabrics, brass ornaments, and lanterns casting a warm, flickering glow. Scents of incense waft through the air, enhancing the atmosphere of mystique. The backdrop displays painted scenes of pyramids, desert landscapes, and domed structures evoking a sense of being transported to the "Middle East".

>z
Time passes.

Little Egypt emerges draped in flowing silk veils which she skillfully uses as part of the dance. Her attire consists of a sparkling, sequined bodice and a flowing skirt, adorned with jingling coin belts and jewelry that accentuate her movements.

>z
Time passes.

The performance begins with slow, undulating movements, drawing you into the rhythm of unfamiliar live music played on traditional instruments like the oud, darbuka, or zurna. As the tempo builds, her hips, torso, and hands move in intricate, mesmerizing patterns, demonstrating remarkable control and fluidity. She incorporates dramatic spins, drops, and shimmies, often accentuating the beat of the music with a quick jingle of her coin belt.

>z
Time passes.

Little Egypt makes eye contact with you and smiles enigmatically. During her performance she balances a sword on her head and accents her dance with finger cymbals.

>z
Time passes.

The music alternates between hauntingly slow melodies and rapid, energetic drum beats, creating an emotional arc that keeps you entranced. Little Egypt relies on the music's dynamic changes to tell a story with movements reflecting joy, sorrow, seduction, and celebration.

>z
Time passes.

The performance concludes with a dramatic flourish of a fast-paced shimmy, a bold spin, and Little Egypt dramatically casts off her veils. The dancer takes a bow to enthusiastic applause, leaving you spellbound by the sensual yet artful display.

You applaud until your hands are sore. Did she just wink at you?

As she leaves the stage, Little Egypt tosses one of her veils to you!

>wear veil
You wrap the veil around your head, shrouding your eyes. The world is a lovely color pink as you look through the veil while her perfume fills your nostrils in the most delightful way. You look pretty!

[Your score has just gone up by five points.]

* * *

>turn it on
You flip a switch. A strong, narrow beam of light shines from the lit lantern.

>e
Show Facade
You can see a Barker here.

>e
Ticket Booth
You can see a janitor, a Cashier, and a ticket kiosk here.

The janitor heads to the Bumper Cars.

>s
Head of the Line
You are standing in front of an attendant with his hand open waiting for your ticket. The entrance to the ride is south of here. The ride operator tells you that you're lucky you showed up when you did because this will be the last trip through Hell Ride for the night. You notice that all the other cars are empty. The Ticket Kiosk is north of here.

You can see a Hell Ride Attendant here.

>give ticket to attendant
(the Hell Ride ticket to the Hell Ride Attendant)
You give the Hell Ride ticket to the Hell Ride Attendant.

>s
Ride Entrance
The cars that will take you into the fearsome Hell Ride stop here for you to board and then move forward, the safety bar locked in place, as the entrance to Hell Ride looms ahead - a grotesque facade of twisted metal and carved wood, illuminated by flickering blood-red lights. The air carries a faint sulfuric tang mingled with the sweet aroma of carnival popcorn.

A towering archway of flames, spikes, and grinning skulls frames the entrance, crowned by flickering letters that read "HELL RIDE", pulsing like a heartbeat. Below, crouching demon sculptures extend clawed hands in a sinister invitation. Wooden doors cover the entrance, whispering with faint, menacing chuckles as distorted organ music grows louder, punctuated by shrieks and grinding machinery.

Inside, near-total darkness is broken by flashes of sickly green light revealing twisted paths and grotesque shapes. Beyond the threshold lies only uncertainty and terror. To one side, the darkness looks a little bit darker than the rest of the room.

You can see a Hell Ride car (empty) here.

* * *

>e
Dark Passage
This room is backstage at the Hell Ride attraction. The room is littered with bags of trash, piles of junk, and dust bunnies so large they should be paying rent. There an exit to the south and west.

[Your score has just gone up by five points.]

>x piles of junk
This is a pile of assorted flotsam and jetsam from the carnival. None of it looks very interesting.

In the pile of junk is a flashlight.

>get flashlight
Taken.

[Your score has just gone up by five points.]

* * *

>w
Ride Entrance
You can see a Hell Ride car (empty) here.

>n
Head of the Line
You can see Mr Whidbey and a Hell Ride Attendant here.

>n
Ticket Booth
You can see a janitor, a Cashier, and a ticket kiosk here.

The janitor heads to the Carousel.

>ne
Carousel
The carousel is a timeless carnival attraction, radiating charm and nostalgia with its brightly painted horses, vibrant lights, and cheerful music. The circular platform is adorned with a canopy of swirling colors, gold trim, and decorative mirrors that reflect the flickering bulbs lining its edges.

Rows of hand-carved animals, most often horses with flowing manes, are arranged in a circle. Each is painted in vivid colors, detailed with golden saddles and ribbons. It also features creatures like lions, tigers, and sea dragons, adding whimsy to the ride. The animals rise and fall gently as the carousel spins, mimicking a galloping motion.

The carousel's warm, playful tunes drift across the midway, inviting riders of all ages to enjoy its simple delight. Children laugh as they choose their favorite animals, while adults savor the nostalgia of the spinning ride. As it rotates, the carousel becomes a moving work of art, blending motion, color, and music into an enchanting centerpiece of the carnival. The Ticket Kiosk is back to the southwest; the way you came.

You can see a janitor and a Carousel Attendant here.

>l at janitor
The janitor looks at you and waits for you to proceed.

The janitor is a portly gentleman wearing dirty overalls, leaning on a broom. He complains that he's missing his flashlight. "My pliers are missing too!" he says.

>give flashlight to janitor
Hey! Thanks, I really appreciate it. I've been lost without my flashlight.

>sw
Ticket Booth
You can see a Cashier and a ticket kiosk here.

>s
Head of the Line
You can see a Hell Ride Attendant here.

>s
Ride Entrance
You can see Mr Whidbey and a Hell Ride car (empty) here.

>e
Dark Passage

>s
Maintenance Office
The maintenance office, hidden behind the carnival's bright facade, is a dim and cluttered space reeking of grease, sweat, and faint traces of popcorn from the midway. The air hangs heavy with oil and stirred-up dust.

The walls are lined with shelves holding tools and parts in disarray - screws and mismatched jars with faded labels. Paint cans and grease jars clutter the workbenches, many left half-open. In the center, a battered desk is strewn with wires, gears, and springs, a bent piece of metal held in a vise. Overhead, a single flickering fluorescent light struggles to illuminate the room.

In one corner, a disassembled ride mechanism lies exposed, chains and pulleys dangling from hooks above, faintly clinking with the vibrations of the rides. A grease-stained manual and a half-drained mug of coffee sit abandoned on a nearby stool.

The walls display faded safety posters, a cork board with maintenance schedules and notes, and a worn photo of the carnival in its prime. A clock ticks faintly, its hands out of sync with reality. The floor, gritty with dust and scattered nails, adds to the room's chaotic charm.

Despite the mess, the room buzzes with purpose - a hidden hub where the carnival's magic is sustained through sweat, ingenuity, and the hum of machinery.

Exits lead north and south.

Nearby a ladder leads up.

Nearby an aqua colored door leads west.

You can also see a worn photo and a desk (on which are a coffee mug and a radio) here.

>u
Dark Hallway
This is a poorly lit hallway. Ahead to the west you can see a closed door.

Nearby a ladder leads down to the Maintenance Office.

Nearby a metal door leads west.

>w
(first opening the metal door)
(first unlocking the metal door)
(with the brass key)

Control Room
The backstage control room is a plain, functional hub where the carnival's rides, lights, and attractions are managed. Gray industrial walls, scuffed and greasy, surround a large monitor streaming live carnival feeds. Beneath them, control panels with labeled dials, colored buttons, and lights oversee the systems scattered about the room. Glancing at the control panels, you can see they are dark.

The hum of electronics fills the air, punctuated by the crackle of a radio: "Maintenance to Bumper Cars - wrench needed!" The worn floor is scattered with papers, tools, and coffee cups. A cluttered desk holds logs and schedules, while a cork board above displays charts and red-marked notes like "Check Zipper circuit breakers."

A flickering light casts cold shadows as the metallic tang of machinery mixes with dampness. Functional yet essential, this hidden space ensures the carnival's magic runs seamlessly. On one wall is a large switch with sparks arcing out from it.

A dark hallway lies to the east.

Nearby a metal door leads east to Dark Hallway.

Currently there are sparks arcing out from the switch. It looks dangerous.

[Your score has just gone up by five points.]

>flip switch
You switch the big switch off.

[Your score has just gone up by ten points.]

>e
Dark Hallway
Nearby a metal door leads west to Control Room.

Nearby a ladder leads down to the Maintenance Office.

Over the loud speaker, an announcement blares: Attention please. There is a vehicle being towed from the parking lot for parking illegally. The license plate of the car is "862901". You breathe a sigh of relief as you realize that's not your license plate. I guess it's a good thing you remembered to place the parking stub on the dashboard.

>d
Maintenance Office
Nearby a ladder leads up to Dark Hallway.

Nearby an aqua colored door leads west.

You can also see a worn photo and a desk (on which are a coffee mug and a radio) here.

Mr Whidbey arrives from Dark Passage.

>s
Crawl Space
The crawl space beneath the carnival ride is a tight, claustrophobic tunnel shrouded in darkness and filled with the hum of machinery above. The air is stale and heavy, carrying the sharp metallic scent of oil and the faint tang of rust. Every sound is amplified in the confined space - the groaning of steel beams, the clanking of chains, and the rhythmic thrum of motors driving the ride above.

The ground is uneven, a mix of packed dirt and loose gravel scattered with forgotten tools, scraps of metal, and tangled wires. Overhead, a network of pipes crisscross the space, some wrapped in fraying insulation that crackles faintly as you crawl past. Small puddles of murky water collect in dips on the floor, their surfaces rippling with vibrations from the ride's movement.

The backstage area continues north and south.

Nearby a crimson colored door leads west.

>s
Mechanical Room North
The north mechanical room is compact and specialized, housing auxiliary systems that keep the ride running smoothly. A subdued hum of capacitors and relays fills the space, its quiet rhythm broken only by the occasional hiss of hydraulic fluid.

Circuit breaker panels line the walls, labeled for functions like "Lighting Controls" and "Brake Systems". Smaller cables and conduits snake along the walls, linking these systems to the main hub. In one corner, a hydraulic pump and reservoir manage lifting arms and rotating platforms, their gauges flickering as they work.

A small workbench against the eastern wall is cluttered with tools and coiled wires, while shelves above hold neatly labeled spare parts - cables, and hydraulic tubing. A faded ride diagram pinned nearby is marked with red annotations from past repairs.

Dimly lit by a single hanging bulb, the room feels cooler and slightly damp, the metallic tang of machinery mixing with a hint of mildew. Though quieter and less prominent than the south mechanical room, this space plays a vital role in supporting the ride's operation and ensuring its emergency systems are always prepared.

There are exists north and south.

Nearby an emerald colored door leads west.

You can also see a toolbox (closed) and a sledgehammer here.

>open tool box
You open the toolbox, revealing an adjustable wrench, some channel locks, and a hammer.

>get wrench
Taken.

>get sledgehammer
(putting the Fortune Teller ticket into the fanny pack to make room)
Taken.

>n
Crawl Space
Nearby a crimson colored door leads west.

>n
Maintenance Office
Nearby a ladder leads up to Dark Hallway.

Nearby an aqua colored door leads west.

You can also see a worn photo and a desk (on which are a coffee mug and a radio) here.

>n
Dark Passage

* * *

>w
Ride Entrance
You can see a Hell Ride car (empty) here.

>n
Head of the Line
You can see a Hell Ride Attendant here.

>n
Ticket Booth
You can see a Cashier and a ticket kiosk here.

>nw
Bumper Cars
The bumper cars is a bustling hub of excitement and laughter, set beneath a canopy of flashing lights and colorful decorations. The rectangular arena is surrounded by padded barriers, ensuring a safe yet thrilling experience for riders. The floor, slick and metallic, allows the brightly colored cars - painted in shades of red, blue, yellow, and green - to glide effortlessly in all directions.

Each car is equipped with a steering wheel and a padded bumper, designed to absorb the impact of playful collisions. As the ride begins, drivers of all ages eagerly maneuver their cars, aiming for friends, family, or strangers with mischievous grins. The air is filled with the sound of bumpers colliding, laughter, and the occasional squeal of surprise.

Overhead, a web of electric poles connects the cars to the ceiling, sparking faintly as they supply power to the vehicles. The ride operator watches from a booth, ensuring everyone enjoys the chaos safely. Surrounding the bumper cars are cheering onlookers, carnival lights, and the lively hum of the fairground.

The bumper cars perfectly captures the playful spirit of the carnival, offering a mix of harmless competition, shared laughter, and nostalgic fun for all ages. The Ticket Kiosk is southeast of here.

You can see a Bumper Cars attendant here.

>give wrench to attendant
Hey! Thanks, I really appreciate it. Usually no one ever responds to the radio in the Control Room. Here, take this fuse.

Taken.

[Your score has just gone up by five points.]

[Your score has just gone up by ten points.]

>se
Ticket Booth
You can see a janitor, a Cashier, and a ticket kiosk here.

>e
High Striker
You can see a Strongman attendant, a lever, and some High Striker prizes here.

>hit bullseye with sledgehammer
As you swing, you feel the extra weight from the sledgehammer. As it comes down on the bullseye, you can't help but feel like the extra weight gives you an edge. The bell rings as the striker reaches the top of the pole. The attendant says, "You're a Muscle Man. Here's a prize for you."

Which prize would you like? 1) a teddy bear, 2) a Swiss Army knife, 3) a magenta colored fuse, 4) a poster of Taylor Swift?

>2
You are now holding a Swiss Army knife.
(putting the Bumper Cars ticket into the fanny pack to make room)

[Your score has just gone up by ten points.]

>w
Ticket Booth
You can see a janitor, a Cashier, and a ticket kiosk here.

The janitor heads to the Concession Stand.

>s
Head of the Line
You can see a Hell Ride Attendant here.

>s
Ride Entrance
You can see a Hell Ride car (empty) here.

* * *

>e
Dark Passage

>s
Maintenance Office
Nearby a ladder leads up to Dark Hallway.

Nearby an aqua colored door leads west.

You can also see a worn photo and a desk (on which are a coffee mug and a radio) here.

>s
Crawl Space
Nearby a crimson colored door leads west.

>s
Mechanical Room North
Nearby an emerald colored door leads west.

You can also see a toolbox (in which are some channel locks and a hammer) here.

>s
Mechanical Room South
The south mechanical room is the operational core of the carnival ride, a bustling, noisy space dominated by a massive motor. Its steady hum drives the thick belts, pulleys, and gears that work in perfect unison to power the ride.

Heavy-duty electrical panels line the walls, adorned with warning labels like "High Voltage" and blinking indicator lights in an array of colors. Overhead, labeled conduits and wires snake across the ceiling, connecting systems with meticulous precision.

A cluttered table holds tools and spare parts - bolts and lubricants - alongside open maintenance logs marked with greasy fingerprints. The air is thick with the smell of oil, metal, and a faint trace of ozone from the electrics.

A cooling fan spins in the corner, barely cutting through the room's warmth. The hum of machinery is occasionally punctuated by clinking chains and the sharp hiss of hydraulic fluid. The floor, a mix of metal grates and worn concrete, reflects years of use and maintenance.

Bright fluorescent lights in wire cages illuminate the space, highlighting the intricate systems at work. The south mechanical room is the ride's powerhouse, where every movement is controlled with precision to deliver its thrilling experience.

You can travel north and south from here.

Nearby a gray colored door leads west.

You can also see a grate (in which is an emerald colored fuse) here.

>chew bubblegum
You chew the bubblegum, blowing a few bubbles as you do so.

>tie string to bubblegum
You tie the 14" long piece of string to the chewed bubblegum.

>put bubblegum in grate
You drop the chewed bubblegum into the grate. The emerald colored fuse attaches to the chewed bubblegum. You quickly and carefully raise the chewed bubblegum and drop emerald colored fuse into your hand.

[Your score has just gone up by ten points.]

>s
Generator Room
 The generator room is a compact, utilitarian space where the lifeblood of the carnival's power is produced. Its reinforced concrete walls bear grime, oil streaks, and faint graffiti from past workers. The air carries a mix of diesel, hot metal, ozone, and damp earth, creating a distinctly industrial scent.

At the center, the main generator hums steadily, its scuffed steel casing evidence of years of service. Thick rubberized cables extend from it like veins, connecting to junction boxes and circuit breakers along the walls. A large panel nearby is cluttered with buttons, switches, and gauges, many with faded labels like "Fuel Intake" and "Emergency Shutoff." A flickering display screen shows power levels and load distribution.

The rough concrete floor is uneven, marked by small puddles of spilled fuel or condensation. Shelves along the walls hold spare parts - filters, spark plugs, and wire coils - while a work area sits beside a grease canister and a worn maintenance manual.

A single industrial bulb in a protective cage casts harsh light, leaving deep shadows across the machinery. In the corner, a vent fan whirs faintly, struggling to cool the warm, vibrating air. A row of diesel canisters gleams beneath a faded safety sign that warns, "Fuel Safely - No Open Flames!"

Though isolated and utilitarian, the generator room is the carnival's heartbeat, powering its lights, rides, and sounds. Its quiet separation from the carnival's chaos serves as a stark reminder of the machinery driving the magic.

The backstage area continues north and south of here.

Nearby an indigo colored door leads west.

>s
Electrical Room
The electrical room is a small but essential space hidden behind the carnival's bright attractions. The air vibrates with electric energy, carrying the acrid scent of overheated wires and metal. Metal panels line the walls, some polished, others worn and streaked with grease.

A central breaker panel, labeled with destinations like "Ferris Wheel Lights" and "Carousel Motors," dominates one wall. Colored indicator lights blink intermittently, reflecting off steel surfaces. Overhead, thick cable bundles snake across the ceiling, connecting to the carnival's power network.

In a corner, an open junction box spills wires onto the wall, while a workbench holds scattered tools and a smudged wiring diagram pinned above. The dirt floor bears scratches, oil stains, and wire clippings. A faint vibration, carried from the generator or nearby rides, pulses through the room.

An emergency shutdown panel painted bright red stands near a fire extinguisher and a faded safety poster. A small fan on the workbench oscillates weakly, barely cooling the room's warmth. Flickering fluorescent tubes overhead cast harsh, shifting shadows.

The electrical room is raw and utilitarian, revealing the fragile systems behind the carnival's magic - a humbling reminder of the power sustaining the midway's enchantment.

This room is eerily quiet, missing the ever present buzz of electricity. There are exits in all directions.

>ne
Electrical Closet One
This is Electrical Closet One. There's an electrical panel here and an exit to the southwest.

You can see a silver key here.

>put all invoices in fanny pack
Mystic Industries invoice: Done.
Oriental Trading invoice: Done.
Frank's Market invoice: Done.
Cash 'N' Carry invoice: Done.

>get key
(the silver key)
Taken.

>sw
Electrical Room

>s
Storage Room
The carnival storage room is a cramped yet essential space, tucked away from the bustling grounds. Its rusted metal and peeling wooden walls bear the marks of years of use, while the air hangs heavy with grease, dust, damp canvas, and a faint trace of stale popcorn.

Shelves overflow with supplies - boxes of light bulbs, spools of wire, and assorted ride parts - piled without order. Tangled flags and strings of lights dangle from hooks, while crates labeled "GAME PRIZES" and "RIDE PARTS" hold items like stuffed animals and plastic toys. Folded tarps and tent poles teeter in one corner.

The room's center is dominated by larger objects: spare ride seats, unassembled booths, and faded attraction pieces like a scratched carousel horse, all hidden beneath protective tarps.

Near the entrance, a battered desk is cluttered with empty coffee cups. Above it, a bulletin board brims with ride schedules and repair requests. A flickering fluorescent bulb casts uneven shadows, adding an eerie atmosphere.

The floor, a rough blend of concrete and dirt, is littered with nuts and wire scraps. In the dim corners, the scuttle of rats and the glint of cobwebs underline the room's gritty nature.

Chaotic yet indispensable, this hidden space powers the carnival's magic, ensuring every ride and booth runs seamlessly.

There is an exit to the north.

Nearby a khaki colored door leads west.

>w
(first opening the khaki colored door)
(first unlocking the khaki colored door)
(with the silver key)

Ride Exit
The exit of Hell Ride is designed to leave riders with lingering unease. Emerging from a dark corridor with peeling black and red-streaked walls, flickering lights cast erratic shadows on the uneven floor. The air is cool and damp, carrying a faint metallic tang, while faint whispers and distant screams echo softly in the background.

Riders step into a small courtyard enclosed by jagged, rusted fencing draped with cobwebs and plastic skulls. Overhead, a weathered sign reads, "You've Survived… For Now." Nearby, carnival workers in tattered costumes watch silently, occasionally muttering cryptic remarks like, "Not everyone makes it out."

A merchandise display glows red, selling items like Hell Ride Survivor t-shirts and key chains. Beyond the fencing, the cheerful carnival lights and sounds feel jarring, contrasting sharply with the ride's oppressive atmosphere.

The exit ensures Hell Ride isn't just an experience - it lingers, blurring the line between thrill and fear.

There is a price list next to the cash register. An attendant is here to assist you with your purchases. The stand has aqua colored fuse, Plastic Bones, Devil Horns, Key Chains, and T-Shirts for sale.

Nearby a khaki colored door leads east to the Storage Room.

You can also see a Merchandise Attendant here.

>buy aqua fuse
You fork over $3.50 for the aqua colored fuse, leaving yourself with $13.50.

[Your score has just gone up by ten points.]

>n
As you enter the room, you can see Mr Whidbey across the way. He seems to be doing something around the guillotine platform. You walk closer to see what he is doing and startle him. Mr Whidbey spins around and stares at you. As he turns and walks out of the guillotine room, you think you saw him drop something.

Guillotine Room
The public square buzzes with tense anticipation, a crowd gathered under gray skies that cast a somber light on the cobblestones. At the center, a stark wooden platform looms, its purpose grim and unavoidable.

A lone figure stands on the scaffold, bound hands behind their back and head bowed low, avoiding the crowd's gaze. Their tattered clothing, once fine, reflects the fall that led them to this moment.

The crowd encircles the platform, emotions ranging from jeers and curses to silent, grim observation. Children sit on shoulders, their curious eyes unaware of the event's gravity. Near the edge of the platform, the town crier proclaims the crime: "High treason against the crown. Let this be a warning to all who defy the realm!"

The condemned flinches but remains silent as the executioner - a hooded figure in black - stands ready beside the guillotine, its blade gleaming faintly in the dim light. The murmurs of the crowd fall into silence at the executioner's signal, leaving only the rustle of wind and the creak of the scaffold.

As the condemned approaches the guillotine, a crow caws sharply from a nearby rooftop, its cry echoing through the square like an omen. The crowd leans forward, breath held, as justice and mortality converge on the scene.

There is just one problem: the guillotine is being raised and lowered by some mechanism. It appears that the timing of the guillotine is off and it is being lowered onto the cars instead of between them. If a person were to be in a car as it passed under the guillotine, they would be seriously injured.  You're glad you're not in one of those cars now. 

Nearby an indigo colored door leads east to the Generator Room.

You can also see a guillotine platform here.

>l under platform
You find the pliers!

* * *

>get pliers
Taken.

[Your score has just gone up by five points.]

>n
Dungeon
The dungeon is a dark, suffocating chamber carved into the earth, its stone walls slick with moisture and grime. The air reeks of sweat, blood, mildew, and burning oil from flickering torches mounted on rusted sconces. Shadows twist on the walls, creating grotesque, unsettling shapes in the dim light.

Chains hang from walls and ceilings, their faint clinking blending with the moans and occasional screams of prisoners. Water drips rhythmically from a cracked ceiling, adding to the chamber's eerie ambiance.

The room is littered with instruments of torment: a splintered rack, a glowing brazier holding bloodstained tools, and a spiked chair gleaming faintly in the light. Prisoners endure their own horrors - one stretched on the rack, another hanging limply from manacles, and a third gasping weakly in the spiked chair.

The hooded torturer moves with detached precision, their leather apron stained with the evidence of countless victims. They work silently, indifferent to the agony surrounding them.

Above, rats scuttle in the shadows, and the low ceiling presses down like the weight of despair. This is a realm of suffering and hopelessness, where life and death blur, and torment is the only certainty.

Nearby a gray colored door leads east to the Mechanical Room South.

You can also see an iron chair, a splintered rack, and a glowing brazier here.

>e
(first opening the gray colored door)
(first unlocking the gray colored door)
(with the silver key)

Mechanical Room South
Nearby a gray colored door leads west to the Dungeon.

You can also see a grate (empty) here.

>s
Generator Room
Nearby an indigo colored door leads west to the Guillotine Room.

* * *

>ne
Electrical Closet One

>open panel
(first unlocking Electrical Panel 1)
(with the Swiss Army knife)
Using the screwdriver on the Swiss Army knife, you remove the screws holding the electrical panel shut.

You open Electrical Panel 1.

>put aqua fuse in socket
You hear a satisfying snick as the aqua fuse slides into place.

* * *

>flip switch
You switch Electrical Panel 1's switch on.

The aqua indicator's light goes on.

[Your score has just gone up by five points.]

>sw
Electrical Room

* * *

>e
Electrical Closet Three
This is Electrical Closet Three. There's an electrical panel here and an exit to the west.

>open panel
(first unlocking Electrical Panel 3)
(with the Swiss Army knife)
Using the screwdriver on the Swiss Army knife, you remove the screws holding the electrical panel shut.

You open Electrical Panel 3.

>put crimson fuse in socket
You hear a satisfying snick as the crimson fuse slides into place.

* * *

>se
Electrical Closet Five
This is Electrical Closet Five. There's an electrical panel here and an exit to the northwest.

>open panel
(first unlocking Electrical Panel 5)
(with the Swiss Army knife)
Using the screwdriver on the Swiss Army knife, you remove the screws holding the electrical panel shut.

You open Electrical Panel 5.

>put emerald fuse in socket
You hear a satisfying snick as the emerald fuse slides into place.

* * *

>sw
Electrical Closet Seven
This is Electrical Closet Seven. There's an electrical panel here and an exit to the northeast.

>open panel
(first unlocking Electrical Panel 7)
(with the Swiss Army knife)
Using the screwdriver on the Swiss Army knife, you remove the screws holding the electrical panel shut.

You open Electrical Panel 7.

>put gray fuse in socket
You hear a satisfying snick as the gray fuse slides into place.

* * *

>w
Electrical Closet Nine
This is Electrical Closet Nine. There's an electrical panel here and an exit to the east.

>open panel
(first unlocking Electrical Panel 9)
(with the Swiss Army knife)
Using the screwdriver on the Swiss Army knife, you remove the screws holding the electrical panel shut.

You open Electrical Panel 9.

>put indigo fuse in socket
You hear a satisfying snick as the indigo fuse slides into place.

* * *

>nw
Electrical Closet Eleven
This is Electrical Closet Eleven. There's an electrical panel here and an exit to the southeast.

>open panel
(first unlocking Electrical Panel 11)
(with the Swiss Army knife)
Using the screwdriver on the Swiss Army knife, you remove the screws holding the electrical panel shut.

You open Electrical Panel 11.

>put khaki fuse in socket
You hear a satisfying snick as the khaki fuse slides into place.

* * *

>n
Generator Room
Nearby an indigo colored door leads west to the Guillotine Room.

>n
Mechanical Room South
Nearby a gray colored door leads west to the Dungeon.

You can also see a grate (empty) here.

>n
Mechanical Room North
Nearby an emerald colored door leads west.

You can also see a toolbox (in which are some channel locks and a hammer) here.

>n
Crawl Space
Nearby a crimson colored door leads west.

* * *

>n
Maintenance Office
Nearby a ladder leads up to Dark Hallway.

Nearby an aqua colored door leads west.

You can also see a worn photo and a desk (on which are a coffee mug and a radio) here.

>u
Dark Hallway
Nearby a ladder leads down to the Maintenance Office.

Nearby a metal door leads west to Control Room.

* * *

>w
Control Room
Nearby a metal door leads east to Dark Hallway.

You can also see a big switch here.

>spin aqua dial to 1
The aqua colored dial is now set to 1.

>set crimson dial to 3
The crimson colored dial is now set to 3.

>set emerald dial to 5
The emerald colored dial is now set to 5.

>turn gray dial to 7
The gray colored dial is now set to 7.

>turn indigo dial to 9
The indigo colored dial is now set to 9.

>turn khaki dial to 11
The khaki colored dial is now set to 11.

* * *

>l at attendant
This is another bored teenager. He's thinking about the big game on Friday night.

>ask attendant about hell ride
Hell Ride is behind on its maintenance schedule. Might want to skip that one.

>talk to attendant about ferris wheel
You can see the whole carnival from up there!

>l at puddles
You carefully skirt the mud and puddles to avoid getting your feet wet.

* * *

>x cash box
The cash box is full of change and paper money.

>x car
This is your car. It's a 2002 Honda Civic and it's seen better days.

Even though it's old, it feels like an old friend. From the faux leather seats to the crack in the windshield. It's familiar and comforting. There are old fast food wrappers on the floor, dirty clothes and text books in the back seat. There is an air freshener hanging from the rear view mirror.

In the beater car is an air freshener.

>l under seat
You find the three quarters, the nickel, the five dimes, and your keys!

[Your score has just gone up by five points.]

>get all
your keys: Taken.
dime: Taken.
dime: Taken.
dime: Taken.
dime: Taken.
dime: Taken.
nickel: Taken.
quarter: Taken.
quarter: Taken.
quarter: Taken.
parking ticket: You'll have to pay for that.
parking stub: That seems to belong to the Parking Attendant.
air freshener: Taken.

>l at seat
A faux leather seat that looked great when it was new.

* * *

>put keys in ignition
You put your keys into the ignition.

>turn keys
If you left now you would just end up in a bar, crying over a beer about your fight. You decide to stay and enjoy the carnival after all.

>s
Ticket Booth
The ticket kiosk stands at the carnival entrance, a compact booth painted in bright red and yellow stripes with bold letters above the window reading "Tickets Here!" Twinkling lights outline its edges, blinking rhythmically to draw attention.

A single window serves visitors, where a smiling cashier dispenses colorful tickets from neatly arranged rolls. Beside the tickets, a cash drawer jingles as change is counted, and a digital payment system glows faintly for modern convenience. Too bad you don't have a debit card.

Next to the kiosk, a vibrant signboard lists ticket prices with playful illustrations of rides. Pennant flags flutter from the kiosk's roof, adding to the festive atmosphere, while the smell of popcorn and pretzels wafts from the southwest.

The worn ground around the kiosk shows the passage of eager carnival-goers. Families, couples, and friends form a buzzing line, their excitement building as they approach this first step into the magic of the carnival.

The midway continues in all directions from here. There is a cashier here. A price list for attraction tickets is on the signboard. The cashier has Hell Ride ticket, Fortune Teller ticket, Ferris Wheel ticket, Bumper Cars ticket, and Carousel ticket.

You can see a janitor, a Cashier, and a ticket kiosk here.

>buy tickets
Hell Ride ticket: You fork over $4.00 for the Hell Ride ticket, leaving yourself with $28.00.
Fortune Teller ticket: You fork over $3.00 for the Fortune Teller ticket, leaving yourself with $25.00.
Ferris Wheel ticket: You fork over $2.00 for the Ferris Wheel ticket, leaving yourself with $23.00.
Bumper Cars ticket: You fork over $2.00 for the Bumper Cars ticket, leaving yourself with $21.00.
Carousel ticket: You fork over $1.00 for the Carousel ticket, leaving yourself with $20.00.

[Your score has just gone up by five points.]

>l at kiosk
(the ticket kiosk)
A single window serves visitors, where a smiling cashier dispenses colorful tickets from neatly arranged rolls. Beside the tickets, a cash drawer jingles as change is counted, and a digital payment system glows faintly for modern convenience. Too bad you don't have a debit card.

Next to the kiosk, a vibrant signboard lists ticket prices with playful illustrations of rides.

>read sign
$4.00 Hell Ride Ticket
$3.00 Fortune Teller Ticket
$2.00 Ferris Wheel Ticket
$2.00 Bumper Cars Ticket
$1.00 Carousel Ticket

The janitor heads to the High Striker.

>l at rolls
Neatly arranged rolls of colorful tickets are displayed behind the cashier.

* * *

>l at families
Families, couples, and friends form a buzzing line, their excitement building as they approach this first step into the magic of the carnival.

>ne
Carousel
The carousel is a timeless carnival attraction, radiating charm and nostalgia with its brightly painted horses, vibrant lights, and cheerful music. The circular platform is adorned with a canopy of swirling colors, gold trim, and decorative mirrors that reflect the flickering bulbs lining its edges.

Rows of hand-carved animals, most often horses with flowing manes, are arranged in a circle. Each is painted in vivid colors, detailed with golden saddles and ribbons. It also features creatures like lions, tigers, and sea dragons, adding whimsy to the ride. The animals rise and fall gently as the carousel spins, mimicking a galloping motion.

The carousel's warm, playful tunes drift across the midway, inviting riders of all ages to enjoy its simple delight. Children laugh as they choose their favorite animals, while adults savor the nostalgia of the spinning ride. As it rotates, the carousel becomes a moving work of art, blending motion, color, and music into an enchanting centerpiece of the carnival. The Ticket Kiosk is back to the southwest; the way you came.

You can see a Carousel Attendant here.

>give ticket to attendant
(the Carousel ticket to the Carousel Attendant)
You give the Carousel ticket to the Carousel Attendant.

Stepping onto the carousel's spinning platform, you're greeted by a kaleidoscope of color - brightly painted horses, glittering lights, and golden trim. The cheerful melody of calliope music fills the air. What will you choose as your mount, perhaps a galloping horse with a flowing mane, a majestic lion, or a whimsical giraffe. Gripping the polished pole, you settle onto the saddle, feeling the smooth rise and fall as the carousel begins to turn.

As the ride picks up speed, the world outside becomes a blur of glowing carnival lights and swirling colors. The gentle up-and-down motion mimics a playful gallop, and the rhythmic whir of the carousel's machinery adds a soothing backdrop to the cheerful atmosphere. Laughter and the sound of children's chatter mix with the music, creating a sense of nostalgia and joy.

For a few moments, you're transported into a magical world, the worries of the day fading away with each graceful rotation. Whether you're enjoying the ride alone, with friends, or sharing a special moment with family, the carousel's charm captures a timeless blend of whimsy and wonder. As it slows to a stop, you step off with a smile, the music lingering in your ears as you rejoin the bustling carnival.

>l at horses
The horses are mounted on poles which go up and down as the Carousel turns.

* * *

>listen to calliope
The carousel's warm, playful tunes drift across the midway, inviting riders of all ages to enjoy its simple delight.

>sw
Ticket Booth
You can see a janitor, a Cashier, and a ticket kiosk here.

>steal brass key
Out of the corner of his eye, the janitor sees you reach for his key ring.

>steal brass key
The janitor slaps your hand away as you reach for the key.

>steal brass key
The janitor says, "Hey! What do you think you're doing?!

The janitor heads to the Concession Stand.

>sw
Concession Stand
The concession stand, perched along the midway, is a colorful and bustling hub. Painted in bright reds, blues, and yellows, it features bold lettering announcing treats like "SODA! POPCORN! CANDY APPLES!" Strings of twinkling lights frame the stand, making it a glowing beacon amid the carnival excitement.

Behind the counter, a popcorn machine churns out golden kernels, filling the air with a buttery aroma. Candy apples gleam under the lights, and cotton candy machines spin fluffy clouds of pink and blue. Warm pretzels sit under a heat lamp, their buttery, salted scent mingling with the sugary treats. A cooler holds sodas, their colorful labels visible through the frosted glass.

The counter is lively with stacks of paper bags, napkins, and cups of cheese and sugar sprinkles. A handwritten chalkboard menu lists prices in playful lettering. Workers in colorful aprons quickly hand out snacks, their movements efficient amid the cheerful chaos.

In front of the stand, kids tug at their parents, teens share pretzels, and the crowd buzzes with energy. More than just a snack stop, the stand is a sensory delight, adding flavor and charm to the carnival experience.

To the south is the Carnival Office. The trailer's exterior is painted in dull, peeling shades of red and white, with old carnival advertisements that are barely legible due to sun damage. A string of dimly lit, flickering bulbs hang above the door, and an old "Private" sign is half-hanging on the side, clearly neglected.

There is a menu to the right of the window. You can see the treats inside the stand. There is an exit to the south and northeast. 

Nearby a sturdy door leads south.

You can also see a janitor, a Concession Attendant, a menu, a Drink of Cola, some Bubblegum, a Bucket of Popcorn, a Candy Apple, Cotton Candy, and a Soft Pretzel here.

>steal brass ring
Out of the corner of his eye, the janitor sees you reach for his key ring.

>steal brass ring
While the janitor is distracted, you manage to steal the brass ring from the janitor.

Taken.

>ne
Ticket Booth
You can see a Cashier and a ticket kiosk here.

>nw
Bumper Cars
The bumper cars is a bustling hub of excitement and laughter, set beneath a canopy of flashing lights and colorful decorations. The rectangular arena is surrounded by padded barriers, ensuring a safe yet thrilling experience for riders. The floor, slick and metallic, allows the brightly colored cars - painted in shades of red, blue, yellow, and green - to glide effortlessly in all directions.

Each car is equipped with a steering wheel and a padded bumper, designed to absorb the impact of playful collisions. As the ride begins, drivers of all ages eagerly maneuver their cars, aiming for friends, family, or strangers with mischievous grins. The air is filled with the sound of bumpers colliding, laughter, and the occasional squeal of surprise.

Overhead, a web of electric poles connects the cars to the ceiling, sparking faintly as they supply power to the vehicles. The ride operator watches from a booth, ensuring everyone enjoys the chaos safely. Surrounding the bumper cars are cheering onlookers, carnival lights, and the lively hum of the fairground.

The bumper cars perfectly captures the playful spirit of the carnival, offering a mix of harmless competition, shared laughter, and nostalgic fun for all ages. The Ticket Kiosk is southeast of here.

You can see a Bumper Cars attendant here.

>l at cars
(the Bumper Cars)
The Bumper Cars are small, colorful, electric-powered vehicles equipped with a padded outer rim to absorb impacts, allowing riders to safely bump into each other as part of the game. The ceiling has a conductive surface that powers the cars. Riders are thrilled by chaotic collisions, laughter, and the challenge of maneuvering away from - or into - other drivers.

>l at riders
Drivers of all ages eagerly maneuver their cars, aiming for others.

>l at bumper
(the Bumper Cars)
The Bumper Cars are small, colorful, electric-powered vehicles equipped with a padded outer rim to absorb impacts, allowing riders to safely bump into each other as part of the game. The ceiling has a conductive surface that powers the cars. Riders are thrilled by chaotic collisions, laughter, and the challenge of maneuvering away from - or into - other drivers.

>l at steering wheel
The steering wheel turns 360 degrees adding to the fun and excitement.

>x drivers
Drivers of all ages eagerly maneuver their cars, aiming for others.

>x poles
The electric poles connects the cars to the ceiling, sparking faintly as they supply power to the vehicles.

* * *

>l at booth
The operator stands in this booth overseeing the action below.

>se
Ticket Booth
You can see a Cashier and a ticket kiosk here.

>se
Fortune Teller
Approaching the fortune teller's booth, you're drawn in by its mysterious allure. Draped in deep purple curtains adorned with golden moons and stars, the booth glows with the soft, inviting light of candles. The air is heavy with the scent of incense, mingling with the sweet aroma of carnival treats. A sign sways slightly in the evening breeze.

You can see Esmeralda the Mysterious here.

>l at booth
Draped in deep purple curtains adorned with golden moons and stars, the booth glows with the soft, inviting light of candles. The air is heavy with the scent of incense, mingling with the sweet aroma of carnival treats.

* * *

>l at curtains
The curtains are deep purple with golden moons and stars.

>smell
The smell of incense wafts through the air mixed with the scent of fresh, buttered popcorn.

>listen
You can hear all the sounds of the carnival. The sounds of a calliope waft across the thoroughfare from the carousel. You can hear the laughter and screams as other patrons ride the rides and play the games.

>l at esmeralda
The fortune teller sits in a dimly lit booth, draped in rich fabrics of deep purple and gold, adorned with celestial patterns of stars and moons. Her appearance is enigmatic, with piercing eyes that seem to look right through you and a knowing smile that hints at secrets yet untold. She wears flowing robes embellished with shimmering beads, and a jeweled headpiece catches the flickering light of nearby candles.

>l at robes
Esmeralda wears flowing robes embellished with shimmering beads, and a jeweled headpiece.

* * *

>read sign
"Fortunes Told - What Does Your Future Hold?" Underneath that it says "Ticket Required"

>give ticket to fortune teller
(the Fortune Teller ticket to Esmeralda the Mysterious)
You give the Fortune Teller ticket to Esmeralda the Mysterious.

Stepping inside, you're greeted by the Esmeralda, a figure cloaked in flowing robes with a jeweled headpiece catching the flickering light. Her piercing eyes seem to look right through you as they gesture for you to sit at a small round table covered in an ornate cloth. At its center rests a glowing crystal ball, surrounded by tarot cards and mysterious trinkets.

Esmeralda's voice is low and melodic, weaving an air of intrigue as they ask you to focus on a question and offer you a tarot reading. The room seems to shrink, the bustling carnival outside fading into the background as they reveal your fate. Each card turned  feels significant, as though unlocking a secret you didn't know you carried.

Past: Eight of Cups (reversed)
Eight of Cups reversed indicates suggests that you may be clinging tightly to your comfort zone, even if it no longer serves your best interests. This card urges you to examine whether you are avoiding necessary growth or ignoring your true desires. It may be tempting to remain in familiar territory, but by doing so, you risk missing out on the opportunities that lie ahead. Now is the time to summon the courage to explore new horizons and embrace the unknown.

>z
Time passes.

Present: Knight of Swords (reversed)
Knight of Swords reversed signifies a lack of strategy, where actions are taken without much thought or consideration for the consequences. It suggests a tendency to rush into situations without a clear plan, leading to hasty decisions and potential conflicts. This reversed Knight warns against reckless behavior and encourages the need for patience and careful deliberation. It serves as a reminder to slow down, reflect, and align actions with a well-thought-out strategy in order to avoid unnecessary conflicts and achieve the desired outcomes.

>z
Time passes.

Challenge: The Devil (reversed)
Devil reversed indicate temptations resisted, stricter moral kept and an escape from the chains from the devil. It offers hope and liberation. The Devil reversed brings the strength and self awareness to confront your inner demons and break free from the suffocating bonds that have kept you trapped in patterns of self-destruction. It is a powerful call to examine your attachments, whether they be toxic relationships, harmful habits, or limiting beliefs.

>z
Time passes.

Opportunity: The Fool (upright)
Fool represents new beginnings and feeling carefree. It may indicate a new phase in your life such as starting a new job, moving to a new city, or beginning a new relationship. Embrace this new chapter with optimism and an open heart. The Fool reminds you that it's never too late to start fresh and that you can always take a leap of faith towards your dreams.

>z
Time passes.

Future: The Devil (upright)
Devil symbolizes primal behaviors, desires and addictions and materialism. It represents the fears that causes obsession and compulsive behavior. Its ominous appearance serves as a reminder that you may find yourself caught in the snare of worldly desires and unhealthy patterns. This card is a wake-up call to face your fears and conquer them. This is a card of temptation, and it's warning you to be careful of what you allow to control you.

As the reading concludes, Esmeralda gazes into your eyes with a cryptic smile and delivers their final words of wisdom: "The order of things is important. Alphabetically and numerically; one follows another and provides the link between the two. If you will learn, think on this carefully. Also, don't trust Whidbey. He's up to something."

Whether you leave with a sense of wonder, excitement, or unease, the encounter lingers with you - a touch of magic amid the carnival's chaos, as if you've glimpsed something beyond the ordinary.

>nw
Ticket Booth
You can see a janitor, a Cashier, and a ticket kiosk here.

>e
High Striker
This area features a tall, eye-catching machine adorned with bright, colorful lights, typically red, yellow, and blue. A large sign at the top reads "Test Your Strength!" in bold, playful lettering. The machine's base is made of polished wood, giving it a vintage appearance. At the center is a sturdy metal pole, with a large bell hanging at the top, signaling when a successful attempt has been made. Along the length of the pole are markings indicating how strong you are.  A nearby sign says, "Buy a mallet, strike the bell, win a prize."

Spectators gather around, cheering on participants and offering lighthearted jabs and encouragement, creating a lively, competitive atmosphere. The sound of the mallet hitting the target is followed by the resonant clang of the bell (if struck), alongside the buzz of carnival music in the background.

The Ticket Kiosk is to the west. Other games are northeast and southeast of here. The Ferris Wheel lies to the east.

You can see a Strongman attendant, a lever, and some High Striker prizes here.

The attendant is holding a mallet.

>e
Ferris Wheel
The Ferris wheel is the towering centerpiece of the carnival, its vibrant lights and graceful rotations drawing the attention of visitors from every corner of the fairgrounds. The wheel's massive steel frame arches high into the sky, its intricate network of beams glinting under the colorful glow of bulbs strung along its circumference. Each gondola, painted in bright hues like red, yellow, and blue, dangles from the wheel, swaying gently as it turns.

At night, the Ferris wheel transforms into a dazzling spectacle, with hundreds of synchronized lights creating patterns and ripples that pulse outward like waves. The bulbs flash in bursts of red, green, and white, casting playful reflections on nearby attractions and the surrounding crowd.

The air around the wheel is filled with a mix of excited chatter, the hum of its motor, and the occasional squeal of laughter or nervousness from riders high above. The ride operator, standing in a small booth at the base, keeps a steady rhythm of loading and unloading passengers, their voice occasionally calling out, "Step right up! The best view of the carnival awaits!"

The Ferris wheel offers an ever-changing perspective of the carnival below. From its peak, riders can see the entire fairground: the spinning lights of the rides, the colorful stripes of game booths, and the winding paths of visitors navigating the midway. Beyond the carnival, the view stretches to the horizon, with city lights adding to the magical experience.

Whether it's a romantic ride for couples, a thrilling adventure for friends, or a calming retreat for families, the Ferris wheel captures the spirit of the carnival - an iconic blend of excitement, wonder, and timeless charm.

Hey! Is that a two dollar bill on the ground?

You can also see a Ferris Wheel Attendant here.

* * *

>l at beams
The Ferris wheel towers above the carnival and is illuminated with vibrant lights, creating a dazzling display. As the wheel turns slowly, the gondolas remain upright, offering riders a thrilling yet gentle experience and spectacular views from the top.

* * *

>l at gondolas
Each gondola, painted in bright hues like red, yellow, and blue, dangles from the wheel, swaying gently as it turns.

>l at bulbs
The Ferris wheel towers above the carnival and is illuminated with vibrant lights, creating a dazzling display. As the wheel turns slowly, the gondolas remain upright, offering riders a thrilling yet gentle experience and spectacular views from the top.

>l at bill
It has a picture of Thomas Jefferson on it.

* * *

>raise safety bar
The safety bar is locked in place.

>w
High Striker
You can see a Strongman attendant, a lever, and some High Striker prizes here.

The attendant is holding a mallet.

The janitor arrives from the Ticket Booth.

>l
High Striker
This area features a tall, eye-catching machine adorned with bright, colorful lights, typically red, yellow, and blue. A large sign at the top reads "Test Your Strength!" in bold, playful lettering. The machine's base is made of polished wood, giving it a vintage appearance. At the center is a sturdy metal pole, with a large bell hanging at the top, signaling when a successful attempt has been made. Along the length of the pole are markings indicating how strong you are.  A nearby sign says, "Buy a mallet, strike the bell, win a prize."

Spectators gather around, cheering on participants and offering lighthearted jabs and encouragement, creating a lively, competitive atmosphere. The sound of the mallet hitting the target is followed by the resonant clang of the bell (if struck), alongside the buzz of carnival music in the background.

The Ticket Kiosk is to the west. Other games are northeast and southeast of here. The Ferris Wheel lies to the east.

You can see a janitor, a Strongman attendant, a lever, and some High Striker prizes here.

The attendant is holding a mallet.

>read sign
Which do you mean, the markings or the High Striker sign?

>markings
There are five levels marked on the pole: Weakling, Getting There, Average, Almost There, and Muscle Man.

Over the loud speaker, an announcement blares: Attention please. There is a vehicle being towed from the parking lot for parking illegally. The license plate of the car is "862901". You breathe a sigh of relief as you realize that's not your license plate. I guess it's a good thing you remembered to place the parking stub on the dashboard.

>read high striker sign
Buy a mallet, strike the bell, win a prize.

>l at base
The High Striker is a tall, eye-catching machine adorned with bright, colorful lights. A large sign at the top reads "Test Your Strength!". The machine's base is made of polished wood. At the center is a sturdy metal pole, with a large bell hanging at the top.

>l at pole
There are five levels marked on the pole: Weakling, Getting There, Average, Almost There, and Muscle Man.

The janitor heads to the Ferris Wheel.

>l at spectators
Spectators gather around, cheering on participants and offering lighthearted jabs and encouragement.

* * *

>l at bell
This is the bell that will ring out when you prove to everyone that you're a "Muscle Man".

>buy mallet
You fork over $2.00 for the mallet, leaving yourself with $20.00.

The janitor arrives from the Ferris Wheel.

>hit bullseye with mallet
You lift the mallet high and bring it down on the lever with all your might! The striker rises towards the bell stopping at "Average".

>g
You lift the mallet high and bring it down on the lever with all your might! The striker rises towards the bell stopping at "Average".

>g
You lift the mallet high and bring it down on the lever with all your might! The striker rises towards the bell stopping at "Getting Stronger".

>g
You lift the mallet high and bring it down on the lever with all your might! The striker rises towards the bell stopping at "Getting Stronger".
 
You can't be sure of it but it seems as if the mallet isn't heavy enough to ring the bell.

>g
You lift the mallet high and bring it down on the lever with all your might! The striker rises towards the bell stopping at "Almost There".
 
The janitor heads to the Ticket Booth.

>ne
Dime Toss Game
The game booth is adorned with vibrant colors - red-and-white striped awnings, twinkling lights, and eye-catching signage that reads "TOSS A DIME - WIN A PRIZE!". You can see prizes of all shapes and sizes hang around the booth, from stuffed animals and novelty toys to shiny trinkets and quirky collectibles. The larger prizes are prominently displayed to entice passersby. Rows of gleaming plates sparkle under overhead lights, their glass surfaces reflecting the surrounding glow.

The distinctive "ping" of dimes hitting plates creates a rhythmic soundtrack, punctuated by the occasional satisfying "plop" when a dime lands perfectly. Victorious shouts mix with playful groans of near-misses, creating a symphony of excitement. Nearby, the hum of other booths, upbeat carnival music, and the distant laughter of children add to the lively backdrop. The booth operator calls out enthusiastically, "Step right up! Test your skill! Win big!" Their energetic pitch draws in curious onlookers. You thought you caught a flash of something coming from the area of the booth.

You're surprised to see that this game only costs a dime. The exit is to the southwest.

You can see a Dime Toss attendant, some Dime Toss prizes, and a plate here.

>l at awnings
The game booth is adorned with vibrant colors - red-and-white striped awnings, twinkling lights, and eye-catching signage.  You can see something shiny on the ground under the booth.

>read sign
The sign reads, "TOSS A DIME - WIN A PRIZE!".

* * *

>l at plates
These are small, flat plates, almost saucers. You are meant to toss a dime on these plates to win a prize!

>l under booth
You find the Mercury dime!

* * *

>get mercury dime
Taken.

[Your score has just gone up by five points.]

>x it
The Mercury dime is a ten-cent coin struck by the United States Mint from late 1916 to 1945. Designed by Adolph Weinman and also referred to as the Winged Liberty Head dime, it gained its common name because the obverse depiction of a young Liberty, identifiable by her winged Phrygian cap, was confused with the Roman god Mercury. It is 90% silver, 10% copper, and has a weight of 2.50 grams.

>toss dime at plate
(the Mercury dime at the plate)
You toss the dime. The heavier Mercury dime hits the plate, starts to spins, and lands in the center of the plate. The attendant shouts out, "Winner! Winner!"

Which prize would you like? 1) a stuffed monkey, 2) an orange colored fuse, 3) a poster of Billie Eilish, 4) a horseshoe magnet?

>toss dime at plate
(the dime at the plate)
You toss the dime. The dime hits the plate and bounces straight off.

>4
You are now holding a horseshoe magnet.

[Your score has just gone up by five points.]

* * *

>l at milk bottles
The milk bottles are stacked in three neat rows: three on the bottom, two in the middle, and one on top. 

         1         
       2   3     
     4   5   6

* * *

>l at prizes
The prizes are a crimson colored fuse, a plush donkey, a goldfish in a bowl, and a poster of Lourde.

>give dime to attendant
The attendant gives you three baseballs in return and says, "Throw the baseball at bottle X where X is the bottle number you want to hit. The bottles are numbered one to six".

>throw baseball at bottle 1
You wind up and throw the baseball at the milk bottles. You knocked over one bottle. You can do better than that.

>throw baseball at bottle 3
You wind up and throw the baseball at the milk bottles. You knocked over one bottle. You can do better than that.

>throw baseball at bottle 5
You wind up and throw the baseball at the milk bottles. The ball hits the bottles in the sweet spot and they topple over onto the platform. The attendant shouts out, "Winner! Winner!"

Which prize would you like? 1) a crimson colored fuse, 2) a plush donkey, 3) a goldfish in a bowl, 4) a poster of Lourde?

* * *

>nw
High Striker
You can see a Strongman attendant, a lever, and some High Striker prizes here.

>l at prizes
The prizes are a teddy bear, a Swiss Army knife, a magenta colored fuse, and a poster of Taylor Swift.

>w
Ticket Booth
You can see a Cashier and a ticket kiosk here.

>sw
Concession Stand
Nearby a sturdy door leads south.

You can also see Mr Whidbey, a Concession Attendant, a menu, a Drink of Cola, some Bubblegum, a Bucket of Popcorn, a Candy Apple, Cotton Candy, and a Soft Pretzel here.

>l at stand
The Concession Stand, perched along the midway, is a colorful and bustling hub. Painted in bright reds, blues, and yellows, it features bold lettering announcing treats like "SODA! POPCORN! CANDY APPLES!" Strings of twinkling lights frame the stand, making it a glowing beacon amid the carnival excitement.

Mr Whidbey heads to the Ticket Booth.

>read sign
$2.00 Drink Of Cola
$2.50 Bucket Of Popcorn
$1.50 Candy Apple
$1.50 Cotton Candy
$1.50 Soft Pretzel
$1.00 Bubblegum

>ask attendant about popcorn
The Concession Attendant says, "The popcorn is really good. It's hot and fresh."

>ask attendant about pretzels
The Concession Attendant says, "I prefer to eat my pretzels with mustard."

>ask attendant about cotton candy
"I love the way cotton candy melts in my mouth", says the Concession Attendant.

>ask attendant about candy apples
The Concession Attendant says, "I can't eat these. They get stuck in my braces."

>ask attendant about bubblegum
"It's Bazooka Joe! My favorite!", the Concession Attendant says.

>l at counter
On the counter there are paper bags, napkins, and cups of cheese and sugar sprinkles.

* * *

>l at butts
The chair is surrounded by cigarette butts carelessly discarded on the ground.

>e
Concession Stand
Nearby a sturdy door leads south.

You can also see a Concession Attendant, a menu, a Drink of Cola, a Bucket of Popcorn, a Candy Apple, Cotton Candy, and a Soft Pretzel here.

* * *

>z
Time passes.

"I know, I know, but what am I supposed to do. That Needleman kid isn't happy with the payout we gave him. He wants $15,000 more."

>z
Time passes.

Isn't this why I buy insurance? Don't worry. You'll get your piece.

>n
You're afraid if you move too much, Mr Whidbey will notice you!

Mr. Whidbey says "I need that money in a hurry though or he's going to go to the authorities. And then you're going down too."

>z
Time passes.

"Ok, I'll try to stall him but I won't be able to do it for long."

>z
Time passes.

"Hey! What are you doing here? This is an employees only area," Mr. Whidbey shouts at you. "Get out of here. Now!"

Concession Stand
The concession stand, perched along the midway, is a colorful and bustling hub. Painted in bright reds, blues, and yellows, it features bold lettering announcing treats like "SODA! POPCORN! CANDY APPLES!" Strings of twinkling lights frame the stand, making it a glowing beacon amid the carnival excitement.

Behind the counter, a popcorn machine churns out golden kernels, filling the air with a buttery aroma. Candy apples gleam under the lights, and cotton candy machines spin fluffy clouds of pink and blue. Warm pretzels sit under a heat lamp, their buttery, salted scent mingling with the sugary treats. A cooler holds sodas, their colorful labels visible through the frosted glass.

The counter is lively with stacks of paper bags, napkins, and cups of cheese and sugar sprinkles. A handwritten chalkboard menu lists prices in playful lettering. Workers in colorful aprons quickly hand out snacks, their movements efficient amid the cheerful chaos.

In front of the stand, kids tug at their parents, teens share pretzels, and the crowd buzzes with energy. More than just a snack stop, the stand is a sensory delight, adding flavor and charm to the carnival experience.

To the south is the Carnival Office. The trailer's exterior is painted in dull, peeling shades of red and white, with old carnival advertisements that are barely legible due to sun damage. A string of dimly lit, flickering bulbs hang above the door, and an old "Private" sign is half-hanging on the side, clearly neglected.

There is a menu to the right of the window. You can see the treats inside the stand. There is an exit to the south and northeast. 

Nearby a sturdy door leads south to the Carnival Office.

You can also see a Concession Attendant, a menu, a Drink of Cola, a Bucket of Popcorn, a Candy Apple, Cotton Candy, and a Soft Pretzel here.

You suddenly find yourself unceremoniously out of the Carnival Office and into the Concession Stand.

* * *

>open safe
You open the safe, revealing an indigo colored fuse, a gold key, and an insurance policy.

>get all from safe
indigo colored fuse: Taken.
gold key: (putting the wallet into the fanny pack to make room)
Taken.
insurance policy: (putting the dime into the fanny pack to make room)
Taken.

[Your score has just gone up by five points.]

[Your score has just gone up by ten points.]

>l at paperwork
Piles of receipts and old financial statements cover much of the desk, but the documents seem to be a mix of chaotic disorganization and purposeful concealment. Most of these are for the regular day to day expenses such as: paper goods, consumables, etc. Closer inspection shows a steadily declining volume of goods ordered. Almost as if the carnival couldn't afford the full cost. Some are marked paid and others are not. Some are marked "Past Due". I wonder if the carnival is in some kind of financial trouble.

>open filing cabinet
(first unlocking the filing cabinet)
(with the gold key)
You open the filing cabinet, revealing an envelope, a Cash 'N' Carry invoice, a Frank's Market invoice, an Oriental Trading invoice, and a Mystic Industries invoice.

>get all invoices
Cash 'N' Carry invoice: (putting the dime into the fanny pack to make room)
Taken.
Frank's Market invoice: (putting the dime into the fanny pack to make room)
Taken.
Oriental Trading invoice: (putting the nickel into the fanny pack to make room)
Taken.
Mystic Industries invoice: (putting the quarter into the fanny pack to make room)
Taken.

[Your score has just gone up by five points.]

[Your score has just gone up by five points.]

[Your score has just gone up by five points.]

[Your score has just gone up by five points.]

>get envelope
(putting the quarter into the fanny pack to make room)
Taken.

>open envelope
You open the envelope, revealing a cashier's check.

>get check
(putting the quarter into the fanny pack to make room)
Taken.

[Your score has just gone up by ten points.]

>l at check
This cashier's check is made payable to "Fred Needleman". The amount is $10,000 and the memo line reads "For services rendered."

>l at Cash 'n' carry
The Cash 'N' Carry invoice reads:

 Cash 'N' Carry.
 121 Maple St
 Stoneham, WA 98132

 2 cases of Soda Cups         $82.50
 1 case of Popcorn Buckets   $106.73
 3 cases of Napkins           $56.41
 Total:                      $245.64

 After the 10th of the month, this invoice will be assessed a finance charge of 3.75% per month, We appreciate your prompt payment.

>l at frank's market
Frank's Market invoice reads:

 Frank's Market Wholesale
 1 Market Pl
 Cambridge, WA 98325

 8 dozen lemons                     $85.00
 10 bags of flour (50 pounds)      $200.00
 5 bags of sugar (50 pounds)       $250.00
 5 Cases of Mexican Coca-Cola      $210.00
 Total:                            $745.00

 Notice: Your account has been closed. Kindly remit the balance due immediately!

>l at oriental trading
The Oriental Trading invoice reads:

 Oriental Trading Company
 P.O. Box 2308
 Omaha, NE 68103-2308

 Mega Bulk 1000 Pc. Multicolor Toy & Novelty Handout Assortment    $184.99
 19" x 11" Bulk 500 Pc. Everyday Toy Treasure Chest Assortment     $119.98
 7" Bulk 72 Pc. Mini Solid Color Plastic Outdoor Bubble Wands       $77.98
 2" Bulk 100 Pc. Mega Everyday Fun Yellow Rubber Ducks Assortment   $44.99
 Total:                                                            $427.94

 Your account is past due. Please pay immediately!

>l at mystic industries
The Mystic Industries invoice reads:

 Mystic Industries, Inc.
 40 Elm St
 Medford, WA 98101

 For services rendered:
 Repairs to the Stake Room in the Hell Ride Attraction after Fire   $22,500.00

 Please note that this invoice is overdue and will be assessed a finance charge of 2.5% per month, We appreciate your prompt payment.

>l at bulb
The flickering light from the lamps casts a yellow hue about the office.

* * *

>l at knick-knacks
These are little bits of memorabilia from the carnival life. There is a miniature Ferris wheel here. You can also see a mini carousel here.

>l at ferris wheel
(the Ferris Wheel)
The Ferris wheel towers above the carnival and is illuminated with vibrant lights, creating a dazzling display. As the wheel turns slowly, the gondolas remain upright, offering riders a thrilling yet gentle experience and spectacular views from the top.

>x carousel
This is a miniature replica of the Carousel.

Mr Whidbey arrives from the Guillotine Room.

>l at brochures
The brochures are meant to be left at convenience stores restaurants, and other businesses as a way to attract visitors to the carnival.

* * *

>l at cabinet
A locked cabinet, likely filled with old carnival financial records, is tucked away against one wall.

>l at safe
You have turned the knob to 62, 22, and 3.

>read receipts
Piles of receipts and old financial statements cover much of the desk, but the documents seem to be a mix of chaotic disorganization and purposeful concealment. Most of these are for the regular day to day expenses such as: paper goods, consumables, etc. Closer inspection shows a steadily declining volume of goods ordered. Almost as if the carnival couldn't afford the full cost. Some are marked paid and others are not. Some are marked "Past Due". I wonder if the carnival is in some kind of financial trouble.

>get ferris wheel
(the mini Ferris wheel)
(putting the air freshener into the fanny pack to make room)
Taken.

Mr Whidbey heads to the Concession Stand.

>n
Concession Stand
Nearby a sturdy door leads south to the Carnival Office.

You can also see Mr Whidbey, a Concession Attendant, a menu, a Drink of Cola, a Bucket of Popcorn, a Candy Apple, Cotton Candy, and a Soft Pretzel here.

>l at ferris wheel
(the mini Ferris wheel)
This is a miniature reproduction of the Ferris wheel.

>drop ferris wheel
(the mini Ferris wheel)
Dropped.

* * *

>l at ferris wheel
(the Ferris Wheel)
The Ferris wheel towers above the carnival and is illuminated with vibrant lights, creating a dazzling display. As the wheel turns slowly, the gondolas remain upright, offering riders a thrilling yet gentle experience and spectacular views from the top.

>ne
Ticket Booth
You can see a Cashier and a ticket kiosk here.

Mr Whidbey arrives from the Concession Stand.

>w
The barker cries:

Ladies and gentlemen, boys and girls, gather 'round! 
Step right up and witness the spectacle that's taken the world by storm! 
She walks, she talks, she crawls on her belly like a reptile. 
Behold the one, the only Little Egypt, performing her legendary Dance of the Pyramids - a dazzling display of mystery, grace, and allure! 
For just a dime, a mere one tenth of a dollar, prepare to be transported to the sands of Cairo, where enchantment and wonder await!

Show Facade
You head west through the midway, the bright lights of the carnival fading behind you as you approach a tent. A sign above the entrance reads "Little Egypt Show - A Journey Into the Mysterious and the Unknown!" A rotund barker, wearing a fez and a dazzling smile, gestures to a small sign beside him. The Ticket Kiosk is back the way you came.

There is a stage in front of the tent. The Barker is encouraging you to step up and enjoy the Little Egypt Show.

You can see a Barker here.

>l at tent
Inside the tent is the Little Egypt show.

* * *

>read sign
The sign reads, "Little Egypt Show - Dime Admission". Underneath it says "The show starts every 15 minutes beginning at the top of the hour."

>give dime to barker
(first taking the dime)
You hand over a dime, and the barker nods, waving you through. As you step past the entrance, the air feels thicker, almost humid, and the sounds of the carnival fade away. You've entered an entirely different world now - one filled with the scents of incense and unfamiliar spices, and the low, hypnotic music of a faraway land. Before you, a series of dimly lit tents stretch out, their flaps slightly swaying in the breeze. Intrigued, you take your first step into the Little Egypt Show. You can now head west into the show.

>w
Show Tent
You are inside the Little Egypt Show. The attraction's facade is to the east. There are folding chairs organized neatly in rows. The show should start soon.

>sit in chair
You get onto the folding chair.

* * *

>listen
The soft sounds of unfamiliar music fill the air.

>l at palace
The stage is decorated to resemble an Middle Eastern palace, featuring rich, colorful fabrics, brass ornaments, and lanterns casting a warm, flickering glow. Scents of incense waft through the air, enhancing the atmosphere of mystique. The canvas displays painted scenes of pyramids, desert landscapes, and domed structures to evoking a sense of being transported to the "Middle East".

>l at stage
The stage is decorated to resemble an Middle Eastern palace, featuring rich, colorful fabrics, brass ornaments, and lanterns casting a warm, flickering glow. Scents of incense waft through the air, enhancing the atmosphere of mystique. The canvas displays painted scenes of pyramids, desert landscapes, and domed structures to evoking a sense of being transported to the "Middle East".

>l at pyramids
The canvas displays painted scenes of pyramids, desert landscapes, and domed structures .

* * *

>l at landscapes
The canvas displays painted scenes of pyramids, desert landscapes, and domed structures .

>l at lanterns
This is a highly polished brass lantern.

It is currently switched off.

>get lantern
Taken.

[Your score has just gone up by five points.]

* * *

>turn it on
You flip a switch. A strong, narrow beam of light shines from the lit lantern.

>l at backdrop
Elegantly painted on linen, the backdrop shows scenes of Middle Eastern life.

>look at veils
Little Egypt is a beautiful woman who is draped in flowing silk veils which she skillfully uses as part of the dance. Her attire consists of a sparkling, sequined bodice and a flowing skirt, adorned with jingling coin belts and jewelry that accentuate her movements.

In the dimly lit tent, you see that the stage is decorated to resemble a Middle Eastern palace, featuring rich, colorful fabrics, brass ornaments, and lanterns casting a warm, flickering glow. Scents of incense waft through the air, enhancing the atmosphere of mystique. The backdrop displays painted scenes of pyramids, desert landscapes, and domed structures evoking a sense of being transported to the "Middle East".

>z
Time passes.

Little Egypt emerges draped in flowing silk veils which she skillfully uses as part of the dance. Her attire consists of a sparkling, sequined bodice and a flowing skirt, adorned with jingling coin belts and jewelry that accentuate her movements.

* * *

>wear veil
You wrap the veil around your head, shrouding your eyes. The world is a lovely color pink as you look through the veil while her perfume fills your nostrils in the most delightful way. You look pretty!

[Your score has just gone up by five points.]

>l at scenes
The canvas displays painted scenes of pyramids, desert landscapes, and domed structures .

>l at landscapes
The canvas displays painted scenes of pyramids, desert landscapes, and domed structures .

* * *

>l at canvas
Elegantly painted on linen, the backdrop shows scenes of Middle Eastern life.

>l at backdrop
Elegantly painted on linen, the backdrop shows scenes of Middle Eastern life.

>l at cymbals
The cymbals are placed on the thumb and index finger of each hand. Tapping them together produces a ringing sound.

In the dimly lit tent, you see that the stage is decorated to resemble a Middle Eastern palace, featuring rich, colorful fabrics, brass ornaments, and lanterns casting a warm, flickering glow. Scents of incense waft through the air, enhancing the atmosphere of mystique. The backdrop displays painted scenes of pyramids, desert landscapes, and domed structures evoking a sense of being transported to the "Middle East".

>l at sword
This is a beautiful steel sword with a filigreed handle and blade.

Little Egypt emerges draped in flowing silk veils which she skillfully uses as part of the dance. Her attire consists of a sparkling, sequined bodice and a flowing skirt, adorned with jingling coin belts and jewelry that accentuate her movements.

>l at wall
You see nothing special about the wall.

The performance begins with slow, undulating movements, drawing you into the rhythm of unfamiliar live music played on traditional instruments like the oud, darbuka, or zurna. As the tempo builds, her hips, torso, and hands move in intricate, mesmerizing patterns, demonstrating remarkable control and fluidity. She incorporates dramatic spins, drops, and shimmies, often accentuating the beat of the music with a quick jingle of her coin belt.

>l at instruments
The musical instrument is of traditional Middle Eastern origins.

Little Egypt makes eye contact with you and smiles enigmatically. During her performance she balances a sword on her head and accents her dance with finger cymbals.

>z
Time passes.

The music alternates between hauntingly slow melodies and rapid, energetic drum beats, creating an emotional arc that keeps you entranced. Little Egypt relies on the music's dynamic changes to tell a story with movements reflecting joy, sorrow, seduction, and celebration.

>z
Time passes.

The performance concludes with a dramatic flourish of a fast-paced shimmy, a bold spin, and Little Egypt dramatically casts off her veils. The dancer takes a bow to enthusiastic applause, leaving you spellbound by the sensual yet artful display.

You applaud until your hands are sore. Did she just wink at you?

>stand
You get off the folding chair.

Show Tent

>e
Show Facade
You can see a Barker here.

>look
Show Facade
You head west through the midway, the bright lights of the carnival fading behind you as you approach a tent. A sign above the entrance reads "Little Egypt Show - A Journey Into the Mysterious and the Unknown!" A rotund barker, wearing a fez and a dazzling smile, gestures to a small sign beside him. The Ticket Kiosk is back the way you came.

There is a stage in front of the tent. The Barker is encouraging you to step up and enjoy the Little Egypt Show.

You can see a Barker here.

>read sign
The sign reads, "Little Egypt Show - Dime Admission". Underneath it says "The show starts every 15 minutes beginning at the top of the hour."

>l at barker
Here is a man dressed in black pants, a blue shirt, a red vest, a hat much like a fez, and a dazzling smile.

The barker cries:

Ladies and gentlemen, boys and girls, gather 'round! 
Step right up and witness the spectacle that's taken the world by storm! 
She walks, she talks, she crawls on her belly like a reptile. 
Behold the one, the only Little Egypt, performing her legendary Dance of the Pyramids - a dazzling display of mystery, grace, and allure! 
For just a dime, a mere one tenth of a dollar, prepare to be transported to the sands of Cairo, where enchantment and wonder await!

>e
Ticket Booth
You can see a janitor, a Cashier, and a ticket kiosk here.

>l at attendant
This is another bored teenager. He's thinking about the big game on Friday night.

>g
This is another bored teenager. He's wondering why he took this stupid job in the first place.

>g
This is another bored teenager. He's just trying to earn enough money to take his sweetie to the movies next week.

>ask attendant about uniform
Wearing blue pants and a pink shirt, the Cashier says, "This is just awful! I look like a lollipop."

The janitor heads to the Head of the Line.

>ask attendant about brewski
"A nice cold Coors Light would taste good about now", the Cashier replies

>ask attendant about beer
"A nice cold Coors Light would taste good about now", the Cashier replies

>ask attendant about game
The Cashier says, "Friday night is the league championship. I hope we win!"

>s
Head of the Line
You are standing in front of an attendant with his hand open waiting for your ticket. The entrance to the ride is south of here. The ride operator tells you that you're lucky you showed up when you did because this will be the last trip through Hell Ride for the night. You notice that all the other cars are empty. The Ticket Kiosk is north of here.

You can see a janitor and a Hell Ride Attendant here.

>l at cars
(the hell ride cars)
These cars ferry carnival goers into the depths of Hell Ride.

The janitor heads to the Ticket Booth.

>l at car
These cars ferry carnival goers into the depths of Hell Ride.

* * *

>shit
And you kiss your mother with that mouth?

>damn
Shhh! Someone will hear you!

>s
You'll need a ticket to go that way.

>give ticket to attendant
(the Hell Ride ticket to the Hell Ride Attendant)
You give the Hell Ride ticket to the Hell Ride Attendant.

* * *

>l at cars
(the Hell Ride car)
A car waits to take you through the horror that is Hell Ride.

* * *

>l at threshold
There are skulls scattered about the threshold of the ride entrance.

>l at flashes
Flashes of sickly green light reveal twisted paths and grotesque shapes in the dark of the ride.

Mr Whidbey arrives from the Head of the Line.

>e
Dark Passage
This room is backstage at the Hell Ride attraction. The room is littered with bags of trash, piles of junk, and dust bunnies so large they should be paying rent. There an exit to the south and west.

[Your score has just gone up by five points.]

>l at bags of trash
The bags of trash are piled in the corner.

>l at junk
This is a pile of assorted flotsam and jetsam from the carnival. None of it looks very interesting.

In the pile of junk is a flashlight.

* * *

>get flashlight
Taken.

[Your score has just gone up by five points.]

>turn it on
You flip a switch. A strong, narrow beam of light shines from the lit flashlight.

Mr Whidbey arrives from Ride Entrance.

>w
Ride Entrance
You can see a Hell Ride car (empty) here.

* * *

>n
Ticket Booth
You can see a Cashier and a ticket kiosk here.

>s
Head of the Line
You can see a Hell Ride Attendant here.

>n
Ticket Booth
You can see a Cashier and a ticket kiosk here.

>e
High Striker
You can see a janitor, a Strongman attendant, a lever, and some High Striker prizes here.

>l at janitor
The janitor looks bored as he waits for you to speak.

The janitor is a portly gentleman wearing dirty overalls, leaning on a broom. He complains that he's missing his flashlight. "My pliers are missing too!" he says.

>e
Ferris Wheel
You can see a Ferris Wheel Attendant here.

>give flashlight to janitor
You can't see any such thing.

>w
High Striker
You can see a janitor, a Strongman attendant, a lever, and some High Striker prizes here.

>w
Ticket Booth
You can see a Cashier and a ticket kiosk here.

>s
Head of the Line
You can see a Hell Ride Attendant here.

* * *

>l at bunnies
These are some massive dust bunnies. Be careful, I've heard they bite.

>s
Maintenance Office
The maintenance office, hidden behind the carnival's bright facade, is a dim and cluttered space reeking of grease, sweat, and faint traces of popcorn from the midway. The air hangs heavy with oil and stirred-up dust.

The walls are lined with shelves holding tools and parts in disarray - screws and mismatched jars with faded labels. Paint cans and grease jars clutter the workbenches, many left half-open. In the center, a battered desk is strewn with wires, gears, and springs, a bent piece of metal held in a vise. Overhead, a single flickering fluorescent light struggles to illuminate the room.

In one corner, a disassembled ride mechanism lies exposed, chains and pulleys dangling from hooks above, faintly clinking with the vibrations of the rides. A grease-stained manual and a half-drained mug of coffee sit abandoned on a nearby stool.

The walls display faded safety posters, a cork board with maintenance schedules and notes, and a worn photo of the carnival in its prime. A clock ticks faintly, its hands out of sync with reality. The floor, gritty with dust and scattered nails, adds to the room's chaotic charm.

Despite the mess, the room buzzes with purpose - a hidden hub where the carnival's magic is sustained through sweat, ingenuity, and the hum of machinery.

Exits lead north and south.

Nearby a ladder leads up.

Nearby an aqua colored door leads west.

You can also see a worn photo and a desk (on which are a coffee mug and a radio) here.

>smell
You smell grease, oil, and the other scents that linger back stage.

* * *

>l at wires
The wires lay in twisted tangles on the desk.

>turn on radio
You switch the radio on.

"Fool In The Rain" by Led Zeppelin plays on the radio.

>l at gears
The gears and springs are strewn on the desk.

You hear Paul Simon's "Kodachrome" playing on the radio.

>l at posters
You're the safe choice for safety!

"Bohemian Rhapsody" by Queen plays on the radio.

>l at schedules
Looking at the maintenance schedules and notes, all you can see are the illegible scribbles of a child.

The DJ announces that "Never Gonna Give You Up" by Rick Astley will be up next.
 Yes, you have been Rick Rolled!

>look
Maintenance Office
The maintenance office, hidden behind the carnival's bright facade, is a dim and cluttered space reeking of grease, sweat, and faint traces of popcorn from the midway. The air hangs heavy with oil and stirred-up dust.

The walls are lined with shelves holding tools and parts in disarray - screws and mismatched jars with faded labels. Paint cans and grease jars clutter the workbenches, many left half-open. In the center, a battered desk is strewn with wires, gears, and springs, a bent piece of metal held in a vise. Overhead, a single flickering fluorescent light struggles to illuminate the room.

In one corner, a disassembled ride mechanism lies exposed, chains and pulleys dangling from hooks above, faintly clinking with the vibrations of the rides. A grease-stained manual and a half-drained mug of coffee sit abandoned on a nearby stool.

The walls display faded safety posters, a cork board with maintenance schedules and notes, and a worn photo of the carnival in its prime. A clock ticks faintly, its hands out of sync with reality. The floor, gritty with dust and scattered nails, adds to the room's chaotic charm.

Despite the mess, the room buzzes with purpose - a hidden hub where the carnival's magic is sustained through sweat, ingenuity, and the hum of machinery.

Exits lead north and south.

Nearby a ladder leads up.

Nearby an aqua colored door leads west.

You can also see a worn photo and a desk (on which are a coffee mug and a radio) here.

You sing along to Bruce Springsteen's "Born To Run".

>read manual
The manual is titled: "Fixing Your Ferris Wheel. It's Easier Than You Think!"

You hear Cat Stevens's "Peace Train" playing on the radio.

>drink coffee
That looks nasty. There's something floating on the top. I wouldn't drink that if I was you.

The DJ announces that "Respect" by Aretha Franklin will be up next.

>drink coffee
You decide to drink it after all. Your stomach lurches as the cold, nasty coffee settles.

Nearby, you can hear "No Woman, No Cry" by Bob Marley.

>drink coffee
You've learned your lesson and set the coffee cup down.

You hear Kermit the Frog's "Rainbow Connection" playing on the radio.

>drink coffee
There's nothing suitable to drink here.

Nearby, you can hear "Respect" by Aretha Franklin.

>l at clock
The clock is wildly off the correct time. I guess it's broken.

"Werewolves Of London" by Warren Zevon plays on the radio.

>turn off radio
You switch the radio off.

* * *

>l at monitor
The monitor flickers for a second and the scene it displays changes to something different.
The monitor now shows nothing but snow.

* * *

>listen
The hum of electronics fills the air, punctuated by the crackle of a radio: "Maintenance to Bumper Cars - wrench needed!"

>flip switch
You switch the big switch off.

[Your score has just gone up by ten points.]

>e
Dark Hallway
Nearby a metal door leads west to Control Room.

Nearby a ladder leads down to the Maintenance Office.

>d
Maintenance Office
Nearby a ladder leads up to Dark Hallway.

Nearby an aqua colored door leads west.

You can also see a worn photo and a desk (on which are a coffee mug and a radio) here.

>get photo
(putting the parking ticket into the fanny pack to make room)
Taken.

>look at it
This is a photo of the carnival in its heyday! A ragtag bunch of people are featured in the picture in front of the Hell Ride facade. On the back reads a date: "03/22/62". This looks like the same photo you found in the Carnival Office.

>s
Crawl Space
The crawl space beneath the carnival ride is a tight, claustrophobic tunnel shrouded in darkness and filled with the hum of machinery above. The air is stale and heavy, carrying the sharp metallic scent of oil and the faint tang of rust. Every sound is amplified in the confined space - the groaning of steel beams, the clanking of chains, and the rhythmic thrum of motors driving the ride above.

The ground is uneven, a mix of packed dirt and loose gravel scattered with forgotten tools, scraps of metal, and tangled wires. Overhead, a network of pipes crisscross the space, some wrapped in fraying insulation that crackles faintly as you crawl past. Small puddles of murky water collect in dips on the floor, their surfaces rippling with vibrations from the ride's movement.

The backstage area continues north and south.

Nearby a crimson colored door leads west.

>listen
You can hear the hum of the machinery above.

* * *

>l at puddles
You move gingerly to avoid the puddles. It's much more pleasant to be dry.

>s
Mechanical Room North
The north mechanical room is compact and specialized, housing auxiliary systems that keep the ride running smoothly. A subdued hum of capacitors and relays fills the space, its quiet rhythm broken only by the occasional hiss of hydraulic fluid.

Circuit breaker panels line the walls, labeled for functions like "Lighting Controls" and "Brake Systems". Smaller cables and conduits snake along the walls, linking these systems to the main hub. In one corner, a hydraulic pump and reservoir manage lifting arms and rotating platforms, their gauges flickering as they work.

A small workbench against the eastern wall is cluttered with tools and coiled wires, while shelves above hold neatly labeled spare parts - cables, and hydraulic tubing. A faded ride diagram pinned nearby is marked with red annotations from past repairs.

Dimly lit by a single hanging bulb, the room feels cooler and slightly damp, the metallic tang of machinery mixing with a hint of mildew. Though quieter and less prominent than the south mechanical room, this space plays a vital role in supporting the ride's operation and ensuring its emergency systems are always prepared.

There are exists north and south.

Nearby an emerald colored door leads west.

You can also see a toolbox (closed) and a sledgehammer here.

>listen
You hear the subdued hum of capacitors and relays.

* * *

>l at tools
Just some of the many tools used to maintain the carnival.

>l at wires
Wires, spare parts, and hydraulic tubing is here.

>l at diagram
This is an electrical diagram for something.

* * *

>l at bulb
This single bulb is feebly trying to light the room.

>s
Mechanical Room South
The south mechanical room is the operational core of the carnival ride, a bustling, noisy space dominated by a massive motor. Its steady hum drives the thick belts, pulleys, and gears that work in perfect unison to power the ride.

Heavy-duty electrical panels line the walls, adorned with warning labels like "High Voltage" and blinking indicator lights in an array of colors. Overhead, labeled conduits and wires snake across the ceiling, connecting systems with meticulous precision.

A cluttered table holds tools and spare parts - bolts and lubricants - alongside open maintenance logs marked with greasy fingerprints. The air is thick with the smell of oil, metal, and a faint trace of ozone from the electrics.

A cooling fan spins in the corner, barely cutting through the room's warmth. The hum of machinery is occasionally punctuated by clinking chains and the sharp hiss of hydraulic fluid. The floor, a mix of metal grates and worn concrete, reflects years of use and maintenance.

Bright fluorescent lights in wire cages illuminate the space, highlighting the intricate systems at work. The south mechanical room is the ride's powerhouse, where every movement is controlled with precision to deliver its thrilling experience.

You can travel north and south from here.

Nearby a gray colored door leads west.

You can also see a grate (in which is an emerald colored fuse) here.

>l at motor
There is all manner of unidentifiable equipment here.

* * *

>l at panels
These are electrical panels controlling other parts of the carnival.

>l at wires
The labeled conduits and wires snake across the ceiling.

>l at conduits
The labeled conduits and wires snake across the ceiling.

* * *

>l at grate
This grate leads down into the darkness. Too bad it's locked.

In the grate is an emerald colored fuse.

>get fuse
(the emerald colored fuse)
Your fingers won't fit inside the grate. You can't reach the emerald colored fuse.
 If only you could grab the emerald colored fuse with something.

>put parking ticket in grate
(first taking the parking ticket)
(putting the 14" long piece of string into the fanny pack to make room)
You put the parking ticket into the grate.

>get parking ticket
Your fingers won't fit inside the grate. You can't reach the parking ticket.
 If only you could grab the parking ticket with something.

>tie string to mallet
You tie the 14" long piece of string to the mallet.

* * *

>get sledgehammer
(putting the brass ring into the fanny pack to make room)
Taken.

>i
You are carrying:
  a sledgehammer
  an adjustable wrench
  an emerald colored fuse
  a worn photo
  a lit flashlight (providing light)
  a sheer veil (being worn)
  a lit lantern (providing light)
  a cashier's check
  an envelope (open but empty)
  a Mystic Industries invoice
  an Oriental Trading invoice
  a Frank's Market invoice
  a Cash 'N' Carry invoice
  an insurance policy
  a gold key
  an indigo colored fuse
  a khaki colored fuse
  some chewed bubblegum
  a crimson colored fuse
  a horseshoe magnet
  a mallet
  a pair of gloves (being worn)
  a fanny pack (being worn, and open)
    a brass ring
      a brass key (which opens the sturdy door and the metal door)
    a Bumper Cars ticket
    a 14" long piece of string (tied to some chewed bubblegum)
    an air freshener
    three quarters
    a nickel
    two dimes
    a wallet
      $19.00 in cash

>put all invoices in fanny pack
Mystic Industries invoice: Done.
Oriental Trading invoice: Done.
Frank's Market invoice: Done.
Cash 'N' Carry invoice: Done.

>drop flashlight
Dropped.

* * *

>n
Crawl Space
Nearby a crimson colored door leads west.

>n
Maintenance Office
Nearby a ladder leads up to Dark Hallway.

Nearby an aqua colored door leads west.

You can also see a desk (on which are a coffee mug and a radio) here.

>n
Dark Passage

* * *

>w
Ride Entrance
You can see a Hell Ride car (empty) here.

>n
Head of the Line
You can see a Hell Ride Attendant here.

Mr Whidbey arrives from the Ticket Booth.

>n
Ticket Booth
You can see a janitor, a Cashier, and a ticket kiosk here.

>nw
Bumper Cars
You can see a Bumper Cars attendant here.

>give wrench to attendant
Hey! Thanks, I really appreciate it. Usually no one ever responds to the radio in the Control Room. Here, take this fuse.

Taken.

[Your score has just gone up by five points.]

[Your score has just gone up by ten points.]

>give ticket to attendant
(first taking the Bumper Cars ticket)
You give the Bumper Cars ticket to the Bumper Cars attendant.

Sliding into the snug seat of the bumper car, your hands grip the steering wheel, anticipation buzzing in the air. Around you, the arena is alive with flashing lights, bursts of laughter, and the hum of electric currents running through the overhead poles. A quick glance shows other riders locking eyes, playful grins spreading as everyone braces for the chaos about to unfold.

As the ride starts, your car jolts forward, and you steer into the fray. The slick metal floor beneath makes every turn feel smooth yet unpredictable. Suddenly, bam! - another car collides into you from the side, sending your car into a spin. You laugh, recovering quickly to aim your vehicle at a friend across the arena.

The thrill of the bumper cars is in the collisions - every thud and jolt accompanied by squeals of delight or mock indignation. The impact is cushioned by the padded bumpers, keeping the fun safe but exhilarating. You swerve, dodge, and sometimes reverse in a desperate attempt to avoid being cornered, all while plotting your next playful crash.

The ride is a whirlwind of laughter, harmless competition, and shared joy. As the music fades and the cars slow to a stop, you climb out with a wide grin, already looking forward to your next turn in the driver's seat.

>i
You are carrying:
  a gray colored fuse
  a sledgehammer
  an emerald colored fuse
  a worn photo
  a sheer veil (being worn)
  a lit lantern (providing light)
  a cashier's check
  an envelope (open but empty)
  an insurance policy
  a gold key
  an indigo colored fuse
  a khaki colored fuse
  some chewed bubblegum
  a crimson colored fuse
  a mallet
  a pair of gloves (being worn)
  a fanny pack (being worn, and open)
    a Cash 'N' Carry invoice
    a Frank's Market invoice
    an Oriental Trading invoice
    a Mystic Industries invoice
    a brass ring
      a brass key (which opens the sturdy door and the metal door)
    a 14" long piece of string (tied to some chewed bubblegum)
    an air freshener
    three quarters
    a nickel
    two dimes
    a wallet
      $19.00 in cash

>se
Ticket Booth
You can see a Cashier and a ticket kiosk here.

>e
High Striker
You can see a Strongman attendant, a lever, and some High Striker prizes here.

* * *

>hit bullseye with sledgehammer
As you swing, you feel the extra weight from the sledgehammer. As it comes down on the bullseye, you can't help but feel like the extra weight gives you an edge. The bell rings as the striker reaches the top of the pole. The attendant says, "You're a Muscle Man. Here's a prize for you."

Which prize would you like? 1) a teddy bear, 2) a Swiss Army knife, 3) a magenta colored fuse, 4) a poster of Taylor Swift?

>2
You are now holding a Swiss Army knife.

[Your score has just gone up by ten points.]

>w
Ticket Booth
You can see a janitor, a Cashier, and a ticket kiosk here.

>s
Head of the Line
You can see a Hell Ride Attendant here.

* * *

>s
Ride Entrance
You can see a Hell Ride car (empty) here.

>e
Dark Passage
You can see Mr Whidbey here.

>s
Maintenance Office
Nearby a ladder leads up to Dark Hallway.

Nearby an aqua colored door leads west.

You can also see a desk (on which are a coffee mug and a radio) here.

* * *

>s
Mechanical Room South
Nearby a gray colored door leads west.

You can also see a grate (in which is a parking ticket) here.

>s
Generator Room
 The generator room is a compact, utilitarian space where the lifeblood of the carnival's power is produced. Its reinforced concrete walls bear grime, oil streaks, and faint graffiti from past workers. The air carries a mix of diesel, hot metal, ozone, and damp earth, creating a distinctly industrial scent.

At the center, the main generator hums steadily, its scuffed steel casing evidence of years of service. Thick rubberized cables extend from it like veins, connecting to junction boxes and circuit breakers along the walls. A large panel nearby is cluttered with buttons, switches, and gauges, many with faded labels like "Fuel Intake" and "Emergency Shutoff." A flickering display screen shows power levels and load distribution.

The rough concrete floor is uneven, marked by small puddles of spilled fuel or condensation. Shelves along the walls hold spare parts - filters, spark plugs, and wire coils - while a work area sits beside a grease canister and a worn maintenance manual.

A single industrial bulb in a protective cage casts harsh light, leaving deep shadows across the machinery. In the corner, a vent fan whirs faintly, struggling to cool the warm, vibrating air. A row of diesel canisters gleams beneath a faded safety sign that warns, "Fuel Safely - No Open Flames!"

Though isolated and utilitarian, the generator room is the carnival's heartbeat, powering its lights, rides, and sounds. Its quiet separation from the carnival's chaos serves as a stark reminder of the machinery driving the magic.

The backstage area continues north and south of here.

Nearby an indigo colored door leads west.

>l at graffiti
The graffiti is varied, from "Peace, Love, Goodwill on Earth" to "Anarchy Rules".

* * *

>l at diesel canisters
The canisters are full of diesel fuel.

>s
Electrical Room
The electrical room is a small but essential space hidden behind the carnival's bright attractions. The air vibrates with electric energy, carrying the acrid scent of overheated wires and metal. Metal panels line the walls, some polished, others worn and streaked with grease.

A central breaker panel, labeled with destinations like "Ferris Wheel Lights" and "Carousel Motors," dominates one wall. Colored indicator lights blink intermittently, reflecting off steel surfaces. Overhead, thick cable bundles snake across the ceiling, connecting to the carnival's power network.

In a corner, an open junction box spills wires onto the wall, while a workbench holds scattered tools and a smudged wiring diagram pinned above. The dirt floor bears scratches, oil stains, and wire clippings. A faint vibration, carried from the generator or nearby rides, pulses through the room.

An emergency shutdown panel painted bright red stands near a fire extinguisher and a faded safety poster. A small fan on the workbench oscillates weakly, barely cooling the room's warmth. Flickering fluorescent tubes overhead cast harsh, shifting shadows.

The electrical room is raw and utilitarian, revealing the fragile systems behind the carnival's magic - a humbling reminder of the power sustaining the midway's enchantment.

This room is eerily quiet, missing the ever present buzz of electricity. There are exits in all directions.

>smell
The air vibrates with electric energy, carrying the acrid scent of overheated wires and metal.

* * *

>l at breaker
This breaker panel controls various portions of the carnival.

* * *

>l at tools
These are various tools you might use to repair electrical equipment.

>s
Storage Room
The carnival storage room is a cramped yet essential space, tucked away from the bustling grounds. Its rusted metal and peeling wooden walls bear the marks of years of use, while the air hangs heavy with grease, dust, damp canvas, and a faint trace of stale popcorn.

Shelves overflow with supplies - boxes of light bulbs, spools of wire, and assorted ride parts - piled without order. Tangled flags and strings of lights dangle from hooks, while crates labeled "GAME PRIZES" and "RIDE PARTS" hold items like stuffed animals and plastic toys. Folded tarps and tent poles teeter in one corner.

The room's center is dominated by larger objects: spare ride seats, unassembled booths, and faded attraction pieces like a scratched carousel horse, all hidden beneath protective tarps.

Near the entrance, a battered desk is cluttered with empty coffee cups. Above it, a bulletin board brims with ride schedules and repair requests. A flickering fluorescent bulb casts uneven shadows, adding an eerie atmosphere.

The floor, a rough blend of concrete and dirt, is littered with nuts and wire scraps. In the dim corners, the scuttle of rats and the glint of cobwebs underline the room's gritty nature.

Chaotic yet indispensable, this hidden space powers the carnival's magic, ensuring every ride and booth runs seamlessly.

There is an exit to the north.

Nearby a khaki colored door leads west.

>l at walls
The rusted metal and peeling wooden walls bear the marks of years of use.

* * *

>n
Electrical Room

>ne
Electrical Closet One
This is Electrical Closet One. There's an electrical panel here and an exit to the southwest.

You can see a silver key here.

>get key
(the silver key)
Taken.

>l at electrical panel
Electrical Panel 1 is a standard issue 200 amp electrical panel supplying 220 power throughout the ride. The electrical panel is closed. There are screws holding it shut.

* * *

>s
Storage Room
Nearby a khaki colored door leads west.

>w
(first opening the khaki colored door)
(first unlocking the khaki colored door)
(with the silver key)

Ride Exit
The exit of Hell Ride is designed to leave riders with lingering unease. Emerging from a dark corridor with peeling black and red-streaked walls, flickering lights cast erratic shadows on the uneven floor. The air is cool and damp, carrying a faint metallic tang, while faint whispers and distant screams echo softly in the background.

Riders step into a small courtyard enclosed by jagged, rusted fencing draped with cobwebs and plastic skulls. Overhead, a weathered sign reads, "You've Survived… For Now." Nearby, carnival workers in tattered costumes watch silently, occasionally muttering cryptic remarks like, "Not everyone makes it out."

A merchandise display glows red, selling items like Hell Ride Survivor t-shirts and key chains. Beyond the fencing, the cheerful carnival lights and sounds feel jarring, contrasting sharply with the ride's oppressive atmosphere.

The exit ensures Hell Ride isn't just an experience - it lingers, blurring the line between thrill and fear.

There is a price list next to the cash register. An attendant is here to assist you with your purchases. The stand has aqua colored fuse, Plastic Bones, Devil Horns, Key Chains, and T-Shirts for sale.

Nearby a khaki colored door leads east to the Storage Room.

You can also see a Merchandise Attendant here.

>read sign
$2.00 Key Chains
$3.50 Aqua Colored Fuse
$2.00 Devil Horns
$1.00 Plastic Bones
$7.50 T-Shirts

* * *

>clip fingernails
Your fingernails look much neater now that you've trimmed them.

>n
As you enter the room, you can see Mr Whidbey across the way. He seems to be doing something around the guillotine platform. You walk closer to see what he is doing and startle him. Mr Whidbey spins around and stares at you. As he turns and walks out of the guillotine room, you think you saw him drop something.

Guillotine Room
The public square buzzes with tense anticipation, a crowd gathered under gray skies that cast a somber light on the cobblestones. At the center, a stark wooden platform looms, its purpose grim and unavoidable.

A lone figure stands on the scaffold, bound hands behind their back and head bowed low, avoiding the crowd's gaze. Their tattered clothing, once fine, reflects the fall that led them to this moment.

The crowd encircles the platform, emotions ranging from jeers and curses to silent, grim observation. Children sit on shoulders, their curious eyes unaware of the event's gravity. Near the edge of the platform, the town crier proclaims the crime: "High treason against the crown. Let this be a warning to all who defy the realm!"

The condemned flinches but remains silent as the executioner - a hooded figure in black - stands ready beside the guillotine, its blade gleaming faintly in the dim light. The murmurs of the crowd fall into silence at the executioner's signal, leaving only the rustle of wind and the creak of the scaffold.

As the condemned approaches the guillotine, a crow caws sharply from a nearby rooftop, its cry echoing through the square like an omen. The crowd leans forward, breath held, as justice and mortality converge on the scene.

There is just one problem: the guillotine is being raised and lowered by some mechanism. It appears that the timing of the guillotine is off and it is being lowered onto the cars instead of between them. If a person were to be in a car as it passed under the guillotine, they would be seriously injured.  You're glad you're not in one of those cars now. 

Nearby an indigo colored door leads east to the Generator Room.

You can also see a guillotine platform here.

>l at crowd
The crowd encircles the platform, emotions ranging from jeers and curses to silent, grim observation. Children sit on shoulders, their curious eyes unaware of the event's gravity.

* * *

>l at cars
The cars keep coming and move under the malfunctioning guillotine. You shudder at just the thought of it

>n
Dungeon
The dungeon is a dark, suffocating chamber carved into the earth, its stone walls slick with moisture and grime. The air reeks of sweat, blood, mildew, and burning oil from flickering torches mounted on rusted sconces. Shadows twist on the walls, creating grotesque, unsettling shapes in the dim light.

Chains hang from walls and ceilings, their faint clinking blending with the moans and occasional screams of prisoners. Water drips rhythmically from a cracked ceiling, adding to the chamber's eerie ambiance.

The room is littered with instruments of torment: a splintered rack, a glowing brazier holding bloodstained tools, and a spiked chair gleaming faintly in the light. Prisoners endure their own horrors - one stretched on the rack, another hanging limply from manacles, and a third gasping weakly in the spiked chair.

The hooded torturer moves with detached precision, their leather apron stained with the evidence of countless victims. They work silently, indifferent to the agony surrounding them.

Above, rats scuttle in the shadows, and the low ceiling presses down like the weight of despair. This is a realm of suffering and hopelessness, where life and death blur, and torment is the only certainty.

Nearby a gray colored door leads east to the Mechanical Room South.

You can also see an iron chair, a splintered rack, and a glowing brazier here.

Mr Whidbey arrives from the Stake Room.

>l at walls
The its stone walls slick with moisture and grime.

* * *

>l at chains
The chains rattle against the walls.

>l at rack
The rack has a prisoner splayed in four directions.

Mr Whidbey heads to the Guillotine Room.

>l at brazier
It is glowing red with an infernal heat raising the temperature of the bloodstained tools.

* * *

>l at rats
You see rats scurry in all directions fleeing from the light cast by you.

>n
Stake Room
The public square is steeped in grim silence, broken only by the crackling of flames. At its center, three wooden stakes rise from a pyre of logs and kindling, darkened by smoke from past executions. Bound to the stakes are three women, their faces reflecting defiance, resignation, and terror.

A crowd encircles the scene, expressions ranging from morbid fascination to righteous fury. Children cling to their mothers, while elders nod solemnly. Some jeer and throw stones; others murmur prayers or avert their gaze.

The executioner, hooded and clad in a leather apron, steps forward with a blazing torch, igniting the pyre in a sudden roar. Flames climb rapidly as thick smoke coils upward. The condemned cry out, their voices mingling with the crackle of fire. The oppressive heat radiates outward, pressing against the silent, uneasy crowd.

Gray clouds loom overhead, nature's somber backdrop to the grim spectacle. A raven caws from the bell tower as slow church bells toll, each strike punctuating the tragedy. As the pyre burns, some onlookers remain transfixed while others quietly slip away, the square heavy with ash, smoke, and the echoes of the condemned.

Nearby an emerald colored door leads east to the Mechanical Room North.

The flames of the pyre burn ever brighter and rise ever higher engulfing the victims.

>l at square
The public square is steeped in grim silence, broken only by the crackling of flames.

* * *

>l at flames
The flames burn ever higher.

In the pyre is a quartz colored fuse.

>get quartz fuse
Taken.

>l at pyre
The flames burn ever higher.

* * *

>l at torch
The executioner carries the torch to light the pyre.

>n
Gallows Room
The public square, slick with morning drizzle, lies under a brooding, overcast sky. At its center looms the gallows, a weathered wooden platform with thick ropes swaying ominously. The crowd stands in somber silence, broken by the shuffle of feet or faint murmurs, their eyes fixed on the grim scene.

A hooded executioner, cloaked in black, adjusts the frayed noose with practiced precision, his cold presence exuding purpose. In front of him stands the condemned man, pale and trembling, his bound hands behind him. Beads of sweat mix with rain on his haunted face as his darting eyes search the indifferent crowd. Each shallow breath forms a fleeting cloud in the chilly air - a fragile reminder of his fleeting life.

Vendors hawk bread and cider, while children strain for a better view. An old man clutches a rosary, whispering prayers, as others smirk and place bets. Above, the bell tower tolls, its mournful chime marking the passage of the man's final moments. A raven perches on the gallows beam, its unblinking gaze fixed on the scene below.

As the executioner adjusts the noose around the man's neck, the crowd falls silent, the air thick with dread. Distant thunder rumbles faintly, as if the heavens themselves await the inevitable.

Nearby a crimson colored door leads east to the Crawl Space.

You can also see a gallows platform here.

>score
You've received 170 points out of a possible 200 in 511 moves!

You have received points for the following: 

•  Eating the blueberries: 5 points.
•  Finding the coins and keys: 5 points.
•  Buying the Hell Ride ticket: 5 points.
•  Taking the Mercury dime: 5 points.
•  Winning the horseshoe magnet: 5 points.
•  Winning the Crimson fuse: 5 points.
•  Acquiring the Khaki fuse: 10 points.
•  Finding the insurance policy: 5 points.
•  Acquiring the Indigo fuse: 10 points.
•  Finding the Cash 'N' Carry invoice: 5 points.
•  Finding the Oriental Trading invoice: 5 points.
•  Finding the Frank's Market invoice: 5 points.
•  Finding the Mystic Industries invoice: 5 points.
•  Acquiring the cashier's check: 10 points.
•  Taking the lantern: 5 points.
•  Wearing the sheer veil: 5 points.
•  Finding the Dark Passage: 5 points.
•  Taking the flashlight: 5 points.
•  Finding the Control Room: 5 points.
•  Turning off the big switch: 10 points.
•  Acquiring the Emerald fuse: 10 points.
•  Bringing the wrench to the Bumper Cars: 5 points.
•  Acquiring the Gray fuse: 10 points.
•  Winning the Swiss Army knife: 10 points.
•  Acquiring the Aqua fuse: 10 points.
•  Acquiring the pliers: 5 points.

>i
You are carrying:
  a quartz colored fuse
  some pliers
  an aqua colored fuse
  a silver key
  a Swiss Army knife
  a gray colored fuse
  a sledgehammer
  an emerald colored fuse
  a worn photo
  a sheer veil (being worn)
  a lit lantern (providing light)
  a cashier's check
  an envelope (open but empty)
  an insurance policy
  a gold key
  an indigo colored fuse
  a khaki colored fuse
  some chewed bubblegum
  a crimson colored fuse
  a mallet
  a pair of gloves (being worn)
  a fanny pack (being worn, and open)
    a Cash 'N' Carry invoice
    a Frank's Market invoice
    an Oriental Trading invoice
    a Mystic Industries invoice
    a brass ring
      a brass key (which opens the sturdy door and the metal door)
    a 14" long piece of string (tied to some chewed bubblegum)
    an air freshener
    three quarters
    a nickel
    two dimes
    a wallet
      $15.50 in cash

>l
Gallows Room
The public square, slick with morning drizzle, lies under a brooding, overcast sky. At its center looms the gallows, a weathered wooden platform with thick ropes swaying ominously. The crowd stands in somber silence, broken by the shuffle of feet or faint murmurs, their eyes fixed on the grim scene.

A hooded executioner, cloaked in black, adjusts the frayed noose with practiced precision, his cold presence exuding purpose. In front of him stands the condemned man, pale and trembling, his bound hands behind him. Beads of sweat mix with rain on his haunted face as his darting eyes search the indifferent crowd. Each shallow breath forms a fleeting cloud in the chilly air - a fragile reminder of his fleeting life.

Vendors hawk bread and cider, while children strain for a better view. An old man clutches a rosary, whispering prayers, as others smirk and place bets. Above, the bell tower tolls, its mournful chime marking the passage of the man's final moments. A raven perches on the gallows beam, its unblinking gaze fixed on the scene below.

As the executioner adjusts the noose around the man's neck, the crowd falls silent, the air thick with dread. Distant thunder rumbles faintly, as if the heavens themselves await the inevitable.

Nearby a crimson colored door leads east to the Crawl Space.

You can also see a gallows platform here.

>listen
Above, the bell tower tolls, its mournful chime marking the passage of the man's final moments.

>smell
You smell incense as it permeates through Hell Ride.

* * *

>l at noose
The noose has been tied and hangs from the gallows proper.

>n
Stocks Room
The public square is a cobblestone expanse bordered by weathered timber-framed buildings. The air carries the mingling scents of chimney smoke, damp earth, and the faint tang of a nearby smithy. At its center, crude wooden stocks stand as a grim focal point, their beams weathered and stained from years of use. Iron clasps lock captives in degrading postures, their tattered clothing offering little protection from the biting wind.

The animatronics and wax figures are extremely life like. Hell Ride sure lives up to its name.

The punished individuals hang their heads in shame, their faces etched with despair. Around them, the crowd revels in cruelty - a wiry man spits insults with gleeful laughter, while a stout woman throws overripe vegetables, each impact sparking jeers. Even children join in, pointing and mocking with mischievous delight.

The square hums with noise: the crowd's taunts, the crack of objects hitting wood, and the quiet murmurs of the suffering captives. Overhead, a gray sky threatens rain, indifferent to the spectacle below. The jeering mob ignores its ominous weight, too engrossed in their shared cruelty to notice nature's disapproval.

Nearby an aqua colored door leads east to the Maintenance Office.

You can also see a wooden stocks here.

>l at square
The public square is a cobblestone expanse bordered by weathered timber-framed buildings.

Mr Whidbey arrives from the Maintenance Office.

>smell
The air carries the mingling scents of chimney smoke, damp earth, and the faint tang of a nearby smithy.

* * *

>l at beams
At the square's center stand a row of crude wooden stocks, their heavy beams stained from years of weather and use. Iron clasps hold the unfortunate captives by their wrists and necks, their bodies forced into unnatural, humiliating postures.

>l at clasps
Iron clasps lock the prisoners in place.

Mr Whidbey heads to the Gallows Room.

>l at animatronics
The animatronics and wax figures are extremely life like. Hell Ride sure lives up to its name.

* * *

>l at vegetables
The rotten fruit and vegetables splatter as each hits its mark, coating the prisoners with rank vegetation.

>e
(first opening the aqua colored door)
(first unlocking the aqua colored door)
(with the silver key)

Maintenance Office
Nearby an aqua colored door leads west to the Stocks Room.

Nearby a ladder leads up to Dark Hallway.

You can also see a desk (on which are a coffee mug and a radio) here.

>i
You are carrying:
  a quartz colored fuse
  some pliers
  an aqua colored fuse
  a silver key
  a Swiss Army knife
  a gray colored fuse
  a sledgehammer
  an emerald colored fuse
  a worn photo
  a sheer veil (being worn)
  a lit lantern (providing light)
  a cashier's check
  an envelope (open but empty)
  an insurance policy
  a gold key
  an indigo colored fuse
  a khaki colored fuse
  some chewed bubblegum
  a crimson colored fuse
  a mallet
  a pair of gloves (being worn)
  a fanny pack (being worn, and open)
    a Cash 'N' Carry invoice
    a Frank's Market invoice
    an Oriental Trading invoice
    a Mystic Industries invoice
    a brass ring
      a brass key (which opens the sturdy door and the metal door)
    a 14" long piece of string (tied to some chewed bubblegum)
    an air freshener
    three quarters
    a nickel
    two dimes
    a wallet
      $15.50 in cash

>s
Crawl Space
Nearby a crimson colored door leads west to the Gallows Room.

* * *

>open panel
(first unlocking Electrical Panel 1)
(with the Swiss Army knife)
Using the screwdriver on the Swiss Army knife, you remove the screws holding the electrical panel shut.

You open Electrical Panel 1.

>l at panel
Electrical Panel 1 is a standard issue 200 amp electrical panel supplying 220 power throughout the ride. The electrical panel is open. Inside the panel you see a switch, a socket, and an indicator light. The screws for the door are gone.

* * *

>open panel
(first unlocking Electrical Panel 3)
(with the Swiss Army knife)
Using the screwdriver on the Swiss Army knife, you remove the screws holding the electrical panel shut.

You open Electrical Panel 3.

>put crimson in socket
(the crimson colored fuse in socket 3)
You hear a satisfying snick as the crimson fuse slides into place.

* * *

>open panel
(first unlocking Electrical Panel 7)
(with the Swiss Army knife)
Using the screwdriver on the Swiss Army knife, you remove the screws holding the electrical panel shut.

You open Electrical Panel 7.

>put gray in socket
(the gray colored fuse in socket 7)
You hear a satisfying snick as the gray fuse slides into place.

* * *

>open panel
(first unlocking Electrical Panel 9)
(with the Swiss Army knife)
Using the screwdriver on the Swiss Army knife, you remove the screws holding the electrical panel shut.

You open Electrical Panel 9.

>put indigo in socket
(the indigo colored fuse in socket 9)
You hear a satisfying snick as the indigo fuse slides into place.

* * *

>open panel
(first unlocking Electrical Panel 11)
(with the Swiss Army knife)
Using the screwdriver on the Swiss Army knife, you remove the screws holding the electrical panel shut.

You open Electrical Panel 11.

>put khaki in socket
(the khaki colored fuse in socket 11)
You hear a satisfying snick as the khaki fuse slides into place.

* * *

>n
Maintenance Office
Nearby an aqua colored door leads west to the Stocks Room.

Nearby a ladder leads up to Dark Hallway.

You can also see a desk (on which are a coffee mug and a radio) here.

>n
Dark Passage
You can see Mr Whidbey here.

Mr Whidbey heads to the Maintenance Office.

>s
Maintenance Office
Nearby an aqua colored door leads west to the Stocks Room.

Nearby a ladder leads up to Dark Hallway.

You can also see Mr Whidbey and a desk (on which are a coffee mug and a radio) here.

>ask whidbey about hell ride
Mr Whidbey waits for you to speak.

"Hell Ride is the premier attraction here at  Whidbey Amusements. It's both spooky and fun! The visitors love it! The fire last month was unfortunate and expensive" says Mr Whidbey.

Mr. Whidbey's eyes dart up and to the left.

>ask whidbey about invoices
Mr Whidbey looks at you expectantly.

Mr Whidbey says, "I know this doesn't look good but the cost of consumables go up every week and attendance is down. I have to pinch pennies somehow, don't I? And that fire was very expensive to repair."

>ask whidbey about insurance policy
Mr Whidbey nervously shifts his weight from one foot to the other.

"An insurance policy? Of course, all reputable businesses have insurance. Even small time carnivals" Mr Whidbey stammers.

>ask whidbey about carnival
Mr Whidbey looks at you expectantly.

"The Whidbey family has owned this carnival since the 1957", Mr Whidbey says. "Unfortunately, I am an only child and never married. Alas, the carnival will close when I am gone. But for now, it's making a comeback!"

>ask whidbey about ferris wheel
Mr Whidbey nervously shifts his weight from one foot to the other.

Mr Whidbey says "The Ferris Wheel is my favorite ride. It's always relaxing and romantic."

Mr. Whidbey quickly changes the subject

>ask whidbey about bumper cars
Mr Whidbey waits for you to speak.

"That incident the other week with that Needleman kids was unfortunate" says Mr Whidbey.

* * *

>ask whidbey about esmeralda
Mr Whidbey looks at you expectantly.

Mr Whidbey says "I see her regularly to have my fortune told. We're lucky to have her here. She's very beautiful. It's a wonder she's never been married."

>ask whidbey about carousel
Mr Whidbey nervously shifts his weight from one foot to the other.

"The carousel is just one of the many rides that thrill and delight our visitors every day," says Mr Whidbey

>ask whidbey about dime toss
Mr Whidbey looks at you expectantly.

"The Dime Toss is is one of the many games that thrill and delight our visitors every day!" says Mr Whidbey.

Mr. Whidbey meets your eyes and quickly looks away.

>ask whidbey about pitchers mound
Mr Whidbey waits for you to speak.

"The Pitchers Mound is is one of the many games that thrill and delight our visitors every day!" says Mr Whidbey.

>ask whidbey about high striker
Mr Whidbey looks at you expectantly.

"The High Striker is is one of the many games that thrill and delight our visitors every day!" says Mr Whidbey.

>ask whidbey about fuses
Mr Whidbey nervously shifts his weight from one foot to the other.

"I know nothing about fuses", Mr Whidbey says.

>ask whidbey about indigo fuse
Mr Whidbey waits for you to speak.

"Where did you get that?" Mr Whidbey asks.

Mr. Whidbey's eyes dart up and to the left.

* * *

>ask whidbey about fire
Mr Whidbey nervously shifts his weight from one foot to the other.

The fire was most unfortunate. It put Hell Ride out of commission for two weeks. Not only did it cost me $22,500 to repair but I lost revenue while it was closed.

>ask whidbey about accidents
Mr Whidbey waits for you to speak.

Mr Whidbey says, "Oh, that's nothing to worry about. Little things happen all the time, right?"

>ask whidbey about pliers
Mr Whidbey nervously shifts his weight from one foot to the other.

"Oh! I thought I lost... um, those belong to the janitor. Where did you find them?" asks Mr Whidbey.

>ask whidbey about needleman
Mr Whidbey looks at you expectantly.

Mr Whidbey says "Uh, Fred is a special... contractor... We paid him. For services rendered."

Mr. Whidbey quickly changes the subject

>ask whidbey about services rendered
Mr Whidbey waits for you to speak.

"Fred did some work over at the bumper cars" says Mr Whidbey.

>accuse whidbey of fraud
Mr Whidbey looks at you expectantly.

"You have nothing on me", says Mr Whidbey.

>show cash 'n' carry
(to Mr Whidbey)
(first taking the Cash 'N' Carry invoice)
Mr Whidbey says, "Money's a little tight. The cost of consumables go up every week."

>show Frank's market
(to Mr Whidbey)
(first taking the Frank's Market invoice)
Mr Whidbey says, "I can't keep up with the cost of ingredients. Everything costs so much!"

>show oriental trading
(to Mr Whidbey)
(first taking the Oriental Trading invoice)
Mr Whidbey says, "There must be prizes for the games otherwise visitors wouldn't play them. Maybe people won't win so often."

Mr. Whidbey's eyes dart up and to the left.

>show mystic industries
(to Mr Whidbey)
(first taking the Mystic Industries invoice)
Mr Whidbey says, That fire in Hell Ride was very expensive to repair. And it put the ride out of commission for two weeks."

>accuse whidbey of fraud
Mr Whidbey nervously shifts his weight from one foot to the other.

"You have nothing on me", says Mr Whidbey.

>accuse whidbey of bribery
Mr Whidbey looks at you expectantly.

The bumper cars injured that Needleman kid with an electrical shock. He was going to report the carnival to the authorities. So, I had to pay him off to keep him quiet.

>accuse whidbey of extortion
Mr Whidbey waits for you to speak.

Not satisfied with the first payment, Needleman wanted more money. His latest demand is $15,000.

>accuse whidbey of insurance policy
Mr Whidbey nervously shifts his weight from one foot to the other.

I needed the money to cover for Needleman somehow.

>show insurance policy to whidbey
"An insurance policy? Of course, all reputable business have insurance. Even small time carnivals", Mr Whidbey stammers.

>show paperwork to whidbey
You can't see any such thing.

>show pliers to whidbey
"Oh! I thought I lost... I mean those belong to the janitor. Where did you find them?" asks Mr Whidbey.

Mr Whidbey heads to the Carnival Office.

>show cashier's check to whidbey
You can't see any such thing.

>show aqua fuse to whidbey
You can only do that to something animate.

>s
Crawl Space
Nearby a crimson colored door leads west to the Gallows Room.

>gonear whidbey
Carnival Office
Dim, yellow light from an overhead bulb casts long shadows over the room, A single desk lamp, flickering provides additional light. A few carnival-themed knick-knacks sit atop the desk. A framed photograph hangs askew on the wall.

The desk is covered in stacks of paperwork, old receipts, invoices, and faded carnival brochures. A locked cabinet is tucked away against one wall. Next to it, there's a small, heavy safe.

Nearby a sturdy door leads north to the Concession Stand.

On the messy desk is a mini carousel.

You can also see Mr Whidbey, a safe (empty), a filing cabinet (empty), and a framed photograph here.

>show cashier's check to whidbey
Mr Whidbey says "Uh, Fred is a special... contractor... We paid him. For services rendered."

Mr. Whidbey quickly changes the subject

>n
Concession Stand
Nearby a sturdy door leads south to the Carnival Office.

You can also see a mini Ferris wheel, a Concession Attendant, a menu, a Drink of Cola, a Bucket of Popcorn, a Candy Apple, Cotton Candy, and a Soft Pretzel here.

>ne
Ticket Booth
You can see a janitor, a Cashier, and a ticket kiosk here.

>s
Head of the Line
You can see a Hell Ride Attendant here.

* * *

>e
Dark Passage

>s
Maintenance Office
Nearby an aqua colored door leads west to the Stocks Room.

Nearby a ladder leads up to Dark Hallway.

You can also see a desk (on which are a coffee mug and a radio) here.

>u
Dark Hallway
Nearby a ladder leads down to the Maintenance Office.

Nearby a metal door leads west to Control Room.

* * *

>set khaki dial to 11
The khaki colored dial is now set to 11.

>put aqua button
What do you want to put the aqua button under?

>push aqua button
You switch the aqua button on.

The monitor flickers for a second and the scene it displays changes to something different.
The monitor now shows a tableau of poor unfortunate townsfolk locked in stocks.
The aqua light is now on.

>push crimson button
You switch the crimson button on.

The monitor flickers for a second and the scene it displays changes to something different.
The monitor now shows a scene of someone waiting to be hanged.
The crimson light is now on.

* * *

>push khaki button
You switch the khaki button on.

The monitor flickers for a second and the scene it displays changes to something different.
The monitor shows the gift shop located at the Hell Ride exit.
The khaki light is now on.

>push indigo button
You switch the indigo button on.

The monitor flickers for a second and the scene it displays changes to something different.
The monitor now shows a tableau of a guillotine rising and falling over the ride exit.
The indigo light is now on.

As you push the indigo button, the monitor switches to a view of the guillotine room. You can still see the blade rising and falling over the cars. Suddenly, you see the blade slowing down, taking longer and longer to fall. Until it finally comes to a complete rest.

The room is heavy with uneasy silence. Hell Ride, once a thrilling spectacle, now looms motionless, as the guillotine blade is frozen halfway down its track. Moments ago, chaos erupted as the malfunctioning mechanism sent the blade crashing unpredictably, ripping through the roofs of cars on the track.

A single car, its roof gashed open, sits under the still blade - a grim reminder of the disaster narrowly averted. Above, a black crow lands on the guillotine's frame, its sharp caw cutting through the murmurs of anger and fear.

Two mechanics climb the scaffolding with tools in hand, their appearance met with wary hope. A crowd has gathered and is watching, holding their breath, as the cursed ride's fate hangs in the balance.

As you exit the ride, the carnival owner and the mayor are present and extending their undying gratitude for saving the day, not to mention lives!

*** You have won! ***

You've received 200 points out of a possible 200 in 634 moves!

You have received points for the following: 

•  Eating the blueberries: 5 points.
•  Finding the coins and keys: 5 points.
•  Buying the Hell Ride ticket: 5 points.
•  Taking the Mercury dime: 5 points.
•  Winning the horseshoe magnet: 5 points.
•  Winning the Crimson fuse: 5 points.
•  Acquiring the Khaki fuse: 10 points.
•  Finding the insurance policy: 5 points.
•  Acquiring the Indigo fuse: 10 points.
•  Finding the Cash 'N' Carry invoice: 5 points.
•  Finding the Oriental Trading invoice: 5 points.
•  Finding the Frank's Market invoice: 5 points.
•  Finding the Mystic Industries invoice: 5 points.
•  Acquiring the cashier's check: 10 points.
•  Taking the lantern: 5 points.
•  Wearing the sheer veil: 5 points.
•  Finding the Dark Passage: 5 points.
•  Taking the flashlight: 5 points.
•  Finding the Control Room: 5 points.
•  Turning off the big switch: 10 points.
•  Acquiring the Emerald fuse: 10 points.
•  Bringing the wrench to the Bumper Cars: 5 points.
•  Acquiring the Gray fuse: 10 points.
•  Winning the Swiss Army knife: 10 points.
•  Acquiring the Aqua fuse: 10 points.
•  Acquiring the pliers: 5 points.
•  Flipping the Aqua switch: 5 points.
•  Flipping the Crimson switch: 5 points.
•  Flipping the Emerald switch: 5 points.
•  Flipping the Gray switch: 5 points.
•  Flipping the Indigo switch: 5 points.
•  Flipping the Khaki switch: 5 points.

Would you like to RESTART, RESTORE a saved game, QUIT, or UNDO the last command?