The carnival is in town and you had a date with your sweetie to visit it. After dinner and just as you arrive at the carnival, you and your date have a terrible fight. They storm off leaving you alone at the carnival. You decide to stay at the carnival anyway.

Hell Ride
The ride of a lifetime... by No Shoes
Release 1 / Serial number 241202 / Inform 7 v10.1.2 / D

Parking Lot
You are in a parking lot full of cars. The midway is to the south. There is a blueberry bush here. There are blueberries on the bush

You can see a dime here.

>get all
dime: Taken.
blueberries: Good Job!

[Your score has just gone up by five points.]

>e
You can't go that way.

>s
The Ticket Booth
You are standing in line at a ticket booth at the carnival. The booth sells tickets to the Hell Ride attraction. The line for the ride forms to the south and the midway continues east and west from here. There is a concession stand to the south west. The ticket booth is garishly painted in purple and green sparkles. There is a Ticket Seller here. The Ticket Seller has a Hell Ride ticket.

You can see a Ticket Seller here.

>e
Strongman Booth
The Strongman Booth is a popular carnival game in which you swing a mallet against a base and cause a striker to hit a bell. Along the length of the pole are markings indicating how strong you are.  A nearby sign says, "Buy a mallet, strike the bell, win a prize."

You can see a Strongman Attendant and a base here.

>nbuy mallet
That's not a verb I recognize.

>buy mallet
You fork over $2.00 for the mallet, leaving yourself with $8.00.

>hit base with mallet
You lift the mallet high and bring it down on the base with all your might! The striker rises towards the bell stopping at "Getting Stronger".  C'mon! You can do better than that!

>g
You lift the mallet high and bring it down on the base with all your might! The striker rises towards the bell stopping at "Average".  C'mon! You can do better than that!

>g
You lift the mallet high and bring it down on the base with all your might! The striker rises towards the bell stopping at "Getting Stronger".  C'mon! You can do better than that!

>g
You lift the mallet high and bring it down on the base with all your might! The striker rises towards the bell stopping at "Getting Stronger".  C'mon! You can do better than that!

>g
You lift the mallet high and bring it down on the base with all your might! The striker rises towards the bell stopping at "Average".  C'mon! You can do better than that!

You swing the mallet one more time. The bell rings as the striker reaches the top of the pole. The attendant says, "You're a Muscle Man. Here's a prize for you."
You now carry the stuffed teddy bear.

[Your score has just gone up by five points.]

>w
The Ticket Booth
You are standing in line at a ticket booth at the carnival. The booth sells tickets to the Hell Ride attraction. The line for the ride forms to the south and the midway continues east and west from here. There is a concession stand to the south west. The ticket booth is garishly painted in purple and green sparkles. There is a Ticket Seller here. The Ticket Seller has a Hell Ride ticket.

You can see a Ticket Seller here.

>i
You are carrying:
  a stuffed teddy bear
  a mallet
  blueberries
  a dime
  a wallet
    $8.00 in cash

>w
Little Egypt Facade
You are standing in front of a trailer. There is a stage in front of the trailer. The Barker is encouraging you to step up, pay for, and enjoy the Little Egypt Show.The barker cries: 

Ladies and gentlemen, boys and girls, gather "round! 
Step right up and witness the spectacle that's taken the world by storm! 
She walks, she talks, she crawls on her belly like a reptile. 
Behold the one, the only Little Egypt, performing her legendary Dance of the Pyramids-a dazzling display of mystery, grace, and exotic allure! 
For just a dime, a mere one tenth of a dollar, prepare to be transported to the sands of Cairo, where enchantment and wonder await!

You can see a Barker here.

* * *

>get all
dime: Taken.
blueberries: Good Job!

[Your score has just gone up by five points.]

>s
The Ticket Booth
You are standing in line at a ticket booth at the carnival. The booth sells tickets to the Hell Ride attraction. The line for the ride forms to the south and the midway continues east and west from here. There is a concession stand to the south west. The ticket booth is garishly painted in purple and green sparkles. There is a Ticket Seller here. The Ticket Seller has a Hell Ride ticket.

You can see a Ticket Seller here.

* * *

>e
Strongman Booth
The Strongman Booth is a popular carnival game in which you swing a mallet against a base and cause a striker to hit a bell. Along the length of the pole are markings indicating how strong you are.  A nearby sign says, "Buy a mallet, strike the bell, win a prize."

You can see a Strongman Attendant and a base here.

>get all
stuffed teddy bear: That seems to belong to the Strongman Attendant.
mallet: You'll have to pay for that.

>buy mallet
You fork over $2.00 for the mallet, leaving yourself with $8.00.

>hit dime
Violence isn't the answer to this one.

* * *

>hit dime with mallet
Nothing happens.

>hit base with dime
You can't hit base with that!

>drop mallet
Dropped.

>hit dime with mallet
Nothing happens.

>hit base with mallet
You're not holding the mallet.

>get mallet
Taken.

>hit base with mallet
You lift the mallet high and bring it down on the base with all your might! The striker rises towards the bell stopping at "Weakling".  C'mon! You can do better than that!

>hit base with mallet
You lift the mallet high and bring it down on the base with all your might! The striker rises towards the bell stopping at "Getting Stronger".  C'mon! You can do better than that!

>hit base with mallet
You lift the mallet high and bring it down on the base with all your might! The striker rises towards the bell stopping at "Average".  C'mon! You can do better than that!

>hit base with mallet
You lift the mallet high and bring it down on the base with all your might! The striker rises towards the bell stopping at "Average".  C'mon! You can do better than that!

You swing the mallet one more time. The bell rings as the striker reaches the top of the pole. The attendant says, "You're a Muscle Man. Here's a prize for you."
You now carry the stuffed teddy bear.

[Your score has just gone up by five points.]

>l
Strongman Booth
The Strongman Booth is a popular carnival game in which you swing a mallet against a base and cause a striker to hit a bell. Along the length of the pole are markings indicating how strong you are.  A nearby sign says, "Buy a mallet, strike the bell, win a prize."

You can see a Strongman Attendant and a base here.

>e
You can't go that way.

>w
The Ticket Booth
You are standing in line at a ticket booth at the carnival. The booth sells tickets to the Hell Ride attraction. The line for the ride forms to the south and the midway continues east and west from here. There is a concession stand to the south west. The ticket booth is garishly painted in purple and green sparkles. There is a Ticket Seller here. The Ticket Seller has a Hell Ride ticket.

You can see a Ticket Seller here.

>w
Little Egypt Facade
You are standing in front of a trailer. There is a stage in front of the trailer. The Barker is encouraging you to step up, pay for, and enjoy the Little Egypt Show.The barker cries: 

Ladies and gentlemen, boys and girls, gather "round! 
Step right up and witness the spectacle that's taken the world by storm! 
She walks, she talks, she crawls on her belly like a reptile. 
Behold the one, the only Little Egypt, performing her legendary Dance of the Pyramids-a dazzling display of mystery, grace, and exotic allure! 
For just a dime, a mere one tenth of a dollar, prepare to be transported to the sands of Cairo, where enchantment and wonder await!

You can see a Barker here.

* * *

The carnival is in town and you had a date with your sweetie to visit it. After dinner and just as you arrive at the carnival, you and your date have a terrible fight. They storm off leaving you alone at the carnival. You decide to stay at the carnival anyway.

Hell Ride
The ride of a lifetime... by No Shoes
Release 1 / Serial number 241202 / Inform 7 v10.1.2 / D

Parking Lot
You are in a parking lot full of cars. The midway is to the south. There is a blueberry bush here. There are blueberries on the bush

You can see a dime here.

>s
The Ticket Booth
You are standing in line at a ticket booth at the carnival. The booth sells tickets to the Hell Ride attraction. The line for the ride forms to the south and the midway continues east and west from here. There is a concession stand to the south west. The ticket booth is garishly painted in purple and green sparkles. There is a Ticket Seller here. The Ticket Seller has a Hell Ride ticket.

You can see a Ticket Seller here.

* * *

>e
Strongman Booth
The Strongman Booth is a popular carnival game in which you swing a mallet against a base and cause a striker to hit a bell. Along the length of the pole are markings indicating how strong you are.  A nearby sign says, "Buy a mallet, strike the bell, win a prize."

You can see a Strongman Attendant and a base here.

>hit money
Violence isn't the answer to this one.

>hit money with dime
You can't see any such thing.

>n
You can't go that way.

>w
The Ticket Booth
You are standing in line at a ticket booth at the carnival. The booth sells tickets to the Hell Ride attraction. The line for the ride forms to the south and the midway continues east and west from here. There is a concession stand to the south west. The ticket booth is garishly painted in purple and green sparkles. There is a Ticket Seller here. The Ticket Seller has a Hell Ride ticket.

You can see a Ticket Seller here.

>nb
That's not a verb I recognize.

>n
Parking Lot
You are in a parking lot full of cars. The midway is to the south. There is a blueberry bush here. There are blueberries on the bush

You can see a dime here.

>get all
dime: Taken.
blueberries: Good Job!

[Your score has just gone up by five points.]

* * *

>e
Strongman Booth
The Strongman Booth is a popular carnival game in which you swing a mallet against a base and cause a striker to hit a bell. Along the length of the pole are markings indicating how strong you are.  A nearby sign says, "Buy a mallet, strike the bell, win a prize."

You can see a Strongman Attendant and a base here.

>hit base with dime
You can't hit base with that!

>hit dime with money
Nothing happens.
You can't hit dime with that!

>hit dime
Violence isn't the answer to this one.

>hit dime with money
Nothing happens.
You can't hit dime with that!

* * *

>s
The Ticket Booth
You are standing in line at a ticket booth at the carnival. The booth sells tickets to the Hell Ride attraction. The line for the ride forms to the south and the midway continues east and west from here. There is a concession stand to the south west. The ticket booth is garishly painted in purple and green sparkles. There is a Ticket Seller here. The Ticket Seller has a Hell Ride ticket.

You can see a Ticket Seller here.

>n
Parking Lot
You are in a parking lot full of cars. The midway is to the south. There is a blueberry bush here. There are blueberries on the bush

You can see a dime here.

* * *

>get dime
Taken.

>w
You can't go that way.

>s
The Ticket Booth
You are standing in line at a ticket booth at the carnival. The booth sells tickets to the Hell Ride attraction. The line for the ride forms to the south and the midway continues east and west from here. There is a concession stand to the south west. The ticket booth is garishly painted in purple and green sparkles. There is a Ticket Seller here. The Ticket Seller has a Hell Ride ticket.

You can see a Ticket Seller here.

* * *

>l
Little Egypt Facade
You are standing in front of a trailer. There is a stage in front of the trailer. The Barker is encouraging you to step up, pay for, and enjoy the Little Egypt Show.

You can see a Barker here.

>w
You head west through the midway, the bright lights of the carnival fading behind you as you approach a wooden booth. A sign above the entrance reads "Little Egypt Show - A Journey Into the Mysterious and Exotic!" A rotund attendant, wearing a fez and a dazzling smile, gestures to a small sign beside him that says "Dime Admission."

It'll cost you a dime to go that way.

* * *

>s
The Ticket Booth
You are standing in line at a ticket booth at the carnival. The booth sells tickets to the Hell Ride attraction. The line for the ride forms to the south and the midway continues east and west from here. There is a concession stand to the south west. The ticket booth is garishly painted in purple and green sparkles. There is a Ticket Seller here. The Ticket Seller has a Hell Ride ticket.

You can see a Ticket Seller here.

>w
You head west through the midway, the bright lights of the carnival fading behind you as you approach a wooden booth. A sign above the entrance reads "Little Egypt Show - A Journey Into the Mysterious and Exotic!" A rotund attendant, wearing a fez and a dazzling smile, gestures to a small sign beside him that says "Dime Admission."

>w
It'll cost you a dime to go that way.

>give dime to barker
You can't see any such thing.

>e
The Ticket Booth
You are standing in line at a ticket booth at the carnival. The booth sells tickets to the Hell Ride attraction. The line for the ride forms to the south and the midway continues east and west from here. There is a concession stand to the south west. The ticket booth is garishly painted in purple and green sparkles. There is a Ticket Seller here. The Ticket Seller has a Hell Ride ticket.

You can see a Ticket Seller here.

>n
Parking Lot
You are in a parking lot full of cars. The midway is to the south. There is a blueberry bush here. There are blueberries on the bush

You can see a dime here.

* * *

>w
You head west through the midway, the bright lights of the carnival fading behind you as you approach a wooden booth. A sign above the entrance reads "Little Egypt Show - A Journey Into the Mysterious and Exotic!" A rotund attendant, wearing a fez and a dazzling smile, gestures to a small sign beside him that says "Dime Admission."

>give dime to barker
You hand over a dime, and the attendant nods, waving you through. As you step past the entrance, the air feels thicker, almost humid, and the sounds of the carnival fade away. You've entered an entirely different world now-one filled with the scents of incense and exotic spices, and the low, hypnotic music of a faraway land. Before you, a series of dimly lit tents stretch out, their flaps slightly swaying in the breeze. Intrigued, you take your first step into the Little Egypt Show. You can now head west into the show.

>w
Little Egypt Show
You are inside the Little Egypt Show. The attraction facade is to the east.

You enter the tent and sit in one of the folding chairs in the front row.

Little Egypt Show (on the Folding Chair)
You are inside the Little Egypt Show. The attraction facade is to the east.

* * *

>z
Time passes.

As you enter the dimly lit tent, you see that the stage is decorated to resemble an exotic Middle Eastern market or palace, featuring rich, colorful fabrics, brass ornaments, and lanterns casting a warm, flickering glow. Scents of incense waft through the air, enhancing the atmosphere of mystique. The backdrop displays painted scenes of pyramids, desert landscapes, or domed structures to evoking a sense of being transported to the "Middle East".

>z
Time passes.

Little Egypt emerges draped in a flowing silk veils which she skillfully uses as part of the dance. Her attire consists of a sparkling, sequined bodice and a flowing skirt, adorned with jingling coin belts and jewelry that accentuate her movements.

>z
Time passes.

The performance begins with slow, undulating movements, drawing the you into the rhythm of exotic live music played on traditional instruments like the oud, darbuka, or zurna. As the tempo builds, her hips, torso, and hands move in intricate, mesmerizing patterns, demonstrating remarkable control and fluidity. She incorporates dramatic spins, drops, and shimmies, often accentuating the beat of the music with a quick jingle of her coin belt.

* * *

>stand
You get off the Folding Chair.

Little Egypt Show
You are inside the Little Egypt Show. The attraction facade is to the east.

>e
Little Egypt Facade
You are standing in front of a trailer. There is a stage in front of the trailer. The Barker is encouraging you to step up, pay for, and enjoy the Little Egypt Show.The barker cries: 

Ladies and gentlemen, boys and girls, gather "round! 
Step right up and witness the spectacle that's taken the world by storm! 
She walks, she talks, she crawls on her belly like a reptile. 
Behold the one, the only Little Egypt, performing her legendary Dance of the Pyramids-a dazzling display of mystery, grace, and exotic allure! 
For just a dime, a mere one tenth of a dollar, prepare to be transported to the sands of Cairo, where enchantment and wonder await!

You can see a Barker here.

>w
Little Egypt Show
You are inside the Little Egypt Show. The attraction facade is to the east.

>e
Little Egypt Facade
You are standing in front of a trailer. There is a stage in front of the trailer. The Barker is encouraging you to step up, pay for, and enjoy the Little Egypt Show.

You can see a Barker here.

>w
Little Egypt Show
You are inside the Little Egypt Show. The attraction facade is to the east.

* * *

>e
Little Egypt Facade
You are standing in front of a trailer. There is a stage in front of the trailer. The Barker is encouraging you to step up, pay for, and enjoy the Little Egypt Show.

You can see a Barker here.

>e
The Ticket Booth
You are standing in line at a ticket booth at the carnival. The booth sells tickets to the Hell Ride attraction. The line for the ride forms to the south and the midway continues east and west from here. There is a concession stand to the south west. The ticket booth is garishly painted in purple and green sparkles. There is a Ticket Seller here. The Ticket Seller has a Hell Ride ticket.

You can see a Ticket Seller here.

>buy ticket
(the Ticket Seller)
The Ticket Seller is yours already.

>buy ride ticket
You fork over $2.50 for the Hell Ride ticket, leaving yourself with $7.50.

>s
Head of the Line
You are standing in front of a ticket taker with his hand open waiting for your ticket. The entrance to the ride is south of here.

You can see a Ride Attendant here.

* * *

>s
Ride Entrance
The cars that will take you into the fearsome Hell Ride stop here for you to board.  To the south is the track that will take you into the ride. The safety bar is raised allowing you to entering the car. East of here is a gate with a sign that reads "Employees Only".

You can see a car (empty) here.

>enter car
You get into the car.

The car moves forward and the safety bar begins to lower.

>z
Time passes.

The car has begun to move toward the entrance of the ride and the safety bar has been lowered halfwa. Surrounded by skulls, chains, and ominous creatures, the doors to the ride read "Hell Ride" in fiery, glowing letters.

>z
Time passes.

The doors open and your car passes through into the darkness. The safety bar has been lowered.

Mist fills the area as you move to the next room.

* * *

>w
It'll cost you a dime to go that way.

>l
You head west through the midway, the bright lights of the carnival fading behind you as you approach a wooden booth. A sign above the entrance reads "Little Egypt Show - A Journey Into the Mysterious and Exotic!" A rotund attendant, wearing a fez and a dazzling smile, gestures to a small sign beside him that says "Dime Admission."

Little Egypt Facade
You are standing in front of a trailer. There is a stage in front of the trailer. The Barker is encouraging you to step up, pay for, and enjoy the Little Egypt Show.

You can see a Barker here.