The carnival is in town and you had a date with your sweetie to visit it. After dinner and just as you arrive at the carnival, you and your date have a terrible fight. They storm off leaving you alone at the carnival. You decide to stay at the carnival anyway.

Hell Ride
The ride of a lifetime... by No Shoes
Release 1 / Serial number 241201 / Inform 7 v10.1.2 / D

Parking Lot
You are in a parking lot full of cars. The midway is to the south. There is a blueberry bush here. There are blueberries on the bush

>s
The Booth
You are standing in line at a ticket booth at the carnival. The booth sells tickets to the Hell Ride attraction. The line for the ride forms to the south and the midway continues east and west from here. There is a concession stand to the south west. The ticket booth is garishly painted in purple and green sparkles. There is a Ticket Seller here. The Ticket Seller has a ticket.

You can see a Seller here.

>buy ticket
You fork over $2.50 for the Hell Ride ticket, leaving yourself with $7.50.

* * *

>s
Head of the Line
You are standing in front of a ticket taker with his hand open waiting for your ticket. The entrance to the ride is south of here.

You can see a Ride Attendant here.

>s
Ride Entrance
The cars that will take you into the fearsome Hell Ride stop here for you to board.  To the south is the track that will take you into the ride. The safety bar is raised allowing you to entering the car.

You can see a car (empty) here.

>get in car
You get into the car.

The car moves forward and the safety bar begins to lower.

>s
You are enjoying the ride.

You are in the Stocks Room.

>s
You are enjoying the ride.

You are in the Gallows Room.

>w
You are enjoying the ride.

You are in the Stake Room.

>n
You are enjoying the ride.

You are in the Dungeon.

>e
You are enjoying the ride.

You are in the Guillotine Room.

You have died.

Too bad.

Too bad.

    *** * * * * * You have died * * * * * ***

In that game you scored 0 out of a possible 100, in 11 turns.

Would you like to RESTART, RESTORE a saved game, QUIT, or UNDO the last command?

>restart
The carnival is in town and you had a date with your sweetie to visit it. After dinner and just as you arrive at the carnival, you and your date have a terrible fight. They storm off leaving you alone at the carnival. You decide to stay at the carnival anyway.

Hell Ride
The ride of a lifetime... by No Shoes
Release 1 / Serial number 241201 / Inform 7 v10.1.2 / D

Parking Lot
You are in a parking lot full of cars. The midway is to the south. There is a blueberry bush here. There are blueberries on the bush

* * *

>get in car
You get into the car.

The car moves forward and the safety bar begins to lower.

>get out of car
I only understood you as far as wanting to get outside.

>exit
You are enjoying the ride.

You are in the Stocks Room.

>l
Ride Entrance (in the car)
The cars that will take you into the fearsome Hell Ride stop here for you to board.  To the south is the track that will take you into the ride. The safety bar is raised allowing you to entering the car.

You are in the Gallows Room.

>z
Time passes.

You are in the Stake Room.

>z
Time passes.

You are in the Dungeon.

>z
Time passes.

You are in the Guillotine Room.

You have died.

Too bad.

Too bad.

    *** * * * * * You have died * * * * * ***

In that game you scored 0 out of a possible 100, in 10 turns.

Would you like to RESTART, RESTORE a saved game, QUIT, or UNDO the last command?

>restart
The carnival is in town and you had a date with your sweetie to visit it. After dinner and just as you arrive at the carnival, you and your date have a terrible fight. They storm off leaving you alone at the carnival. You decide to stay at the carnival anyway.

Hell Ride
The ride of a lifetime... by No Shoes
Release 1 / Serial number 241201 / Inform 7 v10.1.2 / D

Parking Lot
You are in a parking lot full of cars. The midway is to the south. There is a blueberry bush here. There are blueberries on the bush

* * *

>s
The Booth
You are standing in line at a ticket booth at the carnival. The booth sells tickets to the Hell Ride attraction. The line for the ride forms to the south and the midway continues east and west from here. There is a concession stand to the south west. The ticket booth is garishly painted in purple and green sparkles. There is a Ticket Seller here. The Ticket Seller has a ticket.

You can see a Seller here.

>n
Parking Lot
You are in a parking lot full of cars. The midway is to the south. There is a blueberry bush here. There are blueberries on the bush

>s
The Booth
You are standing in line at a ticket booth at the carnival. The booth sells tickets to the Hell Ride attraction. The line for the ride forms to the south and the midway continues east and west from here. There is a concession stand to the south west. The ticket booth is garishly painted in purple and green sparkles. There is a Ticket Seller here. The Ticket Seller has a ticket.

You can see a Seller here.

* * *

>s
Head of the Line
You are standing in front of a ticket taker with his hand open waiting for your ticket. The entrance to the ride is south of here.

You can see a Ride Attendant here.

>give ticket to attendant
You give the Hell Ride ticket to the Ride Attendant.

>s
Ride Entrance
The cars that will take you into the fearsome Hell Ride stop here for you to board.  To the south is the track that will take you into the ride. The safety bar is raised allowing you to entering the car.

You can see a car (empty) here.

* * *

>get in car
You get into the car.

The car moves forward and the safety bar begins to lower.

>z
Time passes.

"Welcome to Precolumbian Archaeology 101," thunders Dr Freitag from the front of the class. "Miss-- yes, you in the back. If you can't find a free seat, how are you going to find Atlantis? Sit down or leave. Now. Thank you."

>z
Time passes.

Freitag stands behinds his desk and lines up the pile of books there more neatly. "It has come to my attention over previous years that there are two sorts of person who enroll in my class," he says.

"Some of you will be members of the swim team or women's lacrosse players who have a distribution requirement to fulfill and are under the mistaken impression that archaeology must be easier than psychology. If that description applies to you, I advise you to drop the class now rather than at the midterm break. Under absolutely no circumstances will I ever sign a withdrawal form for someone who is crying at the time. Make a note of that, please."

* * *

>s
The Booth
You are standing in line at a ticket booth at the carnival. The booth sells tickets to the Hell Ride attraction. The line for the ride forms to the south and the midway continues east and west from here. There is a concession stand to the south west. The ticket booth is garishly painted in purple and green sparkles. There is a Ticket Seller here. The Ticket Seller has a ticket.

You can see a Seller here.

>e
Strongman Booth
The Strongman Booth is a popular carnival game in which you swing a mallet against a base and cause a striker to hit a bell. Along the length of the pole are markings indicating how strong you are.  A nearby sign says, "Buy a mallet, strike the bell, win a prize."

You can see a Strongman Attendant and a base here.

>e
You can't go that way.

>buy mallet
You fork over $2.00 for the mallet, leaving yourself with $8.00.

>hit bullseye with mallet
You lift the mallet high and bring it down on the base with all your might! The striker rises towards the bell stopping at "Getting Stronger".

>hit bullseye with mallet
You lift the mallet high and bring it down on the base with all your might! The striker rises towards the bell stopping at "Getting Stronger".

>hit bullseye with mallet
You lift the mallet high and bring it down on the base with all your might! The striker rises towards the bell stopping at "Average".

>hit bullseye with mallet
You lift the mallet high and bring it down on the base with all your might! The striker rises towards the bell stopping at "Getting Stronger".

You swing the mallet one more time. The bell rings as the striker reaches the top of the pole. The attendant says, "You're a Muscle Man. Here's a prize for you."

[Your score has just gone up by five points.]

>i
You are carrying:
  a stuffed teddy bear
  a mallet
  a dime
  a wallet
    $8.00 in cash

>w
The Booth
You are standing in line at a ticket booth at the carnival. The booth sells tickets to the Hell Ride attraction. The line for the ride forms to the south and the midway continues east and west from here. There is a concession stand to the south west. The ticket booth is garishly painted in purple and green sparkles. There is a Ticket Seller here. The Ticket Seller has a ticket.

You can see a Seller here.

>w
Little Egypt Facade
You are standing in front of a trailer. There is a stage in front of the trailer. The Barker is encouraging you to step up, pay for, and enjoy the Little Egypt Show.

You can see a Barker here.

The barker cries: 

Ladies and gentlemen, boys and girls, gather "round! 
Step right up and witness the spectacle that's taken the world by storm! 
She walks, she talks, she crawls on her belly like a reptile. 
Behold the one, the only Little Egypt, performing her legendary Dance of the Pyramids-a dazzling display of mystery, grace, and exotic allure! 
For just a dime, a mere one tenth of a dollar, prepare to be transported to the sands of Cairo, where enchantment and wonder await!

>l
Little Egypt Facade
You are standing in front of a trailer. There is a stage in front of the trailer. The Barker is encouraging you to step up, pay for, and enjoy the Little Egypt Show.

You can see a Barker here.

The barker cries: 

Ladies and gentlemen, boys and girls, gather "round! 
Step right up and witness the spectacle that's taken the world by storm! 
She walks, she talks, she crawls on her belly like a reptile. 
Behold the one, the only Little Egypt, performing her legendary Dance of the Pyramids-a dazzling display of mystery, grace, and exotic allure! 
For just a dime, a mere one tenth of a dollar, prepare to be transported to the sands of Cairo, where enchantment and wonder await!

* * *

>s
Ride Entrance
The cars that will take you into the fearsome Hell Ride stop here for you to board.  To the south is the track that will take you into the ride. The safety bar is raised allowing you to entering the car.

You can see a car (empty) here.

>s
You can't go that way.

* * *

>n
Parking Lot
You are in a parking lot full of cars. The midway is to the south. There is a blueberry bush here. There are blueberries on the bush

>test me
(Testing.)

>[1] s

The Booth
You are standing in line at a ticket booth at the carnival. The booth sells tickets to the Hell Ride attraction. The line for the ride forms to the south and the midway continues east and west from here. There is a concession stand to the south west. The ticket booth is garishly painted in purple and green sparkles. There is a Ticket Seller here. The Ticket Seller has a ticket.

You can see a Seller here.

>[2] buy ticket
You fork over $2.50 for the Hell Ride ticket, leaving yourself with $7.50.

>[3] s

Head of the Line
You are standing in front of a ticket taker with his hand open waiting for your ticket. The entrance to the ride is south of here.

You can see a Ride Attendant here.

>[4] give ticket to attendant
You give the Hell Ride ticket to the Ride Attendant.

>[5] s

Ride Entrance
The cars that will take you into the fearsome Hell Ride stop here for you to board.  To the south is the track that will take you into the ride. The safety bar is raised allowing you to entering the car.

You can see a car (empty) here.

>[6] enter car
You get into the car.

The car moves forward and the safety bar begins to lower.

>restart.y.test me
Are you sure you want to restart?

>y
The carnival is in town and you had a date with your sweetie to visit it. After dinner and just as you arrive at the carnival, you and your date have a terrible fight. They storm off leaving you alone at the carnival. You decide to stay at the carnival anyway.

Hell Ride
The ride of a lifetime... by No Shoes
Release 1 / Serial number 241201 / Inform 7 v10.1.2 / D

Parking Lot
You are in a parking lot full of cars. The midway is to the south. There is a blueberry bush here. There are blueberries on the bush

>test me
(Testing.)

>[1] s

The Booth
You are standing in line at a ticket booth at the carnival. The booth sells tickets to the Hell Ride attraction. The line for the ride forms to the south and the midway continues east and west from here. There is a concession stand to the south west. The ticket booth is garishly painted in purple and green sparkles. There is a Ticket Seller here. The Ticket Seller has a ticket.

You can see a Seller here.

>[2] buy ticket
You fork over $2.50 for the Hell Ride ticket, leaving yourself with $7.50.

>[3] s

Head of the Line
You are standing in front of a ticket taker with his hand open waiting for your ticket. The entrance to the ride is south of here.

You can see a Ride Attendant here.

>[4] give ticket to attendant
You give the Hell Ride ticket to the Ride Attendant.

>[5] s

Ride Entrance
The cars that will take you into the fearsome Hell Ride stop here for you to board.  To the south is the track that will take you into the ride. The safety bar is raised allowing you to entering the car.

You can see a car (empty) here.

>[6] enter car
You get into the car.

The car moves forward and the safety bar begins to lower.

>n
You are enjoying the ride.

 The car has begun to move toward the entrance of the ride and the safety bar has been lowered halfway.

>restart
Are you sure you want to restart?

* * *

>save
Ok.

* * *

>s
The Booth
You are standing in line at a ticket booth at the carnival. The booth sells tickets to the Hell Ride attraction. The line for the ride forms to the south and the midway continues east and west from here. There is a concession stand to the south west. The ticket booth is garishly painted in purple and green sparkles. There is a Ticket Seller here. The Ticket Seller has a ticket.

You can see a Seller here.

>s
You are enjoying the ride.

Freitag stands behinds his desk and lines up the pile of books there more neatly. "It has come to my attention over previous years that there are two sorts of person who enroll in my class," he says.

"Some of you will be members of the swim team or women's lacrosse players who have a distribution requirement to fulfill and are under the mistaken impression that archaeology must be easier than psychology. If that description applies to you, I advise you to drop the class now rather than at the midterm break. Under absolutely no circumstances will I ever sign a withdrawal form for someone who is crying at the time. Make a note of that, please."

>n
The Booth
You are standing in line at a ticket booth at the carnival. The booth sells tickets to the Hell Ride attraction. The line for the ride forms to the south and the midway continues east and west from here. There is a concession stand to the south west. The ticket booth is garishly painted in purple and green sparkles. There is a Ticket Seller here. The Ticket Seller has a ticket.

You can see a Seller here.

>n
Parking Lot
You are in a parking lot full of cars. The midway is to the south. There is a blueberry bush here. There are blueberries on the bush

* * *

>s
The Booth
You are standing in line at a ticket booth at the carnival. The booth sells tickets to the Hell Ride attraction. The line for the ride forms to the south and the midway continues east and west from here. There is a concession stand to the south west. The ticket booth is garishly painted in purple and green sparkles. There is a Ticket Seller here. The Ticket Seller has a ticket.

You can see a Seller here.

>w
Little Egypt Facade
You are standing in front of a trailer. There is a stage in front of the trailer. The Barker is encouraging you to step up, pay for, and enjoy the Little Egypt Show.

You can see a Barker here.

The barker cries: 

Ladies and gentlemen, boys and girls, gather "round! 
Step right up and witness the spectacle that's taken the world by storm! 
She walks, she talks, she crawls on her belly like a reptile. 
Behold the one, the only Little Egypt, performing her legendary Dance of the Pyramids-a dazzling display of mystery, grace, and exotic allure! 
For just a dime, a mere one tenth of a dollar, prepare to be transported to the sands of Cairo, where enchantment and wonder await!

>w
It'll cost you a dime to go that way.

The barker cries: 

Ladies and gentlemen, boys and girls, gather "round! 
Step right up and witness the spectacle that's taken the world by storm! 
She walks, she talks, she crawls on her belly like a reptile. 
Behold the one, the only Little Egypt, performing her legendary Dance of the Pyramids-a dazzling display of mystery, grace, and exotic allure! 
For just a dime, a mere one tenth of a dollar, prepare to be transported to the sands of Cairo, where enchantment and wonder await!

>give dime to barker
You can now head west into the show.

The barker cries: 

Ladies and gentlemen, boys and girls, gather "round! 
Step right up and witness the spectacle that's taken the world by storm! 
She walks, she talks, she crawls on her belly like a reptile. 
Behold the one, the only Little Egypt, performing her legendary Dance of the Pyramids-a dazzling display of mystery, grace, and exotic allure! 
For just a dime, a mere one tenth of a dollar, prepare to be transported to the sands of Cairo, where enchantment and wonder await!

>w
Little Egypt Show
As you enter the dimly lit tent, you see that the stage is decorated to resemble an exotic Middle Eastern market or palace, featuring rich, colorful fabrics, brass ornaments, and lanterns casting a warm, flickering glow. Scents of incense waft through the air, enhancing the atmosphere of mystique. The backdrop displays painted scenes of pyramids, desert landscapes, or domed structures to evoking a sense of being transported to the "Middle East". 

Little Egypt emerges draped in a flowing silk veils which she skillfully uses as part of the dance. Her attire consists of a sparkling, sequined bodice and harem pants, adorned with jingling coin belts and jewelry that accentuate her movements.

The performance begins with slow, undulating movements, drawing the you into the rhythm of exotic live music played on traditional instruments like the oud, darbuka, or zurna. As the tempo builds, her hips, torso, and hands move in intricate, mesmerizing patterns, demonstrating remarkable control and fluidity. She incorporates dramatic spins, drops, and shimmies, often accentuating the beat of the music with a quick jingle of her coin belt.

Little Egypt makes eye contact with you and smiles enigmatically. During her performance she balances a sword on her head and accents her dance with finger cymbals.

The music alternates between hauntingly slow melodies and rapid, energetic drum beats, creating an emotional arc that keeps the you entranced. Little Egypt relies on the music's dynamic changes to tell a story with movements reflecting joy, sorrow, seduction, and celebration.

The performance concludes with a dramatic flourish of a fast-paced shimmy, a bold spin, and Little Egypt dramatically casts off her veils. The dancer takes a bow to enthusiastic applause, leaving you spellbound by the sensual yet artful display.

>n
You can't go that way.

>n
You can't go that way.

>restart
Are you sure you want to restart?

* * *

>e
Strongman Booth
The Strongman Booth is a popular carnival game in which you swing a mallet against a base and cause a striker to hit a bell. Along the length of the pole are markings indicating how strong you are.  A nearby sign says, "Buy a mallet, strike the bell, win a prize."

You can see a Strongman Attendant and a base here.

>buy mallet
You fork over $2.00 for the mallet, leaving yourself with $8.00.

>hit base with mallet
You lift the mallet high and bring it down on the base with all your might! The striker rises towards the bell stopping at "Weakling".  C'mon! You can do better than that!

>hit base with mallet
You lift the mallet high and bring it down on the base with all your might! The striker rises towards the bell stopping at "Almost There".  C'mon! You can do better than that!

>hit base with mallet
You lift the mallet high and bring it down on the base with all your might! The striker rises towards the bell stopping at "Almost There".  C'mon! You can do better than that!

>hit base with mallet
You lift the mallet high and bring it down on the base with all your might! The striker rises towards the bell stopping at "Average".  C'mon! You can do better than that!

>hit base with mallet
You lift the mallet high and bring it down on the base with all your might! The striker rises towards the bell stopping at "Weakling".  C'mon! You can do better than that!

You swing the mallet one more time. The bell rings as the striker reaches the top of the pole. The attendant says, "You're a Muscle Man. Here's a prize for you."

[Your score has just gone up by five points.]

* * *

>s
You are enjoying the ride.

"The second sort of person," Dr Freitag says, getting another wind. "Yes, the second sort of person takes this class because she imagines that it is going to lead to adventure or possibly to new age encounters with dolphins."

His eye moves over the class, lingering an especially long time on a girl in a patchwork skirt.

"You should also leave now, but since you are probably lying to yourself about the reasons you're here, you will probably not heed my warning and we will be doomed to a semester of one another's company nonetheless."

>enter car
You get into the car.

The car moves forward and the safety bar begins to lower.

>s
Stocks Room (in the car)
You see stocks here.

>s
Gallows Room (in the car)
You see gallows here.

>s
Stake Room (in the car)
You see gallows here.

>s
Dungeon (in the car)
You see a dungeon here.

>s
Guillotine Room (in the car)
A guillotine is about to chop your head off.

>s
*** The End ***

In that game you scored 0 out of a possible 100, in 10 turns.

Would you like to RESTART, RESTORE a saved game, QUIT, or UNDO the last command?

* * *

>s
You are enjoying the ride.

"The second sort of person," Dr Freitag says, getting another wind. "Yes, the second sort of person takes this class because she imagines that it is going to lead to adventure or possibly to new age encounters with dolphins."

His eye moves over the class, lingering an especially long time on a girl in a patchwork skirt.

"You should also leave now, but since you are probably lying to yourself about the reasons you're here, you will probably not heed my warning and we will be doomed to a semester of one another's company nonetheless."

>get in car
You get into the car.

The car moves forward and the safety bar begins to lower.

>s
Stocks Room (in the car)
You see stocks here.

* * *

>s
Dungeon (in the car)
You see a dungeon here.

>s
*** The End ***

In that game you scored 0 out of a possible 100, in 9 turns.

Would you like to RESTART, RESTORE a saved game, QUIT, or UNDO the last command?

* * *

>s
You are enjoying the ride.

"The second sort of person," Dr Freitag says, getting another wind. "Yes, the second sort of person takes this class because she imagines that it is going to lead to adventure or possibly to new age encounters with dolphins."

His eye moves over the class, lingering an especially long time on a girl in a patchwork skirt.

"You should also leave now, but since you are probably lying to yourself about the reasons you're here, you will probably not heed my warning and we will be doomed to a semester of one another's company nonetheless."

>n
Head of the Line
You are standing in front of a ticket taker with his hand open waiting for your ticket. The entrance to the ride is south of here.

You can see a Ride Attendant here.

>n
The Booth
You are standing in line at a ticket booth at the carnival. The booth sells tickets to the Hell Ride attraction. The line for the ride forms to the south and the midway continues east and west from here. There is a concession stand to the south west. The ticket booth is garishly painted in purple and green sparkles. There is a Ticket Seller here. The Ticket Seller has a ticket.

You can see a Seller here.

>get ticket
You'll have to pay for that.

* * *

>s
You are enjoying the ride.

"The second sort of person," Dr Freitag says, getting another wind. "Yes, the second sort of person takes this class because she imagines that it is going to lead to adventure or possibly to new age encounters with dolphins."

His eye moves over the class, lingering an especially long time on a girl in a patchwork skirt.

"You should also leave now, but since you are probably lying to yourself about the reasons you're here, you will probably not heed my warning and we will be doomed to a semester of one another's company nonetheless."

>s
You are enjoying the ride.

"Whatever you may tell yourself, you are not here to gain a deeper understanding of the world or get in touch with yourself or experience another culture."

He paces before the first row of desks, hammering on them one at a time. "I know you probably wrote an admissions statement saying that that is what you hoped to do. Well, too bad. It is not inconceivable that some of you, somehow, will muddle towards a deeper understanding of something thanks to this class, but I am not holding my breath, and neither should you."

>s
You are enjoying the ride.

Freitag takes a breath. "No, my dear freshwomen, what you are here to do is learn facts. FACTS. Facts are unpopular in this university and, I am unhappily aware, at most of the institutions of inferior preparation from which you have come. Nonetheless, facts it will be. I will expect you to learn names. I will expect you to learn dates. I will expect you to study maps and I will expect you to produce evidence of exacting geographical knowledge on the exams. I will expect you to learn shapes of pottery and memorize masonry designs. There are no principles you can learn which are more important or more useful than a truly colossal bank of facts right there in your own head."

>s
You are enjoying the ride.

"I do not ever want to hear that you do not need to learn things because you will be able to look them up. This is the greatest fallacy of your computer-semi-literate generation, that you can get anything out of Google if you need it. Not only is this demonstrably false, but it overlooks something phenomenally important: you only know to look for something if you already know it EXISTS. In short there is no way to fake knowledge, and I am not going to pretend there is." He smiles in lupine fashion.

"This class is likely to be the most miserable experience of your four years in university. Clear?"

>s
You are enjoying the ride.

Everyone is silent.

>s
You are enjoying the ride.

The lecture is interrupted by the shrill of a bell.

There is a flurry of movement as your fellow students begin to put away their books. Dr Freitag makes his way to the door and is gone before anyone can ask him anything.

>s
The Booth
You are standing in line at a ticket booth at the carnival. The booth sells tickets to the Hell Ride attraction. The line for the ride forms to the south and the midway continues east and west from here. There is a concession stand to the south west. The ticket booth is garishly painted in purple and green sparkles. There is a Ticket Seller here. The Ticket Seller has a ticket.

You can see a Seller here.

* * *

>s
You can't go that way.

>restart
Are you sure you want to restart?

* * *

>y
The carnival is in town and you had a date with your sweetie to visit it. After dinner and just as you arrive at the carnival, you and your date have a terrible fight. They storm off leaving you alone at the carnival. You decide to stay at the carnival anyway.

Hell Ride
The ride of a lifetime... by No Shoes
Release 1 / Serial number 241201 / Inform 7 v10.1.2 / D

Parking Lot
You are in a parking lot full of cars. The midway is to the south. There is a blueberry bush here. There are blueberries on the bush

>s
You are enjoying the ride.

"Welcome to Precolumbian Archaeology 101," thunders Dr Freitag from the front of the class. "Miss-- yes, you in the back. If you can't find a free seat, how are you going to find Atlantis? Sit down or leave. Now. Thank you."

* * *

The carnival is in town and you had a date with your sweetie to visit it. After dinner and just as you arrive at the carnival, you and your date have a terrible fight. They storm off leaving you alone at the carnival. You decide to stay at the carnival anyway.

Hell Ride
The ride of a lifetime... by No Shoes
Release 1 / Serial number 241201 / Inform 7 v10.1.2 / D

Parking Lot
You are in a parking lot full of cars. The midway is to the south. There is a blueberry bush here. There are blueberries on the bush

>test me
(Testing.)

>[1] s

The Booth
You are standing in line at a ticket booth at the carnival. The booth sells tickets to the Hell Ride attraction. The line for the ride forms to the south and the midway continues east and west from here. There is a concession stand to the south west. The ticket booth is garishly painted in purple and green sparkles. There is a Ticket Seller here. The Ticket Seller has a ticket.

You can see a Seller here.

>[2] buy ticket
You fork over $2.50 for the Hell Ride ticket, leaving yourself with $7.50.

>[3] s

Head of the Line
You are standing in front of a ticket taker with his hand open waiting for your ticket. The entrance to the ride is south of here.

You can see a Ride Attendant here.

>[4] give ticket to attendant
You give the Hell Ride ticket to the Ride Attendant.

>[5] s

Ride Entrance
The cars that will take you into the fearsome Hell Ride stop here for you to board.  To the south is the track that will take you into the ride. The safety bar is raised allowing you to entering the car.

You can see a car (empty) here.

>exit
You are enjoying the ride.

 The car has begun to move toward the entrance of the ride and the safety bar has been lowered halfway.

>exit
You are enjoying the ride.

The doors open and your car passes through into the darkness. The safety bar has been lowered.

>s
You are enjoying the ride.

You are in the Stocks Room.

>w
You are enjoying the ride.

You are in the Gallows Room.

>e
You are enjoying the ride.

You are in the Stake Room.

>s
You are enjoying the ride.

You are in the Dungeon.

>w
You are enjoying the ride.

You are in the Guillotine Room.

Too bad.

    *** * * * * * You have died * * * * * ***

In that game you scored 0 out of a possible 100, in 14 turns.

Would you like to RESTART, RESTORE a saved game, QUIT, or UNDO the last command?

* * *

>s
You can't go that way.

* * *

>w
You can't go that way.

>n
Head of the Line
You are standing in front of a ticket taker with his hand open waiting for your ticket. The entrance to the ride is south of here.

You can see a Ride Attendant here.

>l at attendant
This is another bored teenager. His thoughts are entirely focused on a cheeseburger for lunch.