Type "HELP" for hints about Hell Ride and general information about playing interactive fiction games. The art in this game was generated by ChatGPT. Images are off by default. Type "IMAGES ON to toggle image presentation.

You're a part-time reporter for The Tribune, the local newspaper. Earlier in the day, your editor called you and told you of a conversation he overheard between the Chief of Police and his Deputy about Whidbey Amusements. It seems there has been a rash of accidents and mishaps at the carnival. Sounds like there could be something suspicious going on. The editor wants you to collect evidence and write a hard hitting piece about this story. If you do a good job, maybe the paper will hire you on full-time.

Hell Ride
The ride of a lifetime... by Dana Montgomery
Release 1 / Serial number 250326 / Inform 7 v10.1.2 / D

Parking Lot
The lot stretches across an open field, gravel crunching under the tires of arriving cars. Floodlights and the carnival's colorful glow light the area, accompanied by distant laughter, music, and the hum of rides.

Cars park haphazardly, guided by makeshift signs and fluttering flags. Families and visitors mingle, some lingering in vehicles, preparing for the chilly evening ahead. Shadows from encroaching trees are pierced by the occasional flash of a flashlight. At the entrance, an attendant collects fees in a weathered booth, making change from a cash box.

Puddles from recent rain shimmer under the lights, while patches of mud cling to shoes. In the distance, RVs and trailers sit quietly, their occupants watching the Ferris wheel turn against the evening sky. The lot serves as a transition between the mundane and the magical world inside the carnival.

The midway is to the south. There is a blueberry bush here. There are blueberries on the bush.

Your car is here. It's a bit of a beater. Inside the car, you can see the glove box, the seat, the rear view mirror, the ignition, and the dashboard.

The attendant has a parking ticket. The price of a parking is $5.00.

You can see a parking attendant here.

* * *

>display signs
$4.00 Hell Ride Ticket
$3.00 Fortune Teller Ticket
$2.00 Ferris Wheel Ticket
$2.00 Bumper Cars Ticket
$1.00 Carousel Ticket

$2.00 Drink Of Cola
$2.50 Bucket Of Popcorn
$1.50 Candy Apple
$1.50 Cotton Candy
$1.50 Soft Pretzel
$1.00 Bubblegum

$2.00 Key Chains
$3.50 Aqua Colored Fuse
$2.00 Devil Horns
$1.00 Plastic Bones
$7.50 T-Shirts

>display fuses
an indigo colored fuse is in the Carnival Office.
a gray colored fuse is in the Bumper Cars.
a magenta colored fuse is in the High Striker.
a khaki colored fuse is in Behind the Concession Stand.
a crimson colored fuse is in the Pitchers Mound.
an orange colored fuse is in the Dime Toss Game.
a quartz colored fuse is in the Stake Room.
an emerald colored fuse is in the Mechanical Room South.
an aqua colored fuse is in the Ride Exit.
9 items.

>display attendants
a parking attendant is an attendant in the Parking Lot.
a Hell Ride attendant is an attendant in the Head of the Line.
a cashier is an attendant in the Ticket Booth.
a concession attendant is an attendant in the Concession Stand.
a Carousel attendant is an attendant in the Carousel.
a Bumper Cars attendant is an attendant in the Bumper Cars.
a High Striker attendant is an attendant in the High Striker.
a Pitchers Mound attendant is an attendant in the Pitchers Mound.
a Ferris Wheel attendant is an attendant in the Ferris Wheel.
a Dime Toss attendant is an attendant in the Dime Toss Game.
a merchandise attendant is an attendant in the Ride Exit.
11 items.

>display containers
0kg *** 25kg yourself
2kg *** 15kg a wallet
0kg *** 15kg a fanny pack
0kg *** 25kg a parking attendant
1kg *** 15kg a beater car
1kg *** 15kg a blueberry bush
0kg *** 25kg a janitor
0kg *** 15kg a brass ring
0kg *** 25kg a Hell Ride attendant
0kg *** 25kg Mr Whidbey
3kg *** 15kg a safe
0kg *** 15kg a messy desk
5kg *** 15kg a filing cabinet
1kg *** 15kg an envelope
2kg *** 15kg a glove box
0kg *** 25kg Mayor
0kg *** 25kg Chief of Police
0kg *** 15kg a seat
0kg *** 15kg Electrical Panel 1
0kg *** 15kg an emergency shutdown panel
0kg *** 15kg Electrical Panel 3
0kg *** 15kg Electrical Panel 5
0kg *** 15kg Electrical Panel 7
0kg *** 15kg Electrical Panel 9
0kg *** 15kg Electrical Panel 11
0kg *** 15kg socket 1
0kg *** 15kg socket 3
0kg *** 15kg socket 5
0kg *** 15kg socket 7
0kg *** 15kg socket 9
0kg *** 15kg socket 11
0kg *** 15kg Control Panel One
0kg *** 15kg Control Panel Three
0kg *** 15kg Control Panel Five
0kg *** 15kg Control Panel Seven
0kg *** 15kg Control Panel Nine
0kg *** 15kg Control Panel Eleven
0kg *** 25kg a cashier
0kg *** 15kg an ignition
0kg *** 15kg a dashboard
0kg *** 15kg a round table
0kg *** 25kg Esmeralda
0kg *** 25kg a concession attendant
0kg *** 15kg a Drink of Cola
0kg *** 25kg a Barker
0kg *** 25kg a Carousel attendant
0kg *** 25kg a Bumper Cars attendant
0kg *** 25kg a High Striker attendant
1kg *** 15kg a trash can
0kg *** 15kg a chair
0kg *** 25kg a Pitchers Mound attendant
0kg *** 25kg a Ferris Wheel attendant
0kg *** 25kg a Dime Toss attendant
0kg *** 15kg a plate
0kg *** 25kg Little Egypt
1kg *** 15kg a wall
0kg *** 15kg a folding chair
0kg *** 15kg a Hell Ride car
1kg *** 15kg a pile of junk
0kg *** 15kg a stool
0kg *** 15kg a desk
5kg *** 15kg a drawer
0kg *** 15kg a wooden stocks
0kg *** 15kg a gallows platform
3kg *** 15kg a toolbox
1kg *** 15kg a pyre
1kg *** 15kg a grate
0kg *** 15kg an iron chair
0kg *** 15kg a guillotine platform
5kg *** 15kg a merchandise stand
0kg *** 25kg a merchandise attendant
71 items.

>display missing descriptions
$35.00 in cash has no description.
1 items.

*** Run-time problem P10: Since nothing is not allowed the property "color", it is against the rules to try to use it.

* * *

>help
Sometimes the temptation to rely on hints becomes overwhelming, and you may prefer to turn off hints now. If you do so, the hints will be removed from the help menu. Turn off hints?

>n
(If you're using a screen reader, press S to turn on Screen Reader mode. This message only appears on the front page of the menu system.)

     1. Introduction to Hell Ride
     2. Hell Ride Origins
     3. Introduction to Interactive Fiction
     4. Settings
     5. Credits
     6. ----- The Hints Below Contain Out Right Solutions -----
     7. The Parking Lot
     8. The Attractions
     9. The Games
     0. The Carnival Office
     A. Back Stage
     B. Hell Ride
     C. The Electrical Area
     D. Where Are The Fuses?
     E. The Control Room
     F. Collecting Evidence
     G. How Points Are Awarded (Spoilers)

>1
( - Introduction to Hell Ride)

Hell Ride - A ride to remember...

You're a part-time reporter for The Tribune, the local newspaper. Earlier in the day, your editor called you and told you of a conversation he overheard between the Chief of Police and his Deputy about Whidbey Amusements. It seems there has been a rash of accidents and mishaps at the carnival. Sounds like there could be something suspicious going on. The editor wants you to collect evidence and write a hard hitting piece about this story. If you do a good job, maybe the paper will hire you on full-time.

As you explore the carnival, you learn (the hard way) that the Hell Ride attraction is malfunctioning with the potential for serious injuries to the riders. You must disable the ride and prevent any loss of life... including your own.

------------------------

>[esc]
(If you're using a screen reader, press S to turn on Screen Reader mode. This message only appears on the front page of the menu system.)

     1. Introduction to Hell Ride
     2. Hell Ride Origins
     3. Introduction to Interactive Fiction
     4. Settings
     5. Credits
     6. ----- The Hints Below Contain Out Right Solutions -----
     7. The Parking Lot
     8. The Attractions
     9. The Games
     0. The Carnival Office
     A. Back Stage
     B. Hell Ride
     C. The Electrical Area
     D. Where Are The Fuses?
     E. The Control Room
     F. Collecting Evidence
     G. How Points Are Awarded (Spoilers)

>2
( - Hell Ride Origins)

Hell Ride - A ride to remember...

In the early 1980's, I had an Apple ][  Plus computer with 64K of RAM, dual 5.25" floppy disks, and a color monitor as big as a television. And the very first game I ever bought was Infocom's Zork I: The Great Underground Empire. This was cool. It was all text-based. The game described your surroundings and you interacted with commands that say what you wanted to do. This "Interactive Fiction" really evoked in a game what I appreciated most about reading: rich descriptions, colorful characters, and the like. After Zork I, there was Zork II and III. Enchanter, Moonmist, Suspect, and so many more. I played them all with my best friend Andy.

Andy and I were software developers at the time and we thought, "We can do this!" So we set out to do this. We developed a game engine with a natural language parser. And it was pretty good. We could support most of the kinds of things they did, certainly less graceful but pretty good.

For fun, we reverse engineered parts of Infocom's game format. We found the dictionary, certain text tokens used for text substitution, the game text. We also discovered the first example of compression I had ever seen and it just about made my head explode. They stored all ASCII characters in five bits! Pow! Mind blown. I had never considered anything like that. Just another hook.

We developed two prototypes: Diner and Hell Ride. Diner was about bank robbers coming into the diner where you are a short order cook and you have to save the day. Hell Ride was pretty close to what you find here. I decided to implement it using modern tools. It's pretty good. Maybe.

I hope you enjoy it.

d.
 (dmontgom22@gmail.com)

------------------------

>[esc]
(If you're using a screen reader, press S to turn on Screen Reader mode. This message only appears on the front page of the menu system.)

     1. Introduction to Hell Ride
     2. Hell Ride Origins
     3. Introduction to Interactive Fiction
     4. Settings
     5. Credits
     6. ----- The Hints Below Contain Out Right Solutions -----
     7. The Parking Lot
     8. The Attractions
     9. The Games
     0. The Carnival Office
     A. Back Stage
     B. Hell Ride
     C. The Electrical Area
     D. Where Are The Fuses?
     E. The Control Room
     F. Collecting Evidence
     G. How Points Are Awarded (Spoilers)

>4
(Settings)

     1: The room description style is currently VERBOSE
     2: Score notification is currently ON
     3: Image presentation is currently OFF
     4: Transcript is currently OFF
     5: Story mode is currently OFF

>1
Hell Ride is now in its "brief" printing mode, which gives long descriptions of places never before visited and short descriptions otherwise.

(Settings)

     1: The room description style is currently BRIEF
     2: Score notification is currently ON
     3: Image presentation is currently OFF
     4: Transcript is currently OFF
     5: Story mode is currently OFF

>2
Score notification off.

(Settings)

     1: The room description style is currently BRIEF
     2: Score notification is currently OFF
     3: Image presentation is currently OFF
     4: Transcript is currently OFF
     5: Story mode is currently OFF

>2
Score notification on.

(Settings)

     1: The room description style is currently BRIEF
     2: Score notification is currently ON
     3: Image presentation is currently OFF
     4: Transcript is currently OFF
     5: Story mode is currently OFF

>3
(Settings)

     1: The room description style is currently BRIEF
     2: Score notification is currently ON
     3: Image presentation is currently ON
     4: Transcript is currently OFF
     5: Story mode is currently OFF

>3
(Settings)

     1: The room description style is currently BRIEF
     2: Score notification is currently ON
     3: Image presentation is currently OFF
     4: Transcript is currently OFF
     5: Story mode is currently OFF

>4
Attempt to begin transcript failed.

(Settings)

     1: The room description style is currently BRIEF
     2: Score notification is currently ON
     3: Image presentation is currently OFF
     4: Transcript is currently ON
     5: Story mode is currently OFF

>5
(Settings)

     1: The room description style is currently BRIEF
     2: Score notification is currently ON
     3: Image presentation is currently OFF
     4: Transcript is currently ON
     5: Story mode is currently ON

>5
(Settings)

     1: The room description style is currently BRIEF
     2: Score notification is currently ON
     3: Image presentation is currently OFF
     4: Transcript is currently ON
     5: Story mode is currently OFF

>[esc]
(If you're using a screen reader, press S to turn on Screen Reader mode. This message only appears on the front page of the menu system.)

     1. Introduction to Hell Ride
     2. Hell Ride Origins
     3. Introduction to Interactive Fiction
     4. Settings
     5. Credits
     6. ----- The Hints Below Contain Out Right Solutions -----
     7. The Parking Lot
     8. The Attractions
     9. The Games
     0. The Carnival Office
     A. Back Stage
     B. Hell Ride
     C. The Electrical Area
     D. Where Are The Fuses?
     E. The Control Room
     F. Collecting Evidence
     G. How Points Are Awarded (Spoilers)

>5
( - Credits)

Hell Ride, Copyright 2025, Dana Montgomery.

Caitlyn Caluya-Bilbruck for her editing and proofreading super powers.

The following awesome individuals for their beta testing, excellent feedback, and ideas:
Joey Acrimonious
Ryan Allocco
Andy Broding
Drew Cook
Max Fog
Damien Karolev
RJ Kowalski
John Montgomery
Andrew Schultz

Additional Credits:
The amazing Inform community over at https://IntFiction.org.

Extensions used in Hell Ride:
Basic Inform version 1 by Graham Nelson
English Language version 1 by Graham Nelson
Standard Rules version 6 by Graham Nelson
Modified Exit version 6 by Emily Short
Hacking by Mathbrush
Glulx Entry Points version 10.0.150101 by Emily Short
Simple Multimedia Effects For V10 version 6 by Mathbrush
Locksmith version 13 by Emily Short
Basic Help Menu version 4 by Wade Clarke
Basic Screen Effects version 8 by Emily Short
Menus version 5 by Wade Clarke
Undo Output Control version 6.0.220529 by Nathanael Nerode (based on the extension by Erik Temple;
integrates Empty Command Handling by Daniel Stelzer based on code by Matt Weiner)
Command Preloading version 1.0.20230916 by Daniel Stelzer (based on I6 code by Andrew Plotkin)
Autosave version 2.0.231013 by Daniel Stelzer (based on I6 code from Ultra Undo by Danii Willis)
Story Mode version 2.0.1 by Drew Cook
Object Response Tests version 7 by Juhana Leinonen

The images were generated using ChatGPT.

------------------------

>[esc]
(If you're using a screen reader, press S to turn on Screen Reader mode. This message only appears on the front page of the menu system.)

     1. Introduction to Hell Ride
     2. Hell Ride Origins
     3. Introduction to Interactive Fiction
     4. Settings
     5. Credits
     6. ----- The Hints Below Contain Out Right Solutions -----
     7. The Parking Lot
     8. The Attractions
     9. The Games
     0. The Carnival Office
     A. Back Stage
     B. Hell Ride
     C. The Electrical Area
     D. Where Are The Fuses?
     E. The Control Room
     F. Collecting Evidence
     G. How Points Are Awarded (Spoilers)

>6
( - ----- The Hints Below Contain Out Right Solutions -----)

Part of the enjoyment of Interactive Fiction comes from the solving of the puzzles. For the most part all Hell Ride puzzles are solved within these hints. The hints are often blunt, especially at the end of a topic. I would, however, encourage you to play for the fun of it and reserve the hints for when you're truly stuck.

------------------------

>[esc]
(If you're using a screen reader, press S to turn on Screen Reader mode. This message only appears on the front page of the menu system.)

     1. Introduction to Hell Ride
     2. Hell Ride Origins
     3. Introduction to Interactive Fiction
     4. Settings
     5. Credits
     6. ----- The Hints Below Contain Out Right Solutions -----
     7. The Parking Lot
     8. The Attractions
     9. The Games
     0. The Carnival Office
     A. Back Stage
     B. Hell Ride
     C. The Electrical Area
     D. Where Are The Fuses?
     E. The Control Room
     F. Collecting Evidence
     G. How Points Are Awarded (Spoilers)

>7
(The Parking Lot)

     1. What about the glove box?
     2. Why can't I leave the parking lot?
     3. What do I do with the string?
     4. Why does my car get towed?

>1
(The Parking Lot - What about the glove box?)

Press H to reveal the first hint.

------------------------

>h
(The Parking Lot - What about the glove box?)

1/4: It's locked.

Press H to reveal another hint.

------------------------

>h
(The Parking Lot - What about the glove box?)

1/4: It's locked.

2/4: Have you tried unlocking it?

Press H to reveal another hint.

------------------------

>h
(The Parking Lot - What about the glove box?)

1/4: It's locked.

2/4: Have you tried unlocking it?

3/4: You need a key.

Press H to reveal another hint.

------------------------

>h
(The Parking Lot - What about the glove box?)

1/4: It's locked.

2/4: Have you tried unlocking it?

3/4: You need a key.

4/4: Look under the car seat.

(You have revealed all the hints on this page.)

------------------------

>[esc]
(The Parking Lot)

     1. What about the glove box?
     2. Why can't I leave the parking lot?
     3. What do I do with the string?
     4. Why does my car get towed?

>2
(The Parking Lot - Why can't I leave the parking lot?)

Press H to reveal the first hint.

------------------------

>h
(The Parking Lot - Why can't I leave the parking lot?)

1/4: Looks like you need something before heading into the carnival.

Press H to reveal another hint.

------------------------

>h
(The Parking Lot - Why can't I leave the parking lot?)

1/4: Looks like you need something before heading into the carnival.

2/4: Looks like you need a parking ticket.

Press H to reveal another hint.

------------------------

>h
(The Parking Lot - Why can't I leave the parking lot?)

1/4: Looks like you need something before heading into the carnival.

2/4: Looks like you need a parking ticket.

3/4: The parking attendant has a parking ticket.

Press H to reveal another hint.

------------------------

>h
(The Parking Lot - Why can't I leave the parking lot?)

1/4: Looks like you need something before heading into the carnival.

2/4: Looks like you need a parking ticket.

3/4: The parking attendant has a parking ticket.

4/4: Buy the parking ticket.

(You have revealed all the hints on this page.)

------------------------

>[esc]
(The Parking Lot)

     1. What about the glove box?
     2. Why can't I leave the parking lot?
     3. What do I do with the string?
     4. Why does my car get towed?

>3
(The Parking Lot - What do I do with the string?)

Press H to reveal the first hint.

------------------------

>h
(The Parking Lot - What do I do with the string?)

1/5: Remember that you know how to macrame.

Press H to reveal another hint.

------------------------

>h
(The Parking Lot - What do I do with the string?)

1/5: Remember that you know how to macrame.

2/5: Isn't macrame the art of tying?

Press H to reveal another hint.

------------------------

>h
(The Parking Lot - What do I do with the string?)

1/5: Remember that you know how to macrame.

2/5: Isn't macrame the art of tying?

3/5: You could tie something to it.

Press H to reveal another hint.

------------------------

>h
(The Parking Lot - What do I do with the string?)

1/5: Remember that you know how to macrame.

2/5: Isn't macrame the art of tying?

3/5: You could tie something to it.

4/5: It looks long enough to reach the fuse in the grate.

Press H to reveal another hint.

------------------------

>h
(The Parking Lot - What do I do with the string?)

1/5: Remember that you know how to macrame.

2/5: Isn't macrame the art of tying?

3/5: You could tie something to it.

4/5: It looks long enough to reach the fuse in the grate.

5/5: Whatever you tied to it wouldn't fall into the grate.

(You have revealed all the hints on this page.)

------------------------

>[esc]
(The Parking Lot)

     1. What about the glove box?
     2. Why can't I leave the parking lot?
     3. What do I do with the string?
     4. Why does my car get towed?

>4
(The Parking Lot - Why does my car get towed?)

Press H to reveal the first hint.

------------------------

>h
(The Parking Lot - Why does my car get towed?)

1/6: Why might your car get towed?

Press H to reveal another hint.

------------------------

>h
(The Parking Lot - Why does my car get towed?)

1/6: Why might your car get towed?

2/6: Is your car parked legally?

Press H to reveal another hint.

------------------------

>h
(The Parking Lot - Why does my car get towed?)

1/6: Why might your car get towed?

2/6: Is your car parked legally?

3/6: Are you sure?

Press H to reveal another hint.

------------------------

>h
(The Parking Lot - Why does my car get towed?)

1/6: Why might your car get towed?

2/6: Is your car parked legally?

3/6: Are you sure?

4/6: What about the parking stub?

Press H to reveal another hint.

------------------------

>h
(The Parking Lot - Why does my car get towed?)

1/6: Why might your car get towed?

2/6: Is your car parked legally?

3/6: Are you sure?

4/6: What about the parking stub?

5/6: The parking attendant knows something about the stub.

Press H to reveal another hint.

------------------------

>h
(The Parking Lot - Why does my car get towed?)

1/6: Why might your car get towed?

2/6: Is your car parked legally?

3/6: Are you sure?

4/6: What about the parking stub?

5/6: The parking attendant knows something about the stub.

6/6: Put the parking stub on the dashboard.

(You have revealed all the hints on this page.)

------------------------

>[esc]
(The Parking Lot)

     1. What about the glove box?
     2. Why can't I leave the parking lot?
     3. What do I do with the string?
     4. Why does my car get towed?

>[esc]
(If you're using a screen reader, press S to turn on Screen Reader mode. This message only appears on the front page of the menu system.)

     1. Introduction to Hell Ride
     2. Hell Ride Origins
     3. Introduction to Interactive Fiction
     4. Settings
     5. Credits
     6. ----- The Hints Below Contain Out Right Solutions -----
     7. The Parking Lot
     8. The Attractions
     9. The Games
     0. The Carnival Office
     A. Back Stage
     B. Hell Ride
     C. The Electrical Area
     D. Where Are The Fuses?
     E. The Control Room
     F. Collecting Evidence
     G. How Points Are Awarded (Spoilers)

>8
(The Attractions)

     1. Can I ride the rides?
     2. Why are tickets so expensive?
     3. The rides are boring.
     4. The Carousel
     5. The Bumper Cars
     6. The Ferris Wheel
     7. The Fortune Teller

>1
(The Attractions - Can I ride the rides?)

Press H to reveal the first hint.

------------------------

>h
(The Attractions - Can I ride the rides?)

1/3: You'll need a ticket.

Press H to reveal another hint.

------------------------

>h
(The Attractions - Can I ride the rides?)

1/3: You'll need a ticket.

2/3: Tickets are expensive though.

Press H to reveal another hint.

------------------------

>h
(The Attractions - Can I ride the rides?)

1/3: You'll need a ticket.

2/3: Tickets are expensive though.

3/3: You can buy tickets at the Ticket Kiosk.

(You have revealed all the hints on this page.)

------------------------

>[esc]
(The Attractions)

     1. Can I ride the rides?
     2. Why are tickets so expensive?
     3. The rides are boring.
     4. The Carousel
     5. The Bumper Cars
     6. The Ferris Wheel
     7. The Fortune Teller

>2
(The Attractions - Why are tickets so expensive?)

Press H to reveal the first hint.

------------------------

>h
(The Attractions - Why are tickets so expensive?)

1/2: What? You were expecting wrist bands?

Press H to reveal another hint.

------------------------

>h
(The Attractions - Why are tickets so expensive?)

1/2: What? You were expecting wrist bands?

2/2: To remind you to spend your money wisely.

(You have revealed all the hints on this page.)

------------------------

>[esc]
(The Attractions)

     1. Can I ride the rides?
     2. Why are tickets so expensive?
     3. The rides are boring.
     4. The Carousel
     5. The Bumper Cars
     6. The Ferris Wheel
     7. The Fortune Teller

>3
(The Attractions - The rides are boring.)

Press H to reveal the first hint.

------------------------

>h
(The Attractions - The rides are boring.)

1/3: Surely not ALL the rides are boring.

Press H to reveal another hint.

------------------------

>h
(The Attractions - The rides are boring.)

1/3: Surely not ALL the rides are boring.

2/3: It's a small carnival, what do you expect?

Press H to reveal another hint.

------------------------

>h
(The Attractions - The rides are boring.)

1/3: Surely not ALL the rides are boring.

2/3: It's a small carnival, what do you expect?

3/3: Have you ridden Hell Ride?

(You have revealed all the hints on this page.)

------------------------

>[esc]
(The Attractions)

     1. Can I ride the rides?
     2. Why are tickets so expensive?
     3. The rides are boring.
     4. The Carousel
     5. The Bumper Cars
     6. The Ferris Wheel
     7. The Fortune Teller

>4
(The Attractions - The Carousel)

Press H to reveal the first hint.

------------------------

>h
(The Attractions - The Carousel)

1/3: What a wonderful childhood memory!

Press H to reveal another hint.

------------------------

>h
(The Attractions - The Carousel)

1/3: What a wonderful childhood memory!

2/3: What animal did you choose to ride?

Press H to reveal another hint.

------------------------

>h
(The Attractions - The Carousel)

1/3: What a wonderful childhood memory!

2/3: What animal did you choose to ride?

3/3: Sometimes I get dizzy on the merry-go-round.

(You have revealed all the hints on this page.)

------------------------

>[esc]
(The Attractions)

     1. Can I ride the rides?
     2. Why are tickets so expensive?
     3. The rides are boring.
     4. The Carousel
     5. The Bumper Cars
     6. The Ferris Wheel
     7. The Fortune Teller

>5
(The Attractions - The Bumper Cars)

Press H to reveal the first hint.

------------------------

>h
(The Attractions - The Bumper Cars)

1/4: The bumper cars are a great way to get your aggression out.

Press H to reveal another hint.

------------------------

>h
(The Attractions - The Bumper Cars)

1/4: The bumper cars are a great way to get your aggression out.

2/4: Great fun crashing into others.

Press H to reveal another hint.

------------------------

>h
(The Attractions - The Bumper Cars)

1/4: The bumper cars are a great way to get your aggression out.

2/4: Great fun crashing into others.

3/4: And getting hit by others.

Press H to reveal another hint.

------------------------

>h
(The Attractions - The Bumper Cars)

1/4: The bumper cars are a great way to get your aggression out.

2/4: Great fun crashing into others.

3/4: And getting hit by others.

4/4: Just enjoy yourself

(You have revealed all the hints on this page.)

------------------------

>[esc]
(The Attractions)

     1. Can I ride the rides?
     2. Why are tickets so expensive?
     3. The rides are boring.
     4. The Carousel
     5. The Bumper Cars
     6. The Ferris Wheel
     7. The Fortune Teller

>6
(The Attractions - The Ferris Wheel)

Press H to reveal the first hint.

------------------------

>h
(The Attractions - The Ferris Wheel)

1/5: Such a relaxing and romantic ride!

Press H to reveal another hint.

------------------------

>h
(The Attractions - The Ferris Wheel)

1/5: Such a relaxing and romantic ride!

2/5: You can see the entire carnival from here.

Press H to reveal another hint.

------------------------

>h
(The Attractions - The Ferris Wheel)

1/5: Such a relaxing and romantic ride!

2/5: You can see the entire carnival from here.

3/5: Do you see anything from the top of the Ferris wheel?

Press H to reveal another hint.

------------------------

>h
(The Attractions - The Ferris Wheel)

1/5: Such a relaxing and romantic ride!

2/5: You can see the entire carnival from here.

3/5: Do you see anything from the top of the Ferris wheel?

4/5: There is a hidden area in the carnival.

Press H to reveal another hint.

------------------------

>h
(The Attractions - The Ferris Wheel)

1/5: Such a relaxing and romantic ride!

2/5: You can see the entire carnival from here.

3/5: Do you see anything from the top of the Ferris wheel?

4/5: There is a hidden area in the carnival.

5/5: It's to the west, behind the Concession Stand.

(You have revealed all the hints on this page.)

------------------------

>[esc]
(The Attractions)

     1. Can I ride the rides?
     2. Why are tickets so expensive?
     3. The rides are boring.
     4. The Carousel
     5. The Bumper Cars
     6. The Ferris Wheel
     7. The Fortune Teller

>7
(The Attractions - The Fortune Teller)

Press H to reveal the first hint.

------------------------

>h
(The Attractions - The Fortune Teller)

1/4: Esmeralda the Fortune Teller is our most popular attraction after Hell Ride.

Press H to reveal another hint.

------------------------

>h
(The Attractions - The Fortune Teller)

1/4: Esmeralda the Fortune Teller is our most popular attraction after Hell Ride.

2/4: You can buy a ticket at the ticket booth.

Press H to reveal another hint.

------------------------

>h
(The Attractions - The Fortune Teller)

1/4: Esmeralda the Fortune Teller is our most popular attraction after Hell Ride.

2/4: You can buy a ticket at the ticket booth.

3/4: Get a tarot reading and learn you fortune.

Press H to reveal another hint.

------------------------

>h
(The Attractions - The Fortune Teller)

1/4: Esmeralda the Fortune Teller is our most popular attraction after Hell Ride.

2/4: You can buy a ticket at the ticket booth.

3/4: Get a tarot reading and learn you fortune.

4/4: Pay attention to any advice she may give you.

(You have revealed all the hints on this page.)

------------------------

>[esc]
(The Attractions)

     1. Can I ride the rides?
     2. Why are tickets so expensive?
     3. The rides are boring.
     4. The Carousel
     5. The Bumper Cars
     6. The Ferris Wheel
     7. The Fortune Teller

>[esc]
(If you're using a screen reader, press S to turn on Screen Reader mode. This message only appears on the front page of the menu system.)

     1. Introduction to Hell Ride
     2. Hell Ride Origins
     3. Introduction to Interactive Fiction
     4. Settings
     5. Credits
     6. ----- The Hints Below Contain Out Right Solutions -----
     7. The Parking Lot
     8. The Attractions
     9. The Games
     0. The Carnival Office
     A. Back Stage
     B. Hell Ride
     C. The Electrical Area
     D. Where Are The Fuses?
     E. The Control Room
     F. Collecting Evidence
     G. How Points Are Awarded (Spoilers)

>9
(The Games)

     1. Are the prizes important?
     2. Why do the games only cost a dime?
     3. I've found a Mercury dime. What is it?
     4. The High Striker Game
     5. The Dime Toss Game
     6. The Pitcher's Mound

>1
(The Games - Are the prizes important?)

Press H to reveal the first hint.

------------------------

>h
(The Games - Are the prizes important?)

1/4: Important? That's a matter of opinion.

Press H to reveal another hint.

------------------------

>h
(The Games - Are the prizes important?)

1/4: Important? That's a matter of opinion.

2/4: A teddy bear to make up with your sweetie?

Press H to reveal another hint.

------------------------

>h
(The Games - Are the prizes important?)

1/4: Important? That's a matter of opinion.

2/4: A teddy bear to make up with your sweetie?

3/4: I'd go with my instincts on this one if I were you.

Press H to reveal another hint.

------------------------

>h
(The Games - Are the prizes important?)

1/4: Important? That's a matter of opinion.

2/4: A teddy bear to make up with your sweetie?

3/4: I'd go with my instincts on this one if I were you.

4/4: Yes, the prizes are important.

(You have revealed all the hints on this page.)

------------------------

>[esc]
(The Games)

     1. Are the prizes important?
     2. Why do the games only cost a dime?
     3. I've found a Mercury dime. What is it?
     4. The High Striker Game
     5. The Dime Toss Game
     6. The Pitcher's Mound

>2
(The Games - Why do the games only cost a dime?)

Press H to reveal the first hint.

------------------------

>h
(The Games - Why do the games only cost a dime?)

1/3: What? You want them to cost a quarter?

Press H to reveal another hint.

------------------------

>h
(The Games - Why do the games only cost a dime?)

1/3: What? You want them to cost a quarter?

2/3: The carnival likes to maintain a link to days past when games cost only a dime?

Press H to reveal another hint.

------------------------

>h
(The Games - Why do the games only cost a dime?)

1/3: What? You want them to cost a quarter?

2/3: The carnival likes to maintain a link to days past when games cost only a dime?

3/3: Just be grateful they don't cost more.

(You have revealed all the hints on this page.)

------------------------

>[esc]
(The Games)

     1. Are the prizes important?
     2. Why do the games only cost a dime?
     3. I've found a Mercury dime. What is it?
     4. The High Striker Game
     5. The Dime Toss Game
     6. The Pitcher's Mound

>3
(The Games - I've found a Mercury dime. What is it?)

Press H to reveal the first hint.

------------------------

>h
(The Games - I've found a Mercury dime. What is it?)

1/4: It's a dime.

Press H to reveal another hint.

------------------------

>h
(The Games - I've found a Mercury dime. What is it?)

1/4: It's a dime.

2/4: It's a Mercury Dime.

Press H to reveal another hint.

------------------------

>h
(The Games - I've found a Mercury dime. What is it?)

1/4: It's a dime.

2/4: It's a Mercury Dime.

3/4: Have you looked at it?

Press H to reveal another hint.

------------------------

>h
(The Games - I've found a Mercury dime. What is it?)

1/4: It's a dime.

2/4: It's a Mercury Dime.

3/4: Have you looked at it?

4/4: It has a weight of 2.50 grams.

(You have revealed all the hints on this page.)

------------------------

* * *

>[esc]
(The Games)

     1. Are the prizes important?
     2. Why do the games only cost a dime?
     3. I've found a Mercury dime. What is it?
     4. The High Striker Game
     5. The Dime Toss Game
     6. The Pitcher's Mound

>4
(The Games - The High Striker Game)

Press H to reveal the first hint.

------------------------

>h
(The Games - The High Striker Game)

1/5: Do you have what it takes? Are you a man or are you a mouse?

Press H to reveal another hint.

------------------------

>h
(The Games - The High Striker Game)

1/5: Do you have what it takes? Are you a man or are you a mouse?

2/5: You have to be pretty strong to ring the bell.

Press H to reveal another hint.

------------------------

>h
(The Games - The High Striker Game)

1/5: Do you have what it takes? Are you a man or are you a mouse?

2/5: You have to be pretty strong to ring the bell.

3/5: You swing with all your might and still can't ring the bell.

Press H to reveal another hint.

------------------------

>h
(The Games - The High Striker Game)

1/5: Do you have what it takes? Are you a man or are you a mouse?

2/5: You have to be pretty strong to ring the bell.

3/5: You swing with all your might and still can't ring the bell.

4/5: Maybe the mallet isn't heavy enough.

Press H to reveal another hint.

------------------------

>h
(The Games - The High Striker Game)

1/5: Do you have what it takes? Are you a man or are you a mouse?

2/5: You have to be pretty strong to ring the bell.

3/5: You swing with all your might and still can't ring the bell.

4/5: Maybe the mallet isn't heavy enough.

5/5: There's a sledgehammer in the Mechanical Room North.

(You have revealed all the hints on this page.)

------------------------

>[esc]
(The Games)

     1. Are the prizes important?
     2. Why do the games only cost a dime?
     3. I've found a Mercury dime. What is it?
     4. The High Striker Game
     5. The Dime Toss Game
     6. The Pitcher's Mound

>5
(The Games - The Dime Toss Game)

Press H to reveal the first hint.

------------------------

>h
(The Games - The Dime Toss Game)

1/6: How hard can it be?

Press H to reveal another hint.

------------------------

>h
(The Games - The Dime Toss Game)

1/6: How hard can it be?

2/6: The dimes keep skidding off the plate.

Press H to reveal another hint.

------------------------

>h
(The Games - The Dime Toss Game)

1/6: How hard can it be?

2/6: The dimes keep skidding off the plate.

3/6: A modern dime weighs 2.268 grams.

Press H to reveal another hint.

------------------------

>h
(The Games - The Dime Toss Game)

1/6: How hard can it be?

2/6: The dimes keep skidding off the plate.

3/6: A modern dime weighs 2.268 grams.

4/6: A Mercury dime weighs 2.500 grams.

Press H to reveal another hint.

------------------------

>h
(The Games - The Dime Toss Game)

1/6: How hard can it be?

2/6: The dimes keep skidding off the plate.

3/6: A modern dime weighs 2.268 grams.

4/6: A Mercury dime weighs 2.500 grams.

5/6: Toss the Mercury dime. It's heavier.

Press H to reveal another hint.

------------------------

>[esc]
(The Games)

     1. Are the prizes important?
     2. Why do the games only cost a dime?
     3. I've found a Mercury dime. What is it?
     4. The High Striker Game
     5. The Dime Toss Game
     6. The Pitcher's Mound

>6
(The Games - The Pitcher's Mound)

Press H to reveal the first hint.

------------------------

>h
(The Games - The Pitcher's Mound)

1/4: You have to choose which bottle to aim at.

Press H to reveal another hint.

------------------------

>h
(The Games - The Pitcher's Mound)

1/4: You have to choose which bottle to aim at.

2/4: The bottles are weighted in such a way as to make you lose.

Press H to reveal another hint.

------------------------

>h
(The Games - The Pitcher's Mound)

1/4: You have to choose which bottle to aim at.

2/4: The bottles are weighted in such a way as to make you lose.

3/4: You have to throw the baseball at the right bottle.

Press H to reveal another hint.

------------------------

>h
(The Games - The Pitcher's Mound)

1/4: You have to choose which bottle to aim at.

2/4: The bottles are weighted in such a way as to make you lose.

3/4: You have to throw the baseball at the right bottle.

4/4: Throw the baseball at bottle 5.

(You have revealed all the hints on this page.)

------------------------

>[esc]
(The Games)

     1. Are the prizes important?
     2. Why do the games only cost a dime?
     3. I've found a Mercury dime. What is it?
     4. The High Striker Game
     5. The Dime Toss Game
     6. The Pitcher's Mound

>[esc]
(If you're using a screen reader, press S to turn on Screen Reader mode. This message only appears on the front page of the menu system.)

     1. Introduction to Hell Ride
     2. Hell Ride Origins
     3. Introduction to Interactive Fiction
     4. Settings
     5. Credits
     6. ----- The Hints Below Contain Out Right Solutions -----
     7. The Parking Lot
     8. The Attractions
     9. The Games
     0. The Carnival Office
     A. Back Stage
     B. Hell Ride
     C. The Electrical Area
     D. Where Are The Fuses?
     E. The Control Room
     F. Collecting Evidence
     G. How Points Are Awarded (Spoilers)

>0
(The Carnival Office)

     1. What about the Invoices?
     2. What about the Filing Cabinet?
     3. What about the Safe?

>1
(The Carnival Office - What about the Invoices?)

Press H to reveal the first hint.

------------------------

>h
(The Carnival Office - What about the Invoices?)

1/3: These are outstanding bills for services rendered and supplies ordered.

Press H to reveal another hint.

------------------------

>h
(The Carnival Office - What about the Invoices?)

1/3: These are outstanding bills for services rendered and supplies ordered.

2/3: Many are marked overdue while a smaller number are stamped "Paid".

Press H to reveal another hint.

------------------------

>h
(The Carnival Office - What about the Invoices?)

1/3: These are outstanding bills for services rendered and supplies ordered.

2/3: Many are marked overdue while a smaller number are stamped "Paid".

3/3: Looks like the Whidbey Amusements might be in some financial trouble.

(You have revealed all the hints on this page.)

------------------------

>[esc]
(The Carnival Office)

     1. What about the Invoices?
     2. What about the Filing Cabinet?
     3. What about the Safe?

>2
(The Carnival Office - What about the Filing Cabinet?)

Press H to reveal the first hint.

------------------------

>h
(The Carnival Office - What about the Filing Cabinet?)

1/3: You need a key to get into it.

Press H to reveal another hint.

------------------------

>h
(The Carnival Office - What about the Filing Cabinet?)

1/3: You need a key to get into it.

2/3: The key is in the safe.

Press H to reveal another hint.

------------------------

>h
(The Carnival Office - What about the Filing Cabinet?)

1/3: You need a key to get into it.

2/3: The key is in the safe.

3/3: There is evidence in the filing cabinet. You should probably examine it.

(You have revealed all the hints on this page.)

------------------------

>[esc]
(The Carnival Office)

     1. What about the Invoices?
     2. What about the Filing Cabinet?
     3. What about the Safe?

>3
(The Carnival Office - What about the Safe?)

Press H to reveal the first hint.

------------------------

>h
(The Carnival Office - What about the Safe?)

1/6: It's locked.

Press H to reveal another hint.

------------------------

>h
(The Carnival Office - What about the Safe?)

1/6: It's locked.

2/6: Looks like it needs a three number combination.

Press H to reveal another hint.

------------------------

>h
(The Carnival Office - What about the Safe?)

1/6: It's locked.

2/6: Looks like it needs a three number combination.

3/6: Have you seen three numbers around anywhere?

Press H to reveal another hint.

------------------------

>h
(The Carnival Office - What about the Safe?)

1/6: It's locked.

2/6: Looks like it needs a three number combination.

3/6: Have you seen three numbers around anywhere?

4/6: Maybe a date

Press H to reveal another hint.

------------------------

>h
(The Carnival Office - What about the Safe?)

1/6: It's locked.

2/6: Looks like it needs a three number combination.

3/6: Have you seen three numbers around anywhere?

4/6: Maybe a date

5/6: Look at the photo.

Press H to reveal another hint.

------------------------

>h
(The Carnival Office - What about the Safe?)

1/6: It's locked.

2/6: Looks like it needs a three number combination.

3/6: Have you seen three numbers around anywhere?

4/6: Maybe a date

5/6: Look at the photo.

6/6: The combination is the date backwards.

(You have revealed all the hints on this page.)

------------------------

>[esc]
(The Carnival Office)

     1. What about the Invoices?
     2. What about the Filing Cabinet?
     3. What about the Safe?

>[esc]
(If you're using a screen reader, press S to turn on Screen Reader mode. This message only appears on the front page of the menu system.)

     1. Introduction to Hell Ride
     2. Hell Ride Origins
     3. Introduction to Interactive Fiction
     4. Settings
     5. Credits
     6. ----- The Hints Below Contain Out Right Solutions -----
     7. The Parking Lot
     8. The Attractions
     9. The Games
     0. The Carnival Office
     A. Back Stage
     B. Hell Ride
     C. The Electrical Area
     D. Where Are The Fuses?
     E. The Control Room
     F. Collecting Evidence
     G. How Points Are Awarded (Spoilers)

>a
(Back Stage)

     1. Why do I get eaten by a grue?
     2. Are the doors important?

>1
(Back Stage - Why do I get eaten by a grue?)

Press H to reveal the first hint.

------------------------

>h
(Back Stage - Why do I get eaten by a grue?)

1/6: Grues love the dark.

Press H to reveal another hint.

------------------------

>h
(Back Stage - Why do I get eaten by a grue?)

1/6: Grues love the dark.

2/6: Do you have a light?

Press H to reveal another hint.

------------------------

>h
(Back Stage - Why do I get eaten by a grue?)

1/6: Grues love the dark.

2/6: Do you have a light?

3/6: Have you looked for one?

Press H to reveal another hint.

------------------------

>h
(Back Stage - Why do I get eaten by a grue?)

1/6: Grues love the dark.

2/6: Do you have a light?

3/6: Have you looked for one?

4/6: There are two in the game.

Press H to reveal another hint.

------------------------

>h
(Back Stage - Why do I get eaten by a grue?)

1/6: Grues love the dark.

2/6: Do you have a light?

3/6: Have you looked for one?

4/6: There are two in the game.

5/6: One is in the Dark Passage.

Press H to reveal another hint.

------------------------

>h
(Back Stage - Why do I get eaten by a grue?)

1/6: Grues love the dark.

2/6: Do you have a light?

3/6: Have you looked for one?

4/6: There are two in the game.

5/6: One is in the Dark Passage.

6/6: The other is in the Little Egypt tent.

(You have revealed all the hints on this page.)

------------------------

>[esc]
(Back Stage)

     1. Why do I get eaten by a grue?
     2. Are the doors important?

>2
(Back Stage - Are the doors important?)

Press H to reveal the first hint.

------------------------

>h
(Back Stage - Are the doors important?)

1/5: Only if you want to know what's on the other side.

Press H to reveal another hint.

------------------------

>h
(Back Stage - Are the doors important?)

1/5: Only if you want to know what's on the other side.

2/5: Have you tried checking what's on the other side?

Press H to reveal another hint.

------------------------

>h
(Back Stage - Are the doors important?)

1/5: Only if you want to know what's on the other side.

2/5: Have you tried checking what's on the other side?

3/5: You'll need a key

Press H to reveal another hint.

------------------------

>h
(Back Stage - Are the doors important?)

1/5: Only if you want to know what's on the other side.

2/5: Have you tried checking what's on the other side?

3/5: You'll need a key

4/5: You have to find it

Press H to reveal another hint.

------------------------

>h
(Back Stage - Are the doors important?)

1/5: Only if you want to know what's on the other side.

2/5: Have you tried checking what's on the other side?

3/5: You'll need a key

4/5: You have to find it

5/5: It's in Electrical Closet One

(You have revealed all the hints on this page.)

------------------------

>[esc]
(Back Stage)

     1. Why do I get eaten by a grue?
     2. Are the doors important?

>[esc]
(If you're using a screen reader, press S to turn on Screen Reader mode. This message only appears on the front page of the menu system.)

     1. Introduction to Hell Ride
     2. Hell Ride Origins
     3. Introduction to Interactive Fiction
     4. Settings
     5. Credits
     6. ----- The Hints Below Contain Out Right Solutions -----
     7. The Parking Lot
     8. The Attractions
     9. The Games
     0. The Carnival Office
     A. Back Stage
     B. Hell Ride
     C. The Electrical Area
     D. Where Are The Fuses?
     E. The Control Room
     F. Collecting Evidence
     G. How Points Are Awarded (Spoilers)

>b
(Hell Ride)

     1. Why do I die?
     2. What about the different rooms

>1
(Hell Ride - Why do I die?)

Press H to reveal the first hint.

------------------------

>h
(Hell Ride - Why do I die?)

1/6: Everybody dies.

Press H to reveal another hint.

------------------------

>h
(Hell Ride - Why do I die?)

1/6: Everybody dies.

2/6: So, you've ridden Hell Ride, huh?

Press H to reveal another hint.

------------------------

>h
(Hell Ride - Why do I die?)

1/6: Everybody dies.

2/6: So, you've ridden Hell Ride, huh?

3/6: Aren't the animatronics and wax figures amazing?

Press H to reveal another hint.

------------------------

>h
(Hell Ride - Why do I die?)

1/6: Everybody dies.

2/6: So, you've ridden Hell Ride, huh?

3/6: Aren't the animatronics and wax figures amazing?

4/6: Did you notice the guillotine rising and falling?

Press H to reveal another hint.

------------------------

>h
(Hell Ride - Why do I die?)

1/6: Everybody dies.

2/6: So, you've ridden Hell Ride, huh?

3/6: Aren't the animatronics and wax figures amazing?

4/6: Did you notice the guillotine rising and falling?

5/6: Did you notice it chop you in half?

Press H to reveal another hint.

------------------------

>h
(Hell Ride - Why do I die?)

1/6: Everybody dies.

2/6: So, you've ridden Hell Ride, huh?

3/6: Aren't the animatronics and wax figures amazing?

4/6: Did you notice the guillotine rising and falling?

5/6: Did you notice it chop you in half?

6/6: You have to disable Hell Ride

(You have revealed all the hints on this page.)

------------------------

>[esc]
(Hell Ride)

     1. Why do I die?
     2. What about the different rooms

>2
(Hell Ride - What about the different rooms)

Press H to reveal the first hint.

------------------------

>h
(Hell Ride - What about the different rooms)

1/5: Everything sure looks realistic.

Press H to reveal another hint.

------------------------

>h
(Hell Ride - What about the different rooms)

1/5: Everything sure looks realistic.

2/5: Aren't the animatronics and wax figures amazing?

Press H to reveal another hint.

------------------------

>h
(Hell Ride - What about the different rooms)

1/5: Everything sure looks realistic.

2/5: Aren't the animatronics and wax figures amazing?

3/5: Each room shows a different manner of punishment.

Press H to reveal another hint.

------------------------

>h
(Hell Ride - What about the different rooms)

1/5: Everything sure looks realistic.

2/5: Aren't the animatronics and wax figures amazing?

3/5: Each room shows a different manner of punishment.

4/5: There's the Stocks, the Gallows, the Stake, the Dungeon, and the Guillotine.

Press H to reveal another hint.

------------------------

>h
(Hell Ride - What about the different rooms)

1/5: Everything sure looks realistic.

2/5: Aren't the animatronics and wax figures amazing?

3/5: Each room shows a different manner of punishment.

4/5: There's the Stocks, the Gallows, the Stake, the Dungeon, and the Guillotine.

5/5: Just your typical ride in the dark.

(You have revealed all the hints on this page.)

------------------------

>[esc]
(Hell Ride)

     1. Why do I die?
     2. What about the different rooms

>[esc]
(If you're using a screen reader, press S to turn on Screen Reader mode. This message only appears on the front page of the menu system.)

     1. Introduction to Hell Ride
     2. Hell Ride Origins
     3. Introduction to Interactive Fiction
     4. Settings
     5. Credits
     6. ----- The Hints Below Contain Out Right Solutions -----
     7. The Parking Lot
     8. The Attractions
     9. The Games
     0. The Carnival Office
     A. Back Stage
     B. Hell Ride
     C. The Electrical Area
     D. Where Are The Fuses?
     E. The Control Room
     F. Collecting Evidence
     G. How Points Are Awarded (Spoilers)

>c
(The Electrical Area)

     1. What's going on in the Electrical Room?
     2. What about the electrical panels?
     3. Are the fuses important?

>1
(The Electrical Area - What's going on in the Electrical Room?)

Press H to reveal the first hint.

------------------------

>h
(The Electrical Area - What's going on in the Electrical Room?)

1/7: There are exits in all directions

Press H to reveal another hint.

------------------------

>h
(The Electrical Area - What's going on in the Electrical Room?)

1/7: There are exits in all directions

2/7: Can you go in the direction you intend?

Press H to reveal another hint.

------------------------

>h
(The Electrical Area - What's going on in the Electrical Room?)

1/7: There are exits in all directions

2/7: Can you go in the direction you intend?

3/7: The room is electromagnetic.

Press H to reveal another hint.

------------------------

>h
(The Electrical Area - What's going on in the Electrical Room?)

1/7: There are exits in all directions

2/7: Can you go in the direction you intend?

3/7: The room is electromagnetic.

4/7: Maybe that's causing the problem.

Press H to reveal another hint.

------------------------

>h
(The Electrical Area - What's going on in the Electrical Room?)

1/7: There are exits in all directions

2/7: Can you go in the direction you intend?

3/7: The room is electromagnetic.

4/7: Maybe that's causing the problem.

5/7: You end up back in the Generator Room every time you try to move.

Press H to reveal another hint.

------------------------

>h
(The Electrical Area - What's going on in the Electrical Room?)

1/7: There are exits in all directions

2/7: Can you go in the direction you intend?

3/7: The room is electromagnetic.

4/7: Maybe that's causing the problem.

5/7: You end up back in the Generator Room every time you try to move.

6/7: Maybe you can make it so it's not electromagnetic.

Press H to reveal another hint.

------------------------

>h
(The Electrical Area - What's going on in the Electrical Room?)

1/7: There are exits in all directions

2/7: Can you go in the direction you intend?

3/7: The room is electromagnetic.

4/7: Maybe that's causing the problem.

5/7: You end up back in the Generator Room every time you try to move.

6/7: Maybe you can make it so it's not electromagnetic.

7/7: Turn off the big switch in the Control Room.

(You have revealed all the hints on this page.)

------------------------

>[esc]
(The Electrical Area)

     1. What's going on in the Electrical Room?
     2. What about the electrical panels?
     3. Are the fuses important?

>2
(The Electrical Area - What about the electrical panels?)

Press H to reveal the first hint.

------------------------

>h
(The Electrical Area - What about the electrical panels?)

1/4: There's a socket, a switch, and an indicator in each one.

Press H to reveal another hint.

------------------------

>h
(The Electrical Area - What about the electrical panels?)

1/4: There's a socket, a switch, and an indicator in each one.

2/4: You could probably put something in the socket.

Press H to reveal another hint.

------------------------

>h
(The Electrical Area - What about the electrical panels?)

1/4: There's a socket, a switch, and an indicator in each one.

2/4: You could probably put something in the socket.

3/4: Looks like a fuse will fit in the socket.

Press H to reveal another hint.

------------------------

>h
(The Electrical Area - What about the electrical panels?)

1/4: There's a socket, a switch, and an indicator in each one.

2/4: You could probably put something in the socket.

3/4: Looks like a fuse will fit in the socket.

4/4: I'd put a fuse in the socket and flip the switch.

(You have revealed all the hints on this page.)

------------------------

>[esc]
(The Electrical Area)

     1. What's going on in the Electrical Room?
     2. What about the electrical panels?
     3. Are the fuses important?

>3
(The Electrical Area - Are the fuses important?)

Press H to reveal the first hint.

------------------------

>h
(The Electrical Area - Are the fuses important?)

1/4: Yes.

Press H to reveal another hint.

------------------------

>h
(The Electrical Area - Are the fuses important?)

1/4: Yes.

2/4: They come in pretty colors.

Press H to reveal another hint.

------------------------

>h
(The Electrical Area - Are the fuses important?)

1/4: Yes.

2/4: They come in pretty colors.

3/4: Have you seen those colors anywhere else?

Press H to reveal another hint.

------------------------

>h
(The Electrical Area - Are the fuses important?)

1/4: Yes.

2/4: They come in pretty colors.

3/4: Have you seen those colors anywhere else?

4/4: Have you put a fuse in a socket?

(You have revealed all the hints on this page.)

------------------------

>[esc]
(The Electrical Area)

     1. What's going on in the Electrical Room?
     2. What about the electrical panels?
     3. Are the fuses important?

>[esc]
(If you're using a screen reader, press S to turn on Screen Reader mode. This message only appears on the front page of the menu system.)

     1. Introduction to Hell Ride
     2. Hell Ride Origins
     3. Introduction to Interactive Fiction
     4. Settings
     5. Credits
     6. ----- The Hints Below Contain Out Right Solutions -----
     7. The Parking Lot
     8. The Attractions
     9. The Games
     0. The Carnival Office
     A. Back Stage
     B. Hell Ride
     C. The Electrical Area
     D. Where Are The Fuses?
     E. The Control Room
     F. Collecting Evidence
     G. How Points Are Awarded (Spoilers)

>d
(Where Are The Fuses?)

     1. Where's the Aqua fuse?
     2. Where's the Crimson fuse?
     3. Where's the Emerald fuse?
     4. Where's the Gray fuse?
     5. Where's the Indigo fuse?
     6. Where's the Khaki fuse?
     7. Where's the Magenta fuse?
     8. Where's the Orange fuse?
     9. Where's the Quartz fuse?

>1
(Where Are The Fuses? - Where's the Aqua fuse?)

Press H to reveal the first hint.

------------------------

>h
(Where Are The Fuses? - Where's the Aqua fuse?)

1/3: It's in the Hell Ride Exit.

Press H to reveal another hint.

------------------------

>h
(Where Are The Fuses? - Where's the Aqua fuse?)

1/3: It's in the Hell Ride Exit.

2/3: It's in the merchandise stand.

Press H to reveal another hint.

------------------------

>h
(Where Are The Fuses? - Where's the Aqua fuse?)

1/3: It's in the Hell Ride Exit.

2/3: It's in the merchandise stand.

3/3: Buy the Aqua fuse.

(You have revealed all the hints on this page.)

------------------------

>[esc]
(Where Are The Fuses?)

     1. Where's the Aqua fuse?
     2. Where's the Crimson fuse?
     3. Where's the Emerald fuse?
     4. Where's the Gray fuse?
     5. Where's the Indigo fuse?
     6. Where's the Khaki fuse?
     7. Where's the Magenta fuse?
     8. Where's the Orange fuse?
     9. Where's the Quartz fuse?

>2
(Where Are The Fuses? - Where's the Crimson fuse?)

Press H to reveal the first hint.

------------------------

>h
(Where Are The Fuses? - Where's the Crimson fuse?)

1/1: It's a prize at the Pitcher's Mound.

(This page has just the one hint.)

------------------------

* * *

>[esc]
(Where Are The Fuses?)

     1. Where's the Aqua fuse?
     2. Where's the Crimson fuse?
     3. Where's the Emerald fuse?
     4. Where's the Gray fuse?
     5. Where's the Indigo fuse?
     6. Where's the Khaki fuse?
     7. Where's the Magenta fuse?
     8. Where's the Orange fuse?
     9. Where's the Quartz fuse?

>3
(Where Are The Fuses? - Where's the Emerald fuse?)

Press H to reveal the first hint.

------------------------

>h
(Where Are The Fuses? - Where's the Emerald fuse?)

1/8: It's in the Mechanical Room South.

Press H to reveal another hint.

------------------------

>h
(Where Are The Fuses? - Where's the Emerald fuse?)

1/8: It's in the Mechanical Room South.

2/8: It's in the grate.

Press H to reveal another hint.

------------------------

>h
(Where Are The Fuses? - Where's the Emerald fuse?)

1/8: It's in the Mechanical Room South.

2/8: It's in the grate.

3/8: Is there anyway to extend your reach?

Press H to reveal another hint.

------------------------

>h
(Where Are The Fuses? - Where's the Emerald fuse?)

1/8: It's in the Mechanical Room South.

2/8: It's in the grate.

3/8: Is there anyway to extend your reach?

4/8: The string looks long enough.

Press H to reveal another hint.

------------------------

>h
(Where Are The Fuses? - Where's the Emerald fuse?)

1/8: It's in the Mechanical Room South.

2/8: It's in the grate.

3/8: Is there anyway to extend your reach?

4/8: The string looks long enough.

5/8: Have you tied anything to the string?

Press H to reveal another hint.

------------------------

>h
(Where Are The Fuses? - Where's the Emerald fuse?)

1/8: It's in the Mechanical Room South.

2/8: It's in the grate.

3/8: Is there anyway to extend your reach?

4/8: The string looks long enough.

5/8: Have you tied anything to the string?

6/8: Maybe the fuse would stick to the bubblegum or the horseshoe magnet.

Press H to reveal another hint.

------------------------

>h
(Where Are The Fuses? - Where's the Emerald fuse?)

1/8: It's in the Mechanical Room South.

2/8: It's in the grate.

3/8: Is there anyway to extend your reach?

4/8: The string looks long enough.

5/8: Have you tied anything to the string?

6/8: Maybe the fuse would stick to the bubblegum or the horseshoe magnet.

7/8: Chew the bubblegum first.

Press H to reveal another hint.

------------------------

>h
(Where Are The Fuses? - Where's the Emerald fuse?)

1/8: It's in the Mechanical Room South.

2/8: It's in the grate.

3/8: Is there anyway to extend your reach?

4/8: The string looks long enough.

5/8: Have you tied anything to the string?

6/8: Maybe the fuse would stick to the bubblegum or the horseshoe magnet.

7/8: Chew the bubblegum first.

8/8: Put the bubblegum (or the horseshoe magnet) in the grate.

(You have revealed all the hints on this page.)

------------------------

>[esc]
(Where Are The Fuses?)

     1. Where's the Aqua fuse?
     2. Where's the Crimson fuse?
     3. Where's the Emerald fuse?
     4. Where's the Gray fuse?
     5. Where's the Indigo fuse?
     6. Where's the Khaki fuse?
     7. Where's the Magenta fuse?
     8. Where's the Orange fuse?
     9. Where's the Quartz fuse?

>4
(Where Are The Fuses? - Where's the Gray fuse?)

Press H to reveal the first hint.

------------------------

>h
(Where Are The Fuses? - Where's the Gray fuse?)

1/3: It's in the Bumper Cars attraction.

Press H to reveal another hint.

------------------------

>h
(Where Are The Fuses? - Where's the Gray fuse?)

1/3: It's in the Bumper Cars attraction.

2/3: The attendant has it.

Press H to reveal another hint.

------------------------

>h
(Where Are The Fuses? - Where's the Gray fuse?)

1/3: It's in the Bumper Cars attraction.

2/3: The attendant has it.

3/3: Bring him a wrench and he'll give you the fuse.

(You have revealed all the hints on this page.)

------------------------

>[esc]
(Where Are The Fuses?)

     1. Where's the Aqua fuse?
     2. Where's the Crimson fuse?
     3. Where's the Emerald fuse?
     4. Where's the Gray fuse?
     5. Where's the Indigo fuse?
     6. Where's the Khaki fuse?
     7. Where's the Magenta fuse?
     8. Where's the Orange fuse?
     9. Where's the Quartz fuse?

>5
(Where Are The Fuses? - Where's the Indigo fuse?)

Press H to reveal the first hint.

------------------------

>h
(Where Are The Fuses? - Where's the Indigo fuse?)

1/3: It's locked up tight.

Press H to reveal another hint.

------------------------

>h
(Where Are The Fuses? - Where's the Indigo fuse?)

1/3: It's locked up tight.

2/3: It's in the Carnival Office.

Press H to reveal another hint.

------------------------

>h
(Where Are The Fuses? - Where's the Indigo fuse?)

1/3: It's locked up tight.

2/3: It's in the Carnival Office.

3/3: It's in the safe.

(You have revealed all the hints on this page.)

------------------------

>[esc]
(Where Are The Fuses?)

     1. Where's the Aqua fuse?
     2. Where's the Crimson fuse?
     3. Where's the Emerald fuse?
     4. Where's the Gray fuse?
     5. Where's the Indigo fuse?
     6. Where's the Khaki fuse?
     7. Where's the Magenta fuse?
     8. Where's the Orange fuse?
     9. Where's the Quartz fuse?

>6
(Where Are The Fuses? - Where's the Khaki fuse?)

Press H to reveal the first hint.

------------------------

>h
(Where Are The Fuses? - Where's the Khaki fuse?)

1/5: In a secret location.

Press H to reveal another hint.

------------------------

>h
(Where Are The Fuses? - Where's the Khaki fuse?)

1/5: In a secret location.

2/5: Have you ridden the Ferris Wheel?

Press H to reveal another hint.

------------------------

>h
(Where Are The Fuses? - Where's the Khaki fuse?)

1/5: In a secret location.

2/5: Have you ridden the Ferris Wheel?

3/5: Can you see anything from the top of the Ferris Wheel?

Press H to reveal another hint.

------------------------

>h
(Where Are The Fuses? - Where's the Khaki fuse?)

1/5: In a secret location.

2/5: Have you ridden the Ferris Wheel?

3/5: Can you see anything from the top of the Ferris Wheel?

4/5: It's behind the Concession Stand to the west.

Press H to reveal another hint.

------------------------

>h
(Where Are The Fuses? - Where's the Khaki fuse?)

1/5: In a secret location.

2/5: Have you ridden the Ferris Wheel?

3/5: Can you see anything from the top of the Ferris Wheel?

4/5: It's behind the Concession Stand to the west.

5/5: Look in the trash can.

(You have revealed all the hints on this page.)

------------------------

>[esc]
(Where Are The Fuses?)

     1. Where's the Aqua fuse?
     2. Where's the Crimson fuse?
     3. Where's the Emerald fuse?
     4. Where's the Gray fuse?
     5. Where's the Indigo fuse?
     6. Where's the Khaki fuse?
     7. Where's the Magenta fuse?
     8. Where's the Orange fuse?
     9. Where's the Quartz fuse?

>7
(Where Are The Fuses? - Where's the Magenta fuse?)

Press H to reveal the first hint.

------------------------

>h
(Where Are The Fuses? - Where's the Magenta fuse?)

1/1: It's a prize at the High Striker game.

(This page has just the one hint.)

------------------------

>[esc]
(Where Are The Fuses?)

     1. Where's the Aqua fuse?
     2. Where's the Crimson fuse?
     3. Where's the Emerald fuse?
     4. Where's the Gray fuse?
     5. Where's the Indigo fuse?
     6. Where's the Khaki fuse?
     7. Where's the Magenta fuse?
     8. Where's the Orange fuse?
     9. Where's the Quartz fuse?

>8
(Where Are The Fuses? - Where's the Orange fuse?)

Press H to reveal the first hint.

------------------------

>h
(Where Are The Fuses? - Where's the Orange fuse?)

1/1: It's a prize at the Dime Toss game.

(This page has just the one hint.)

------------------------

>[esc]
(Where Are The Fuses?)

     1. Where's the Aqua fuse?
     2. Where's the Crimson fuse?
     3. Where's the Emerald fuse?
     4. Where's the Gray fuse?
     5. Where's the Indigo fuse?
     6. Where's the Khaki fuse?
     7. Where's the Magenta fuse?
     8. Where's the Orange fuse?
     9. Where's the Quartz fuse?

>9
(Where Are The Fuses? - Where's the Quartz fuse?)

Press H to reveal the first hint.

------------------------

>h
(Where Are The Fuses? - Where's the Quartz fuse?)

1/2: It's in the Stake Room.

Press H to reveal another hint.

------------------------

>h
(Where Are The Fuses? - Where's the Quartz fuse?)

1/2: It's in the Stake Room.

2/2: It's in the pyre.

(You have revealed all the hints on this page.)

------------------------

>[esc]
(Where Are The Fuses?)

     1. Where's the Aqua fuse?
     2. Where's the Crimson fuse?
     3. Where's the Emerald fuse?
     4. Where's the Gray fuse?
     5. Where's the Indigo fuse?
     6. Where's the Khaki fuse?
     7. Where's the Magenta fuse?
     8. Where's the Orange fuse?
     9. Where's the Quartz fuse?

>[esc]
(If you're using a screen reader, press S to turn on Screen Reader mode. This message only appears on the front page of the menu system.)

     1. Introduction to Hell Ride
     2. Hell Ride Origins
     3. Introduction to Interactive Fiction
     4. Settings
     5. Credits
     6. ----- The Hints Below Contain Out Right Solutions -----
     7. The Parking Lot
     8. The Attractions
     9. The Games
     0. The Carnival Office
     A. Back Stage
     B. Hell Ride
     C. The Electrical Area
     D. Where Are The Fuses?
     E. The Control Room
     F. Collecting Evidence
     G. How Points Are Awarded (Spoilers)

>e
(The Control Room)

     1. Tell me about the big switch.
     2. What about the control panels?

>1
(The Control Room - Tell me about the big switch.)

Press H to reveal the first hint.

------------------------

>h
(The Control Room - Tell me about the big switch.)

1/7: It's big

Press H to reveal another hint.

------------------------

>h
(The Control Room - Tell me about the big switch.)

1/7: It's big

2/7: Very big

Press H to reveal another hint.

------------------------

>h
(The Control Room - Tell me about the big switch.)

1/7: It's big

2/7: Very big

3/7: It's in the Control Room.

Press H to reveal another hint.

------------------------

>h
(The Control Room - Tell me about the big switch.)

1/7: It's big

2/7: Very big

3/7: It's in the Control Room.

4/7: Did you read the label?

Press H to reveal another hint.

------------------------

>h
(The Control Room - Tell me about the big switch.)

1/7: It's big

2/7: Very big

3/7: It's in the Control Room.

4/7: Did you read the label?

5/7: Have you tried turning the big switch off?

Press H to reveal another hint.

------------------------

>h
(The Control Room - Tell me about the big switch.)

1/7: It's big

2/7: Very big

3/7: It's in the Control Room.

4/7: Did you read the label?

5/7: Have you tried turning the big switch off?

6/7: Did you die because your hands were unprotected?

Press H to reveal another hint.

------------------------

>h
(The Control Room - Tell me about the big switch.)

1/7: It's big

2/7: Very big

3/7: It's in the Control Room.

4/7: Did you read the label?

5/7: Have you tried turning the big switch off?

6/7: Did you die because your hands were unprotected?

7/7: Try wearing the gloves.

(You have revealed all the hints on this page.)

------------------------

>[esc]
(The Control Room)

     1. Tell me about the big switch.
     2. What about the control panels?

>2
(The Control Room - What about the control panels?)

Press H to reveal the first hint.

------------------------

>h
(The Control Room - What about the control panels?)

1/9: There's a dial, a button, and a light in each one.

Press H to reveal another hint.

------------------------

>h
(The Control Room - What about the control panels?)

1/9: There's a dial, a button, and a light in each one.

2/9: These are pretty colors.

Press H to reveal another hint.

------------------------

>h
(The Control Room - What about the control panels?)

1/9: There's a dial, a button, and a light in each one.

2/9: These are pretty colors.

3/9: Have you seen these colors anywhere else?

Press H to reveal another hint.

------------------------

>h
(The Control Room - What about the control panels?)

1/9: There's a dial, a button, and a light in each one.

2/9: These are pretty colors.

3/9: Have you seen these colors anywhere else?

4/9: Try spinning the dials.

Press H to reveal another hint.

------------------------

>h
(The Control Room - What about the control panels?)

1/9: There's a dial, a button, and a light in each one.

2/9: These are pretty colors.

3/9: Have you seen these colors anywhere else?

4/9: Try spinning the dials.

5/9: Spin the dials to the right number.

Press H to reveal another hint.

------------------------

>h
(The Control Room - What about the control panels?)

1/9: There's a dial, a button, and a light in each one.

2/9: These are pretty colors.

3/9: Have you seen these colors anywhere else?

4/9: Try spinning the dials.

5/9: Spin the dials to the right number.

6/9: Is there a number that corresponds to each color?

Press H to reveal another hint.

------------------------

>h
(The Control Room - What about the control panels?)

1/9: There's a dial, a button, and a light in each one.

2/9: These are pretty colors.

3/9: Have you seen these colors anywhere else?

4/9: Try spinning the dials.

5/9: Spin the dials to the right number.

6/9: Is there a number that corresponds to each color?

7/9: Aqua = A = 1, Crimson = C = 3, etc.

Press H to reveal another hint.

------------------------

>h
(The Control Room - What about the control panels?)

1/9: There's a dial, a button, and a light in each one.

2/9: These are pretty colors.

3/9: Have you seen these colors anywhere else?

4/9: Try spinning the dials.

5/9: Spin the dials to the right number.

6/9: Is there a number that corresponds to each color?

7/9: Aqua = A = 1, Crimson = C = 3, etc.

8/9: The colors correspond to the scenes in Hell Ride.

Press H to reveal another hint.

------------------------

>h
(The Control Room - What about the control panels?)

1/9: There's a dial, a button, and a light in each one.

2/9: These are pretty colors.

3/9: Have you seen these colors anywhere else?

4/9: Try spinning the dials.

5/9: Spin the dials to the right number.

6/9: Is there a number that corresponds to each color?

7/9: Aqua = A = 1, Crimson = C = 3, etc.

8/9: The colors correspond to the scenes in Hell Ride.

9/9: Push the indigo button.

(You have revealed all the hints on this page.)

------------------------

>[esc]
(The Control Room)

     1. Tell me about the big switch.
     2. What about the control panels?

>[esc]
(If you're using a screen reader, press S to turn on Screen Reader mode. This message only appears on the front page of the menu system.)

     1. Introduction to Hell Ride
     2. Hell Ride Origins
     3. Introduction to Interactive Fiction
     4. Settings
     5. Credits
     6. ----- The Hints Below Contain Out Right Solutions -----
     7. The Parking Lot
     8. The Attractions
     9. The Games
     0. The Carnival Office
     A. Back Stage
     B. Hell Ride
     C. The Electrical Area
     D. Where Are The Fuses?
     E. The Control Room
     F. Collecting Evidence
     G. How Points Are Awarded (Spoilers)

>f
(Collecting Evidence)

     1. Show Evidence
     2. How is evidence calculated?
     3. How to make an arrest
     4. Evidence regarding Accidents
     5. Evidence regarding Mr Whidbey
     6. Evidence regarding Past Due Invoices
     7. Evidence regarding Fuses
     8. Evidence regarding Insurance

>1
(Collecting Evidence - Show Evidence)

Type SHOW EVIDENCE  or READ NOTEBOOK to see the evidence collected so far.

------------------------

>[esc]
(Collecting Evidence)

     1. Show Evidence
     2. How is evidence calculated?
     3. How to make an arrest
     4. Evidence regarding Accidents
     5. Evidence regarding Mr Whidbey
     6. Evidence regarding Past Due Invoices
     7. Evidence regarding Fuses
     8. Evidence regarding Insurance

>2
(Collecting Evidence - How is evidence calculated?)

Press H to reveal the first hint.

------------------------

>h
(Collecting Evidence - How is evidence calculated?)

1/5: Each piece of evidence is weighted according to its importance.

Press H to reveal another hint.

------------------------

>h
(Collecting Evidence - How is evidence calculated?)

1/5: Each piece of evidence is weighted according to its importance.

2/5: The weights are added together to get the total evidence.

Press H to reveal another hint.

------------------------

>h
(Collecting Evidence - How is evidence calculated?)

1/5: Each piece of evidence is weighted according to its importance.

2/5: The weights are added together to get the total evidence.

3/5: If the total evidence is 0 to 30 then you don' have enough evidence for an arrest.

Press H to reveal another hint.

------------------------

>h
(Collecting Evidence - How is evidence calculated?)

1/5: Each piece of evidence is weighted according to its importance.

2/5: The weights are added together to get the total evidence.

3/5: If the total evidence is 0 to 30 then you don' have enough evidence for an arrest.

4/5: If the total evidence is 31 to 75 then you have enough evidence to press charges and go to trial.

Press H to reveal another hint.

------------------------

>h
(Collecting Evidence - How is evidence calculated?)

1/5: Each piece of evidence is weighted according to its importance.

2/5: The weights are added together to get the total evidence.

3/5: If the total evidence is 0 to 30 then you don' have enough evidence for an arrest.

4/5: If the total evidence is 31 to 75 then you have enough evidence to press charges and go to trial.

5/5: If the total evidence is greater than or equal to 76 then you have enough evidence for a conviction.

(You have revealed all the hints on this page.)

------------------------

>[esc]
(Collecting Evidence)

     1. Show Evidence
     2. How is evidence calculated?
     3. How to make an arrest
     4. Evidence regarding Accidents
     5. Evidence regarding Mr Whidbey
     6. Evidence regarding Past Due Invoices
     7. Evidence regarding Fuses
     8. Evidence regarding Insurance

>3
(Collecting Evidence - How to make an arrest)

An opportunity to make accusations and confront people will present itself.

------------------------

>[esc]
(Collecting Evidence)

     1. Show Evidence
     2. How is evidence calculated?
     3. How to make an arrest
     4. Evidence regarding Accidents
     5. Evidence regarding Mr Whidbey
     6. Evidence regarding Past Due Invoices
     7. Evidence regarding Fuses
     8. Evidence regarding Insurance

>4
(Collecting Evidence - Evidence regarding Accidents)

Ask people about the attractions to learn about accidents and mishaps around the carnival.

------------------------

>[esc]
(Collecting Evidence)

     1. Show Evidence
     2. How is evidence calculated?
     3. How to make an arrest
     4. Evidence regarding Accidents
     5. Evidence regarding Mr Whidbey
     6. Evidence regarding Past Due Invoices
     7. Evidence regarding Fuses
     8. Evidence regarding Insurance

>5
(Collecting Evidence - Evidence regarding Mr Whidbey)

Ask people about Mr Whidbey to learn more. Listen to Mr Whidbey's telephone conversation.

------------------------

>[esc]
(Collecting Evidence)

     1. Show Evidence
     2. How is evidence calculated?
     3. How to make an arrest
     4. Evidence regarding Accidents
     5. Evidence regarding Mr Whidbey
     6. Evidence regarding Past Due Invoices
     7. Evidence regarding Fuses
     8. Evidence regarding Insurance

>6
(Collecting Evidence - Evidence regarding Past Due Invoices)

Ask about or show people the past due invoices.

------------------------

>[esc]
(Collecting Evidence)

     1. Show Evidence
     2. How is evidence calculated?
     3. How to make an arrest
     4. Evidence regarding Accidents
     5. Evidence regarding Mr Whidbey
     6. Evidence regarding Past Due Invoices
     7. Evidence regarding Fuses
     8. Evidence regarding Insurance

>7
(Collecting Evidence - Evidence regarding Fuses)

Ask about or show people the fuses.

------------------------

>[esc]
(Collecting Evidence)

     1. Show Evidence
     2. How is evidence calculated?
     3. How to make an arrest
     4. Evidence regarding Accidents
     5. Evidence regarding Mr Whidbey
     6. Evidence regarding Past Due Invoices
     7. Evidence regarding Fuses
     8. Evidence regarding Insurance

>8
(Collecting Evidence - Evidence regarding Insurance)

Ask about or show people the insurance policy and cashier's check.

------------------------

>[esc]
(Collecting Evidence)

     1. Show Evidence
     2. How is evidence calculated?
     3. How to make an arrest
     4. Evidence regarding Accidents
     5. Evidence regarding Mr Whidbey
     6. Evidence regarding Past Due Invoices
     7. Evidence regarding Fuses
     8. Evidence regarding Insurance

>[esc]
(If you're using a screen reader, press S to turn on Screen Reader mode. This message only appears on the front page of the menu system.)

     1. Introduction to Hell Ride
     2. Hell Ride Origins
     3. Introduction to Interactive Fiction
     4. Settings
     5. Credits
     6. ----- The Hints Below Contain Out Right Solutions -----
     7. The Parking Lot
     8. The Attractions
     9. The Games
     0. The Carnival Office
     A. Back Stage
     B. Hell Ride
     C. The Electrical Area
     D. Where Are The Fuses?
     E. The Control Room
     F. Collecting Evidence
     G. How Points Are Awarded (Spoilers)

>g
( - How Points Are Awarded (Spoilers))

Note that not all of these points are awarded. Some are mutually exclusive of others.

  5 - Eating the blueberries:                  
  5 - Finding the coins and keys:              
  5 - Buying the Hell Ride ticket:             
  5 - Wearing the sheer veil:                  
  5 - Finding the Cash 'N' Carry invoice:      
  5 - Finding the Oriental Trading invoice:    
  5 - Finding the Frank's Market invoice:      
  5 - Finding the Mystic Industries invoice:   
  5 - Finding the insurance policy:            
  5 - Acquiring the brass key:                 
10 - Acquiring the cashier's check stub:      
  5 - Acquiring the pliers:                    
  5 - Taking the lantern:                      
  5 - Taking the flashlight:                   
  5 - Taking the Mercury dime:                 
  5 - Turning off the big switch:              
  5 - Finding the Control Room:                
  5 - Finding the Dark Passage:                
  5 - Bringing the wrench to the Bumper Cars:  
10 - Acquiring the Aqua fuse:                 
10 - Acquiring the Emerald fuse:              
10 - Acquiring the Gray fuse:                 
10 - Acquiring the Indigo fuse:               
10 - Acquiring the Khaki fuse:                
  5 - Flipping the Aqua switch:                
  5 - Flipping the Crimson switch:             
  5 - Flipping the Emerald switch:             
  5 - Flipping the Gray switch:                
  5 - Flipping the Indigo switch:              
  5 - Flipping the Khaki switch:               
  5 - Winning the teddy bear:                  
  5 - Winning the knock-off Swiss Army knife:  
  5 - Winning the poster of Taylor Swift:      
  5 - Winning the Magenta fuse:                
  5 - Winning the stuffed monkey:              
  5 - Winning the Orange fuse:                 
  5 - Winning the poster of Billie Eilish:     
  5 - Winning the horseshoe magnet:            
10 - Winning the Crimson fuse:                
  5 - Winning the a plush donkey:              
  5 - Winning the goldfish in a bowl:          
  5 - Winning the poster of Lourde:            

------------------------

>[esc]
(If you're using a screen reader, press S to turn on Screen Reader mode. This message only appears on the front page of the menu system.)

     1. Introduction to Hell Ride
     2. Hell Ride Origins
     3. Introduction to Interactive Fiction
     4. Settings
     5. Credits
     6. ----- The Hints Below Contain Out Right Solutions -----
     7. The Parking Lot
     8. The Attractions
     9. The Games
     0. The Carnival Office
     A. Back Stage
     B. Hell Ride
     C. The Electrical Area
     D. Where Are The Fuses?
     E. The Control Room
     F. Collecting Evidence
     G. How Points Are Awarded (Spoilers)

>[esc]
Parking Lot
The lot stretches across an open field, gravel crunching under the tires of arriving cars. Floodlights and the carnival's colorful glow light the area, accompanied by distant laughter, music, and the hum of rides.

Cars park haphazardly, guided by makeshift signs and fluttering flags. Families and visitors mingle, some lingering in vehicles, preparing for the chilly evening ahead. Shadows from encroaching trees are pierced by the occasional flash of a flashlight. At the entrance, an attendant collects fees in a weathered booth, making change from a cash box.

Puddles from recent rain shimmer under the lights, while patches of mud cling to shoes. In the distance, RVs and trailers sit quietly, their occupants watching the Ferris wheel turn against the evening sky. The lot serves as a transition between the mundane and the magical world inside the carnival.

The midway is to the south. There is a blueberry bush here. There are blueberries on the bush.

Your car is here. It's a bit of a beater. Inside the car, you can see the glove box, the seat, the rear view mirror, the ignition, and the dashboard.

The attendant has a parking ticket. The price of a parking is $5.00.

You can see a parking attendant here.

* * *

>4
(Settings)

     1: The room description style is currently VERBOSE
     2: Score notification is currently ON
     3: Image presentation is currently OFF
     4: Transcript is currently OFF
     5: Story mode is currently OFF

>5
(Settings)

     1: The room description style is currently VERBOSE
     2: Score notification is currently ON
     3: Image presentation is currently OFF
     4: Transcript is currently OFF
     5: Story mode is currently ON

>[esc]
(If you're using a screen reader, press S to turn on Screen Reader mode. This message only appears on the front page of the menu system.)

     1. Introduction to Hell Ride
     2. Hell Ride Origins
     3. Introduction to Interactive Fiction
     4. Settings
     5. Credits
     6. ----- The Hints Below Contain Out Right Solutions -----
     7. The Parking Lot
     8. The Attractions
     9. The Games
     0. The Carnival Office
     A. Back Stage
     B. Hell Ride
     C. The Electrical Area
     D. Where Are The Fuses?
     E. The Control Room
     F. Collecting Evidence
     G. How Points Are Awarded (Spoilers)

>[esc]
Parking Lot
The lot stretches across an open field, gravel crunching under the tires of arriving cars. Floodlights and the carnival's colorful glow light the area, accompanied by distant laughter, music, and the hum of rides.

Cars park haphazardly, guided by makeshift signs and fluttering flags. Families and visitors mingle, some lingering in vehicles, preparing for the chilly evening ahead. Shadows from encroaching trees are pierced by the occasional flash of a flashlight. At the entrance, an attendant collects fees in a weathered booth, making change from a cash box.

Puddles from recent rain shimmer under the lights, while patches of mud cling to shoes. In the distance, RVs and trailers sit quietly, their occupants watching the Ferris wheel turn against the evening sky. The lot serves as a transition between the mundane and the magical world inside the carnival.

The midway is to the south. There is a blueberry bush here. There are blueberries on the bush.

Your car is here. It's a bit of a beater. Inside the car, you can see the glove box, the seat, the rear view mirror, the ignition, and the dashboard.

The attendant has a parking ticket. The price of a parking is $5.00.

You can see a parking attendant here.

>get berries

>get berries
Taken.

>eat blueberries

>eat blueberries
The blueberries were delicious. A true taste of summer!

[Your score has just gone up by five points.]

>look under seat

>look under seat
You find the three quarters, the nickel, the five dimes, and your keys!

[Your score has just gone up by five points.]

>get dimes, keys

>get dimes, keys
dime: Taken.
dime: Taken.
dime: Taken.
dime: Taken.
dime: Taken.
your keys: Taken.

>open glove box

>open glove box
(first unlocking the glove box)
(with your keys)
You open the glove box, revealing a 14" long piece of string and a pair of gloves.

>get all from glove compartment

>get all from glove compartment
14" long piece of string: Taken.
pair of gloves: Taken.

>wear gloves

>wear gloves
You put on the pair of gloves.

>give coupon to attendant

>give coupon to attendant
(first taking the coupon)
Done. The price of a parking ticket is now $3.00.

>buy ticket

>buy ticket
The attendant mumbles something about the stub.

You fork over $3.00 for the parking ticket, leaving yourself with $32.00.

>put stub on dashboard

>put stub on dashboard
You put the parking stub on the dashboard.

>south

>south
Ticket Booth
Painted in bright red and yellow stripes, the ticket kiosk stands at the entrance with flickering lights to draw attention. A smiling cashier hands out tickets, while the cash drawer jingles. A digital payment system sits in the corner. Too bad you don't have a debit card.

To the right, a signboard displays ticket prices alongside illustrations of the rides. Pennant flags flutter and the air is filled with the scent of popcorn, pretzels, and grease.

The ground is worn from the steps of carnival goers eagerly waiting in line as they approach the midway.

The midway continues in all directions from here. There is a cashier here. A price list for attraction tickets is on the signboard. The cashier has Hell Ride ticket, Fortune Teller ticket, Ferris Wheel ticket, Bumper Cars ticket, and Carousel ticket.

You can see a cashier here.

>buy tickets

>buy tickets
Hell Ride ticket: You fork over $4.00 for the Hell Ride ticket, leaving yourself with $28.00.
Fortune Teller ticket: You fork over $3.00 for the Fortune Teller ticket, leaving yourself with $25.00.
Ferris Wheel ticket: You fork over $2.00 for the Ferris Wheel ticket, leaving yourself with $23.00.
Bumper Cars ticket: You fork over $2.00 for the Bumper Cars ticket, leaving yourself with $21.00.
Carousel ticket: You fork over $1.00 for the Carousel ticket, leaving yourself with $20.00.

[Your score has just gone up by five points.]

>east

>east
High Striker
A tall machine stands with bright red, yellow, and blue lights. A sign sits at the top reading "Test Your Strength!" The base is dark, polished wood, with a sturdy metal pole and a bell at the top. Markings along the pole indicate strength. A smaller sign says, "Buy a mallet, strike the bell, win a prize." Spectators cheer as the sound of the mallet hitting the target fills the night.

The Ticket Kiosk is to the west. Other games are northeast and southeast of here. The Ferris Wheel lies to the east.

You can see a High Striker attendant, a bullseye, and some High Striker prizes here.

The attendant is holding a mallet.

>examine prizes

>examine prizes
The prizes are a teddy bear, a knock-off Swiss Army knife, a magenta colored fuse, and a poster of Taylor Swift.

>buy mallet

>buy mallet
You fork over $2.00 for the mallet, leaving yourself with $18.00.

>hit bullseye with mallet

>hit bullseye with mallet
You lift the mallet high and bring it down on the bullseye with all your might! The striker rises towards the bell stopping at "Weakling".
 
>again

>again
You lift the mallet high and bring it down on the bullseye with all your might! The striker rises towards the bell stopping at "Getting Stronger".
 
>again

>again
You lift the mallet high and bring it down on the bullseye with all your might! The striker rises towards the bell stopping at "Getting Stronger".
 
>again

>again
You lift the mallet high and bring it down on the bullseye with all your might! The striker rises towards the bell stopping at "Average".
 
You can't be sure of it but it seems as if the mallet isn't heavy enough to ring the bell.

>southeast

>southeast
Pitchers Mound
The milk bottle toss is a classic game of skill and luck. A pyramid of colorful bottles sits on a sturdy platform - three on the bottom, two in the middle, and one at the top. Players throw baseballs to knock down the stack and win a prize. The booth is lively, with cheering and the clatter of falling bottles. The attendant calls, "Step right up! Three balls for a dime!" Prizes from toys to stuffed animals hang nearby. With this carnival favorite, every toss is filled with suspense.  You thought you caught a flash of something coming from the area of the booth.

You're surprised to see that this game only costs a dime. The High Striker is to the northwest.

The milk bottles are stacked in three neat rows: three bottles on the bottom, two in the middle, and one on top.

         1         
       2   3     
     4   5   6     

You can also see a Pitchers Mound attendant and some Pitchers Mound prizes here.

>look under booth

>look under booth
You find the Mercury dime!

>get mercury dime

>get mercury dime
Taken.

[Your score has just gone up by five points.]

>northwest

>northwest
High Striker
A tall machine stands with bright red, yellow, and blue lights. A sign sits at the top reading "Test Your Strength!" The base is dark, polished wood, with a sturdy metal pole and a bell at the top. Markings along the pole indicate strength. A smaller sign says, "Buy a mallet, strike the bell, win a prize." Spectators cheer as the sound of the mallet hitting the target fills the night.

The Ticket Kiosk is to the west. Other games are northeast and southeast of here. The Ferris Wheel lies to the east.

You can see a High Striker attendant, a bullseye, and some High Striker prizes here.

>northeast

>northeast
Dime Toss Game
The booth is brightly colored with red-and-white stripes, twinkling lights, and a sign reading "TOSS A DIME - WIN A PRIZE!" Prizes hang around the booth, from stuffed animals to shiny trinkets. Gleaming plates reflect the light, waiting for dimes. The "ping" of dimes hitting plates is followed by the satisfying "plop" when they land. Shouts of victory and playful groans mix with carnival music and laughter. The operator calls out, drawing in onlookers.

You're surprised to see that this game only costs a dime. The exit is to the southwest.

You can see a Dime Toss attendant, some Dime Toss prizes, and a plate here.

>flip mercury dime on plate

>flip mercury dime on plate
You toss the dime. The heavier Mercury dime hits the plate, starts to spins, and lands in the center of the plate. The attendant shouts out, "Winner! Winner!"

Which prize would you like? 1) a stuffed monkey, 2) an orange colored fuse, 3) a poster of Billie Eilish, 4) a horseshoe magnet?

>4

>4
You are now holding a horseshoe magnet.

[Your score has just gone up by five points.]

>4

>4
I didn't understand that sentence.

>southwest

>southwest
High Striker
A tall machine stands with bright red, yellow, and blue lights. A sign sits at the top reading "Test Your Strength!" The base is dark, polished wood, with a sturdy metal pole and a bell at the top. Markings along the pole indicate strength. A smaller sign says, "Buy a mallet, strike the bell, win a prize." Spectators cheer as the sound of the mallet hitting the target fills the night.

The Ticket Kiosk is to the west. Other games are northeast and southeast of here. The Ferris Wheel lies to the east.

You can see a High Striker attendant, a bullseye, and some High Striker prizes here.

>southeast

>southeast
Pitchers Mound
The milk bottle toss is a classic game of skill and luck. A pyramid of colorful bottles sits on a sturdy platform - three on the bottom, two in the middle, and one at the top. Players throw baseballs to knock down the stack and win a prize. The booth is lively, with cheering and the clatter of falling bottles. The attendant calls, "Step right up! Three balls for a dime!" Prizes from toys to stuffed animals hang nearby. With this carnival favorite, every toss is filled with suspense. 

You're surprised to see that this game only costs a dime. The High Striker is to the northwest.

The milk bottles are stacked in three neat rows: three bottles on the bottom, two in the middle, and one on top.

         1         
       2   3     
     4   5   6     

You can also see a Pitchers Mound attendant and some Pitchers Mound prizes here.

>give dime to attendant

>give dime to attendant
The attendant gives you three baseballs in return.

>throw baseball at bottle 5

>throw baseball at bottle 5
You wind up and throw the baseball at the milk bottles. The ball hits the bottles in the sweet spot and they topple over onto the platform. The attendant shouts out, "Winner! Winner!"

Which prize would you like? 1) a crimson colored fuse, 2) a plush donkey, 3) a goldfish in a bowl, 4) a poster of Lourde?

>1

>1
You are now holding a crimson colored fuse.

[Your score has just gone up by ten points.]

>1

>1
I didn't understand that sentence.

>give dime to attendant

>give dime to attendant
The Pitchers Mound attendant says, "Sorry. You only get to play once."

>northwest

>northwest
High Striker
A tall machine stands with bright red, yellow, and blue lights. A sign sits at the top reading "Test Your Strength!" The base is dark, polished wood, with a sturdy metal pole and a bell at the top. Markings along the pole indicate strength. A smaller sign says, "Buy a mallet, strike the bell, win a prize." Spectators cheer as the sound of the mallet hitting the target fills the night.

The Ticket Kiosk is to the west. Other games are northeast and southeast of here. The Ferris Wheel lies to the east.

You can see a High Striker attendant, a bullseye, and some High Striker prizes here.

>east

>east
Ferris Wheel
The Ferris wheel dominates the carnival, its bright lights visible from every corner. Its massive steel frame arches high, with colorful gondolas swaying as it turns. At night, flashing in bursts of red, green, and white, the wheel dazzles with lights. The air buzzes with the hum of the motor. The operator calls, "Step right up! The best view of the carnival awaits!" From the top, riders get a panoramic view of the fairgrounds, with city lights stretching to the horizon.

Hey! Is that a two dollar bill on the ground?

You can also see a Ferris Wheel attendant here.

>give ticket to attendant

>give ticket to attendant
(the Ferris Wheel ticket to the Ferris Wheel attendant)
You give the Ferris Wheel ticket to the Ferris Wheel attendant.

As you enter the gondola, the safety bar clicks into place, and the Ferris wheel begins its ascent. The sounds of the carnival fade, replaced by the hum of machinery and a soft breeze. At the peak, the carnival sprawls below, its lights twinkling against the twilight sky. The world falls quiet up here. The gondola sways gently, adding excitement to the serene view. From the top you can see something to the west of the concession stand. As you descend, the sounds of the carnival return, bringing you back to the fun.

>west

>west
High Striker
A tall machine stands with bright red, yellow, and blue lights. A sign sits at the top reading "Test Your Strength!" The base is dark, polished wood, with a sturdy metal pole and a bell at the top. Markings along the pole indicate strength. A smaller sign says, "Buy a mallet, strike the bell, win a prize." Spectators cheer as the sound of the mallet hitting the target fills the night.

The Ticket Kiosk is to the west. Other games are northeast and southeast of here. The Ferris Wheel lies to the east.

You can see a High Striker attendant, a bullseye, and some High Striker prizes here.

>west

>west
Ticket Booth
Painted in bright red and yellow stripes, the ticket kiosk stands at the entrance with flickering lights to draw attention. A smiling cashier hands out tickets, while the cash drawer jingles. A digital payment system sits in the corner. Too bad you don't have a debit card.

To the right, a signboard displays ticket prices alongside illustrations of the rides. Pennant flags flutter and the air is filled with the scent of popcorn, pretzels, and grease.

The ground is worn from the steps of carnival goers eagerly waiting in line as they approach the midway.

The midway continues in all directions from here. There is a cashier here. A price list for attraction tickets is on the signboard. The cashier has Ferris Wheel ticket.

You can see a janitor and a cashier here.

>southwest

>southwest
Concession Stand
The concession stand is a destination for many along the midway. Twinkling lights frame the stand making it glow amid the carnival's buzz.

Behind the counter, popcorn churns in the machine, candy apples gleam, and cotton candy spins in clouds. Warm pretzels sit under a heat lamp, while sodas chill in a frosted cooler. The counter is cluttered with bags, napkins, and sprinkle cups. Kids tug at parents, teens share pretzels, and the crowd buzzes with energy.

There is a menu to the right of the window. You can see the treats inside the stand. There are exits to the south, west, and northeast.

Nearby a sturdy door leads south.

You can also see a concession attendant and a menu here.

>buy bubblegum

>buy bubblegum
You fork over $1.00 for the Bubblegum, leaving yourself with $17.00.

>west

>west
Behind the Concession Stand
Behind the concession stand, to one side, is the trash generated from the day's activities and to the other side boxes of supplies. There is a chair here surrounded by cigarette butts. There is an exit to the east.

You can see a trash can (closed) and some concession boxes here.

>open trash can

>open trash can
You open the trash can, revealing a khaki colored fuse.

>get khaki fuse

>get khaki fuse
Taken.

[Your score has just gone up by ten points.]

>east

>east
Concession Stand
The concession stand is a destination for many along the midway. Twinkling lights frame the stand making it glow amid the carnival's buzz.

Behind the counter, popcorn churns in the machine, candy apples gleam, and cotton candy spins in clouds. Warm pretzels sit under a heat lamp, while sodas chill in a frosted cooler. The counter is cluttered with bags, napkins, and sprinkle cups. Kids tug at parents, teens share pretzels, and the crowd buzzes with energy.

There is a menu to the right of the window. You can see the treats inside the stand. There are exits to the south, west, and northeast.

Nearby a sturdy door leads south.

You can also see a concession attendant and a menu here.

>northeast

>northeast
Ticket Booth
Painted in bright red and yellow stripes, the ticket kiosk stands at the entrance with flickering lights to draw attention. A smiling cashier hands out tickets, while the cash drawer jingles. A digital payment system sits in the corner. Too bad you don't have a debit card.

To the right, a signboard displays ticket prices alongside illustrations of the rides. Pennant flags flutter and the air is filled with the scent of popcorn, pretzels, and grease.

The ground is worn from the steps of carnival goers eagerly waiting in line as they approach the midway.

The midway continues in all directions from here. There is a cashier here. A price list for attraction tickets is on the signboard. The cashier has Ferris Wheel ticket.

You can see a cashier here.

>south

>south
Head of the Line
You are standing in front of an attendant with his hand open waiting for your ticket. The entrance to the ride is south of here. The ride operator tells you that you're lucky you showed up when you did because this will be the last trip through Hell Ride for the night. You notice that all the other cars are empty. The Ticket Kiosk is north of here.

You can see a Hell Ride attendant here.

>give ticket to attendant

>give ticket to attendant
(the Hell Ride ticket to the Hell Ride attendant)
You give the Hell Ride ticket to the Hell Ride attendant.

>south

>south
Ride Entrance
The cars for Hell Ride stop here, and the safety bar clicks into place as riders board the cars. Ahead, the grotesque entrance looms - a twisted metal archway adorned with spikes, skulls, and flickering blood-red lights. A faint sulfuric smell mixes with the scent of popcorn.

The "HELL RIDE" sign pulses above the door, while demon statues with clawed hands seem to beckon. The entrance is shrouded in darkness, broken only by eerie green flashes that reveal twisted paths. Faint whispers and distant organ music grow louder. To one side, the darkness looks a little bit darker than the rest of the room.

You can see a Hell Ride car (empty) here.

>east

>east
Dark Passage
This room is backstage at the Hell Ride attraction. The room is littered with bags of trash, piles of junk, and dust bunnies so large they should be paying rent. There an exit to the south and west.

[Your score has just gone up by five points.]

>look at junk

>look at junk
This is a pile of assorted flotsam and jetsam from the carnival. None of it looks very interesting.

In the pile of junk is a flashlight.

>get flashlight

>get flashlight
Taken.

[Your score has just gone up by five points.]

>turn it on

>turn it on
You flip a switch. A strong, narrow beam of light shines from the lit flashlight.

>south

>south
Maintenance Office
The maintenance office is a dim, cluttered space, filled with the smells of grease, sweat, and popcorn. Disorganized shelves are lined with tools and parts, while paint cans and grease jars clutter the workbenches. A battered desk holds wires, gears, and springs, with a bent piece of metal in a vise.

A flickering fluorescent light barely brightens the room. In one corner, a disassembled ride mechanism hangs with chains and pulleys. A greasy manual and a half-empty coffee mug sit on a nearby stool.

Faded safety posters and a worn photo of the carnival decorate the walls, along with a corkboard full of schedules and notes, and a worn photo of the carnival in its prime. The floor is gritty with dust and scattered nails. Despite the mess, the room buzzes with purpose and keeps the carnival running, fueled by sweat and ingenuity.

Exits lead north and south.

Nearby a ladder leads up.

Nearby an aqua colored door leads west.

You can also see a worn photo and a desk (on which are a coffee mug and a radio) here.

>open drawer

>open drawer
You open the drawer, revealing some scissors, a stapler, a ballpoint pen, a pad of paper, and a silver key.

>get silver key

>get silver key
Taken.

>south

>south
Crawl Space
The crawl space beneath the ride is cramped and dark, filled with the hum of machinery above. The air is thick with oil and rust. Sounds echo - groaning steel, clanking chains, and the rhythmic thrum of motors.

The ground is uneven, a mix of dirt, gravel, and scattered tools. Pipes overhead are wrapped in fraying insulation, crackling as you move. Small puddles of murky water collect.

The backstage area continues north and south.

Nearby a crimson colored door leads west.

>south

>south
Mechanical Room North
The north mechanical room is compact, housing auxiliary systems for the ride. A soft hum of capacitors and relays fills the space, interrupted only by the occasional hissing of hydraulic fluid.

Circuit breaker panels line the walls, labeled for different functions. Cables and conduits connect the systems to the main hub. Flickering with gauges, a hydraulic pump in the corner manages lifting arms and platforms.

A small workbench is cluttered with parts, while shelves above hold spare parts like cables and hydraulic tubing. A faded ride diagram with red annotations is pinned nearby. The room feels cool and damp.

There are exists north and south.

Nearby an emerald colored door leads west.

You can also see a toolbox (closed) and a sledgehammer here.

>open toolbox

>open toolbox
You open the toolbox, revealing an adjustable wrench, some channel locks, and a hammer.

>get wrench

>get wrench
Taken.

>get sledgehammer

>get sledgehammer
Taken.

>south

>south
Mechanical Room South
The south mechanical room is the heart of the ride, with a massive motor powering the thick belts, pulleys, and gears. Electrical panels line the walls, flashing "High Voltage" and colorful indicator lights.

Conduits and wires snake across the ceiling, connecting systems. A cluttered table holds tools, spare parts, and maintenance logs stained with grease. The air smells of oil, metal, and ozone.

A cooling fan struggles to cut the warmth as the hum of machinery mixes with the hiss of hydraulics and clinking chains. The floor is a patchwork of metal grates and worn concrete. The room is busy; every movement is precise and controlled.

You can travel north and south from here.

Nearby a gray colored door leads west.

You can also see a grate (in which is an emerald colored fuse) here.

>chew gum

>chew gum
You chew the bubblegum, blowing a few bubbles as you do so.

>tie string to gum

>tie string to gum
You tie the 14" long piece of string to the chewed bubblegum.

>lower gum into grate

>lower gum into grate
You drop the chewed bubblegum into the grate. The emerald colored fuse attaches to the chewed bubblegum. You quickly and carefully raise the chewed bubblegum and drop emerald colored fuse into your hand.

[Your score has just gone up by ten points.]

>south

>south
Generator Room
The generator room is small, with concrete walls stained by oil and grime. The air smells of diesel, metal, and damp earth.

The main generator hums, connected by thick cables to circuit breakers and a cluttered panel with switches and gauges. A flickering display shows power levels. The cracked floor is littered with puddles. Shelves hold spare parts and manuals, and a workbench sits next to a grease canister.

The room is the carnival's power source, hidden but essential.

The backstage area continues north and south of here.

Nearby an indigo colored door leads west.

>west

>west
(first opening the indigo colored door)
(first unlocking the indigo colored door)
(with the silver key)

As you enter the room, you can see Mr Whidbey across the way. He seems to be doing something around the guillotine platform. You walk closer to see what he is doing and startle him. Mr Whidbey spins around and glares at you. As he turns and walks out of the room, you think you saw him drop something.

Guillotine Room
The public square hums with tension under gray skies. A wooden platform stands at the center, a grim focal point.

A lone figure, hands bound and head bowed, stands on the scaffold. Their tattered clothes reveal a once-gilded past.

The crowd jeers while children watch wide-eyed. The town crier proclaims, "High treason against the crown!"

The condemned remains silent as the executioner, robed in black, stands beside the guillotine. The blade gleams in the dim light. The crowd's murmurs die, replaced by silence.

As the condemned approaches, the guillotine's timing falters. Instead of falling on the scaffold, the blade swings over the cars, threatening any unlucky passenger who passes beneath.

There is just one problem: the guillotine is being raised and lowered by some mechanism. It appears that the timing of the guillotine is off and it is being lowered onto the cars instead of between them. If a person were to be in a car as it passed under the guillotine, they would be seriously injured.

You're glad you're not in one of those cars now. You must do something to stop it before someone gets hurt! 

Nearby a wooden door leads east to the Generator Room.

You can also see a guillotine platform here.

>look at platform

>look at platform
At the center of the square stands a raised wooden platform, stark and imposing, where the grim sentence is to be carried out. You can just make out something underneath the platform in the dark.

>look under platform

>look under platform
You find the pliers!

>get pliers

>get pliers
(putting the notebook into the fanny pack to make room)
You're carrying too many things already.

Mr Whidbey arrives from the Dungeon.

>show pliers to whidbey

>show pliers to whidbey
(first taking the pliers)
(putting the wallet into the fanny pack to make room)
"Oh! I thought I lost... I mean those belong to the janitor. Where did you find them?" asks Mr Whidbey.

Mr. Whidbey's eyes dart up and to the left.

You've collected some new evidence.

You've discovered some evidence. To see a list and weighting of the evidence you've collected, type "SHOW EVIDENCE". To collect more evidence, try to ASK someone ABOUT something. Or SHOW something TO someone.

[Your score has just gone up by five points.]

>north

>north
Dungeon
The dungeon is dark and damp, the air thick with sweat, blood, and mildew. Lanterns flicker on rusted sconces, casting twisted shadows.

Chains rattle, mixed with distant moans and screams. Water drips from a cracked ceiling, pooling on the blood-dark floor.

Instruments of torture clutter the room: a broken rack, a brazier with bloodstained tools, and a spiked chair. Prisoners endure all these things, bound or writhing in agony.

The torturer moves with cold precision, ignoring the suffering. Above, rats scurry in the shadows, and the heavy, oppressive air thickens with despair.

Nearby a wooden door leads east to the Mechanical Room South.

You can also see an iron chair, a splintered rack, and a glowing brazier here.

>north

>north
Stake Room
The public square is silent, broken only by crackling flames. At its center, three women are bound to wooden stakes, their faces showing defiance, resignation, and terror.

A crowd watches, some jeering, others praying or looking away. Torch in hand, the executioner steps forward igniting the pyre. Flames roar as the women cry out, their voices lost in the heat.

Gray clouds loom above as a raven caws. Church bells toll, marking the tragedy. Some onlookers stay, others quietly leave.

Nearby a wooden door leads east to the Mechanical Room North.

The flames of the pyre burn ever brighter and rise ever higher engulfing the victims.

>look in pyre

>look in pyre
In the pyre is a quartz colored fuse.

>get quartz fuse

>get quartz fuse
(putting the dime into the fanny pack to make room)
Taken.

>north

>north
Gallows Room
The public square, wet from morning drizzle, lies under a dark sky. At its center, the gallows loom, ropes swaying. Their eyes fixed on the scene, the crowd stands in silence.

A hooded executioner, cold and focused, adjusts the noose. Pale and bound, the condemned man trembles as his eyes dart around the crowd. Sweat and rain mix on his face as he breathes shallowly.

Vendors shout, children push forward, and an old man whispers prayers. Above, the bell tolls, marking the man's final moments. A raven watches from the gallows beam. The air is heavy as distant thunder rumbles.

Nearby a wooden door leads east to the Crawl Space.

You can also see a gallows platform here.

>north

>north
Stocks Room
The public square is a cobblestone stretch surrounded by weathered buildings. The air smells of smoke, damp earth, and a nearby smithy. At the center, old stocks stand with iron clasps holding captives in shameful positions. Their tattered clothes offer little against the cold wind.

The animatronics are lifelike, enhancing the grim atmosphere. The crowd mocks the prisoners, hurling insults and rotten food. Jeers mix with their laughter. The square hums with noise. Unnoticed by the crowd, the sky darkens as the spectacle continues.

Nearby a wooden door leads east to the Maintenance Office.

You can also see a wooden stocks here.

>east

>east
(first opening the wooden door)
(first unlocking the wooden door)
(with the silver key)

Maintenance Office
The maintenance office is a dim, cluttered space, filled with the smells of grease, sweat, and popcorn. Disorganized shelves are lined with tools and parts, while paint cans and grease jars clutter the workbenches. A battered desk holds wires, gears, and springs, with a bent piece of metal in a vise.

A flickering fluorescent light barely brightens the room. In one corner, a disassembled ride mechanism hangs with chains and pulleys. A greasy manual and a half-empty coffee mug sit on a nearby stool.

Faded safety posters and a worn photo of the carnival decorate the walls, along with a corkboard full of schedules and notes, and a worn photo of the carnival in its prime. The floor is gritty with dust and scattered nails. Despite the mess, the room buzzes with purpose and keeps the carnival running, fueled by sweat and ingenuity.

Exits lead north and south.

Nearby an aqua colored door leads west to the Stocks Room.

Nearby a ladder leads up.

You can also see a worn photo and a desk (on which are a coffee mug and a radio) here.

>north

>north
Dark Passage
This room is backstage at the Hell Ride attraction. The room is littered with bags of trash, piles of junk, and dust bunnies so large they should be paying rent. There an exit to the south and west.

>west

>west
Ride Entrance
The cars for Hell Ride stop here, and the safety bar clicks into place as riders board the cars. Ahead, the grotesque entrance looms - a twisted metal archway adorned with spikes, skulls, and flickering blood-red lights. A faint sulfuric smell mixes with the scent of popcorn.

The "HELL RIDE" sign pulses above the door, while demon statues with clawed hands seem to beckon. The entrance is shrouded in darkness, broken only by eerie green flashes that reveal twisted paths. Faint whispers and distant organ music grow louder. To one side, the darkness looks a little bit darker than the rest of the room.

You can see a Hell Ride car (empty) here.

>north

>north
Head of the Line
You are standing in front of an attendant. The entrance to the ride is south of here. The ride operator tells you that you're lucky you showed up when you did because this will be the last trip through Hell Ride for the night. You notice that all the other cars are empty. The Ticket Kiosk is north of here.

You can see a Hell Ride attendant here.

>north

>north
Ticket Booth
Painted in bright red and yellow stripes, the ticket kiosk stands at the entrance with flickering lights to draw attention. A smiling cashier hands out tickets, while the cash drawer jingles. A digital payment system sits in the corner. Too bad you don't have a debit card.

To the right, a signboard displays ticket prices alongside illustrations of the rides. Pennant flags flutter and the air is filled with the scent of popcorn, pretzels, and grease.

The ground is worn from the steps of carnival goers eagerly waiting in line as they approach the midway.

The midway continues in all directions from here. There is a cashier here. A price list for attraction tickets is on the signboard. The cashier has Ferris Wheel ticket.

You can see a janitor and a cashier here.

The janitor heads to the Bumper Cars.

>northwest

>northwest
Bumper Cars
The bumper cars are a lively scene of flashing lights and vibrant decorations. The arena is surrounded by padded barriers, ensuring the rider's safety. Cars in faded reds, blues, yellows, and greens glide across the slick floor, each equipped with a steering wheel and padded bumper. Riders maneuver their cars with intensity, creating a din of bumps and laughter. Overhead, electric poles hum with energy. While onlookers cheer from the sidelines, the bumper cars offer playful competition and nostalgic fun for all. The Ticket Kiosk is southeast of here.

You can see a janitor and a Bumper Cars attendant here.

>look at janitor

>look at janitor
The janitor looks at you expectantly.

The janitor is a portly gentleman wearing dirty overalls, leaning on a broom. The janitor is wearing a brass ring with a key on it. He complains that he's missing his flashlight. He also mentions that his pliers are missing.

>give pliers to janitor

>give pliers to janitor
"Hey! Thanks. These have been missing from my tool box. Where did you find them?" asks the janitor.

>give flashlight to janitor

>give flashlight to janitor
The janitor says, "Thanks for returning my pliers and flashlight. Here, take this key."
Taken.

>give wrench to attendant

>give wrench to attendant
Hey! Thanks, I really appreciate it. Usually no one ever responds to the radio in the Control Room. Here, take this fuse.

Taken.

The janitor heads to the Ticket Booth.

[Your score has just gone up by five points.]

[Your score has just gone up by ten points.]

>southeast

>southeast
Ticket Booth
Painted in bright red and yellow stripes, the ticket kiosk stands at the entrance with flickering lights to draw attention. A smiling cashier hands out tickets, while the cash drawer jingles. A digital payment system sits in the corner. Too bad you don't have a debit card.

To the right, a signboard displays ticket prices alongside illustrations of the rides. Pennant flags flutter and the air is filled with the scent of popcorn, pretzels, and grease.

The ground is worn from the steps of carnival goers eagerly waiting in line as they approach the midway.

The midway continues in all directions from here. There is a cashier here. A price list for attraction tickets is on the signboard. The cashier has Ferris Wheel ticket.

You can see a janitor, Mr Whidbey, and a cashier here.

>east

>east
High Striker
A tall machine stands with bright red, yellow, and blue lights. A sign sits at the top reading "Test Your Strength!" The base is dark, polished wood, with a sturdy metal pole and a bell at the top. Markings along the pole indicate strength. A smaller sign says, "Buy a mallet, strike the bell, win a prize." Spectators cheer as the sound of the mallet hitting the target fills the night.

The Ticket Kiosk is to the west. Other games are northeast and southeast of here. The Ferris Wheel lies to the east.

You can see a High Striker attendant, a bullseye, and some High Striker prizes here.

Over the loudspeaker, an announcement blares: Attention please. There is a vehicle being towed from the parking lot for parking illegally. The license plate of the car is "862901". You breathe a sigh of relief as you realize that's not your license plate. I guess it's a good thing you remembered to place the parking stub on the dashboard.

>hit bullseye with sledgehammer

>hit bullseye with sledgehammer
As you swing, you feel the extra weight from the sledgehammer. As it comes down on the bullseye, you can't help but feel like the extra weight gives you an edge. The bell rings as the striker reaches the top of the pole. The attendant says, "You're a Muscle Man. Here's a prize for you."

Which prize would you like? 1) a teddy bear, 2) a knock-off Swiss Army knife, 3) a magenta colored fuse, 4) a poster of Taylor Swift?

>2

>2
You are now holding a knock-off Swiss Army knife.

[Your score has just gone up by five points.]

>2

>2
I didn't understand that sentence.

>hit bullseye with sledge

>hit bullseye with sledge
As you swing, you feel the extra weight from the sledgehammer. As it comes down on the bullseye, you can't help but feel like the extra weight gives you an edge. The bell rings as the striker reaches the top of the pole. The attendant says, "You're a Muscle Man. Here's a prize for you."

Which prize would you like? 1) a teddy bear, 3) a magenta colored fuse, 4) a poster of Taylor Swift?

>3

>3
You are now holding a magenta colored fuse.
(putting the dime into the fanny pack to make room)

[Your score has just gone up by five points.]

>3

>3
I didn't understand that sentence.

>hit bullseye with sledgehammer

>hit bullseye with sledgehammer
The High Striker attendant takes the sledgehammer away from you exclaiming, "Hey! What are you doing? I'm not going to let you cheat again!"

>west

>west
Ticket Booth
Painted in bright red and yellow stripes, the ticket kiosk stands at the entrance with flickering lights to draw attention. A smiling cashier hands out tickets, while the cash drawer jingles. A digital payment system sits in the corner. Too bad you don't have a debit card.

To the right, a signboard displays ticket prices alongside illustrations of the rides. Pennant flags flutter and the air is filled with the scent of popcorn, pretzels, and grease.

The ground is worn from the steps of carnival goers eagerly waiting in line as they approach the midway.

The midway continues in all directions from here. There is a cashier here. A price list for attraction tickets is on the signboard. The cashier has Ferris Wheel ticket.

You can see a cashier here.

>west

>west
In front of the tent, the barker gestures excitedly, calling out:

Ladies and gentlemen, boys and girls, gather 'round! 
Step right up and witness the spectacle that's taken the world by storm! 
She walks, she talks, she crawls on her belly like a reptile. 
Behold the one, the only Little Egypt, performing her legendary Dance of the Pyramids - a dazzling display of mystery, grace, and allure! 
For just a dime, a mere one tenth of a dollar, prepare to be transported to the sands of Cairo, where enchantment and wonder await!

Show Facade
As you walk west through the midway, the lights fade to a soft glow, leading you to a tent. A sign reads "Little Egypt Show - A Journey Into the Mysterious and Unknown!" The barker, wearing a fez and smiling, points to another sign: "Little Egypt - Dime Admission." The ticket kiosk is behind you to the east.

There is a stage in front of the tent. The Barker is encouraging you to step up and enjoy.

You can see a Barker here.

>give dime to barker

>give dime to barker
You hand over a dime, and the barker nods, waving you through. As you step up to the entrance, the air feels thicker and the sounds of the carnival fade away. You've entered an entirely different world now. Before you, there is a tent. Intrigued, you take your first step towards the Little Egypt Show. You can now head west into the show.

>ask barker about hell ride

>ask barker about hell ride
"Hell Ride is our most popular attraction but there always seems to be something wrong with it," says the Barker.

You've collected some new evidence.

>ask barker about accidents

>ask barker about accidents
The Barker says "Things sure seem vulnerable at this time."

You've collected some new evidence.

>west

>west
Show Tent
You are inside the Little Egypt Show. The attraction's facade is to the east. There are folding chairs standing vigil in neat in rows. The show should start soon.

>get lantern

>get lantern
Taken.

[Your score has just gone up by five points.]

>turn it on

>turn it on
You flip a switch. A strong, narrow beam of light shines from the lit lantern.

>wait

>wait
Time passes.

>wait

>wait
Time passes.

The tent is dimly lit, the stage is a fully decorated representation of some Middle Eastern palace, featuring rich, colorful fabrics, brass ornaments, and lanterns casting a warm, flickering glow. Heady incense wafts through the air, softening everything around the edges. Enhancing the mystique, the backdrop displays painted scenes of pyramids, desert landscapes, and domed structures. The colorful onion topped buildings and jewel tones set to the sepia colored landscape have you transported far away.

>wait

>wait
Time passes.

Little Egypt emerges, draped in flowing silken veils. Skillfully she twirls using them as part of the dance. A sparkling, sequined bodice opens into a gauze skirt, adorned with jingling coin belts and jewelry that accentuate her dance.

>wait

>wait
Time passes.

The performance begins with slow, undulating movements, drawing you into the rhythm of the music. Traditional instruments like the oud, darbuka, or zurna are an accompanying chorus. As the tempo builds, her hips, torso, and hands twist in an intricate and mesmerizing pattern. Little Egypt demonstrates remarkable control and fluidity. She dramatically spins, drops, and shimmies, often punctuating the beat with a quick jingle of her coin belt.

>wait

>wait
Time passes.

Little Egypt makes eye contact with you and smiles enigmatically. In her performance she balances a fine silver sword on her head and accents her dance with tinkling finger cymbals.

>wait

>wait
Time passes.

The music oscillates between hauntingly slow melodies and rapid, energetic drum beats, a roller coaster of emotion that leaves you entranced. Little Egypt relies on the music's dynamic changes to tell a story with movements reflecting joy, sorrow, seduction, and celebration.

>wait

>wait
Time passes.

The performance concludes with a dramatic flourish, an energetic shimmy, a bold spin, and Little Egypt casts off her veils. The dancer takes a bow to thunderous applause, leaving you spellbound by the sensual display.

You applaud until your hands are sore. Did she just wink at you?

As she leaves the stage, Little Egypt tosses one of her veils to you!

>wait

>wait
Time passes.

>wear veil

>wear veil
You wrap the veil around your head, shrouding your eyes. The world is a lovely color pink as you look through the veil while her perfume fills your nostrils in the most delightful way. You look pretty!

[Your score has just gone up by five points.]

>east

>east
Show Facade
As you walk west through the midway, the lights fade to a soft glow, leading you to a tent. A sign reads "Little Egypt Show - A Journey Into the Mysterious and Unknown!" The barker, wearing a fez and smiling, points to another sign: "Little Egypt - Dime Admission." The ticket kiosk is behind you to the east.

There is a stage in front of the tent. The Barker is encouraging you to step up and enjoy.

You can see a Barker here.

>east

>east
Ticket Booth
Painted in bright red and yellow stripes, the ticket kiosk stands at the entrance with flickering lights to draw attention. A smiling cashier hands out tickets, while the cash drawer jingles. A digital payment system sits in the corner. Too bad you don't have a debit card.

To the right, a signboard displays ticket prices alongside illustrations of the rides. Pennant flags flutter and the air is filled with the scent of popcorn, pretzels, and grease.

The ground is worn from the steps of carnival goers eagerly waiting in line as they approach the midway.

The midway continues in all directions from here. There is a cashier here. A price list for attraction tickets is on the signboard. The cashier has Ferris Wheel ticket.

You can see a cashier here.

>southwest

>southwest
Concession Stand
The concession stand is a destination for many along the midway. Twinkling lights frame the stand making it glow amid the carnival's buzz.

Behind the counter, popcorn churns in the machine, candy apples gleam, and cotton candy spins in clouds. Warm pretzels sit under a heat lamp, while sodas chill in a frosted cooler. The counter is cluttered with bags, napkins, and sprinkle cups. Kids tug at parents, teens share pretzels, and the crowd buzzes with energy.

There is a menu to the right of the window. You can see the treats inside the stand. There are exits to the south, west, and northeast.

Nearby a sturdy door leads south.

You can also see a concession attendant and a menu here.

>south

>south
(first opening the sturdy door)
(first unlocking the sturdy door)
(with the brass key)

Carnival Office
Dim, yellow light from an overhead bulb casts long shadows over the room, A single desk lamp, flickering provides additional light. A few carnival-themed knick-knacks sit atop the desk. A framed photograph hangs askew on the wall.

The desk is covered in stacks of paperwork, old receipts, invoices, and faded carnival brochures. A locked cabinet is tucked away against one wall. Next to it, there's a small, heavy safe.

Nearby a sturdy door leads north to the Concession Stand.

On the messy desk are a mini Ferris wheel and a mini carousel.

You can also see a safe (closed), a filing cabinet (closed), and a framed photograph here.

As you enter the room, you see Mr Whidbey with his back to the door. He's talking on the telephone.

"Hello? Oh, it's you." says Mr. Whidbey.

>wait

>wait
Time passes.

Mr. Whidbey listens to the other end of the conversation.

>wait

>wait
Time passes.

"I know, I know, but what am I supposed to do. We have to get that Needleman kid more money. Another $15,000 ought to do it."

>wait

>wait
Time passes.

Isn't this why I buy insurance? Don't worry. You'll get your piece. Everyone will get their piece.

>wait

>wait
Time passes.

Mr. Whidbey says "I need that money in a hurry though before anyone gets suspicious. If anything happens then you'll go down too."

>wait

>wait
Time passes.

"Ok, I'll try to stall for a bit but I won't be able to do it for long."

>wait

>wait
Time passes.

"Hey! What are you doing here? This is area is for employees only," Mr. Whidbey shouts at you. "Get out of here. Now!"

Concession Stand
The concession stand is a destination for many along the midway. Twinkling lights frame the stand making it glow amid the carnival's buzz.

Behind the counter, popcorn churns in the machine, candy apples gleam, and cotton candy spins in clouds. Warm pretzels sit under a heat lamp, while sodas chill in a frosted cooler. The counter is cluttered with bags, napkins, and sprinkle cups. Kids tug at parents, teens share pretzels, and the crowd buzzes with energy.

There is a menu to the right of the window. You can see the treats inside the stand. There are exits to the south, west, and northeast.

Nearby a sturdy door leads south to the Carnival Office.

You can also see a concession attendant and a menu here.

You suddenly find yourself escorted outside the Carnival Office unceremoniously only to find yourself in the Concession Stand.

>south

>south
Carnival Office
Dim, yellow light from an overhead bulb casts long shadows over the room, A single desk lamp, flickering provides additional light. A few carnival-themed knick-knacks sit atop the desk. A framed photograph hangs askew on the wall.

The desk is covered in stacks of paperwork, old receipts, invoices, and faded carnival brochures. A locked cabinet is tucked away against one wall. Next to it, there's a small, heavy safe.

Nearby a sturdy door leads north to the Concession Stand.

On the messy desk are a mini Ferris wheel and a mini carousel.

You can also see a safe (closed), a filing cabinet (closed), and a framed photograph here.

>look at photo

>look at photo
This appears to be a photo of the carnival's opening night, a once proud moment lost in time. On the back reads a date: "03/22/62". This looks like the same photo you found in the Maintenance Office.

>turn dial to 62

>turn dial to 62
You turn the knob to 62.

>set dial to 22

>set dial to 22
You turn the knob to 22.

>spin dial to 3

>spin dial to 3
You turn the knob to 3, and you hear a click.

>open safe

>open safe
You open the safe, revealing an indigo colored fuse, a gold key, and an insurance policy.

>get all from safe

>get all from safe
indigo colored fuse: Taken.
gold key: (putting your keys into the fanny pack to make room)
Taken.
insurance policy: (putting the 14" long piece of string (tied to some chewed bubblegum) into the fanny pack to make room)
Taken.

[Your score has just gone up by five points.]

[Your score has just gone up by ten points.]

>open filing cabinet

>open filing cabinet
(first unlocking the filing cabinet)
(with the gold key)
You open the filing cabinet, revealing an envelope, a Cash 'N' Carry invoice, a Frank's Market invoice, an Oriental Trading invoice, and a Mystic Industries invoice.

>get all from cabinet

>get all from cabinet
Cash 'N' Carry invoice: (putting the parking ticket into the fanny pack to make room)
Taken.
envelope: (putting the Fortune Teller ticket into the fanny pack to make room)
Taken.
Frank's Market invoice: (putting the Bumper Cars ticket into the fanny pack to make room)
Taken.
Oriental Trading invoice: (putting the Carousel ticket into the fanny pack to make room)
Taken.
Mystic Industries invoice: (putting the mallet into the fanny pack to make room)
Taken.

[Your score has just gone up by five points.]

[Your score has just gone up by five points.]

[Your score has just gone up by five points.]

[Your score has just gone up by five points.]

>open envelope

>open envelope
You open the envelope, revealing a check stub.

>look at check stub

>look at check stub
This check stub is for a check made payable to "Fred Needleman". The amount is $10,000 and the memo line reads "For services rendered."

>north

>north
Concession Stand
The concession stand is a destination for many along the midway. Twinkling lights frame the stand making it glow amid the carnival's buzz.

Behind the counter, popcorn churns in the machine, candy apples gleam, and cotton candy spins in clouds. Warm pretzels sit under a heat lamp, while sodas chill in a frosted cooler. The counter is cluttered with bags, napkins, and sprinkle cups. Kids tug at parents, teens share pretzels, and the crowd buzzes with energy.

There is a menu to the right of the window. You can see the treats inside the stand. There are exits to the south, west, and northeast.

Nearby a sturdy door leads south to the Carnival Office.

You can also see a concession attendant and a menu here.

>ask attendant about hell ride

>ask attendant about hell ride
"Hell Ride is so old that It's falling apart. I wouldn't ride it." says the concession attendant.

You've collected some new evidence.

>ask attendant about accidents

>ask attendant about accidents
The concession attendant says "The fire, the Ferris wheel, the Bumper Cars... That seems like a lot!"

You've collected some new evidence.

>northeast

>northeast
Ticket Booth
Painted in bright red and yellow stripes, the ticket kiosk stands at the entrance with flickering lights to draw attention. A smiling cashier hands out tickets, while the cash drawer jingles. A digital payment system sits in the corner. Too bad you don't have a debit card.

To the right, a signboard displays ticket prices alongside illustrations of the rides. Pennant flags flutter and the air is filled with the scent of popcorn, pretzels, and grease.

The ground is worn from the steps of carnival goers eagerly waiting in line as they approach the midway.

The midway continues in all directions from here. There is a cashier here. A price list for attraction tickets is on the signboard. The cashier has Ferris Wheel ticket.

You can see a cashier here.

>south

>south
Head of the Line
You are standing in front of an attendant. The entrance to the ride is south of here. The ride operator tells you that you're lucky you showed up when you did because this will be the last trip through Hell Ride for the night. You notice that all the other cars are empty. The Ticket Kiosk is north of here.

You can see a janitor and a Hell Ride attendant here.

>south

>south
Ride Entrance
The cars for Hell Ride stop here, and the safety bar clicks into place as riders board the cars. Ahead, the grotesque entrance looms - a twisted metal archway adorned with spikes, skulls, and flickering blood-red lights. A faint sulfuric smell mixes with the scent of popcorn.

The "HELL RIDE" sign pulses above the door, while demon statues with clawed hands seem to beckon. The entrance is shrouded in darkness, broken only by eerie green flashes that reveal twisted paths. Faint whispers and distant organ music grow louder. To one side, the darkness looks a little bit darker than the rest of the room.

You can see a Hell Ride car (empty) here.

>east

>east
Dark Passage
This room is backstage at the Hell Ride attraction. The room is littered with bags of trash, piles of junk, and dust bunnies so large they should be paying rent. There an exit to the south and west.

>south

>south
Maintenance Office
The maintenance office is a dim, cluttered space, filled with the smells of grease, sweat, and popcorn. Disorganized shelves are lined with tools and parts, while paint cans and grease jars clutter the workbenches. A battered desk holds wires, gears, and springs, with a bent piece of metal in a vise.

A flickering fluorescent light barely brightens the room. In one corner, a disassembled ride mechanism hangs with chains and pulleys. A greasy manual and a half-empty coffee mug sit on a nearby stool.

Faded safety posters and a worn photo of the carnival decorate the walls, along with a corkboard full of schedules and notes, and a worn photo of the carnival in its prime. The floor is gritty with dust and scattered nails. Despite the mess, the room buzzes with purpose and keeps the carnival running, fueled by sweat and ingenuity.

Exits lead north and south.

Nearby an aqua colored door leads west to the Stocks Room.

Nearby a ladder leads up.

You can also see a worn photo and a desk (on which are a coffee mug and a radio) here.

>up

>up
Dark Hallway
This is a poorly lit hallway. Ahead to the west you can see a closed door.

Nearby a ladder leads down to the Maintenance Office.

Nearby a metal door leads west.

>west

>west
(first opening the metal door)
(first unlocking the metal door)
(with the brass key)

Control Room
The backstage control room is a functional space with gray, scuffed walls. A large monitor shows live feeds while control panels with dials, buttons, and lights manage the rides and systems. The panels remain oddly dark.

The hum of electronics is interrupted by a crackling radio: "Maintenance to Bumper Cars - wrench needed!" Papers, tools, and coffee cups clutter the floor. A desk holds logs and schedules, and a corkboard displays charts and red-marked notes, including one that says "Check Zipper circuit breakers."

A single light casts harsh shadows, and the air smells of lubricant and burnt wires, mingling with dampness. The room is hidden but vital, keeping the carnival running. On one wall, a switch sparks with blue and white arcs.

On one wall is a large switch with sparks arcing out from it.

Nearby a metal door leads east to Dark Hallway.

Currently there are sparks arcing out from the switch. It looks dangerous.

[Your score has just gone up by five points.]

>flip switch

>flip switch
You switch the big switch off.

[Your score has just gone up by five points.]

>east

>east
Dark Hallway
This is a poorly lit hallway. Ahead to the west you can see the glow of an open door.

Nearby a metal door leads west to Control Room.

Nearby a ladder leads down to the Maintenance Office.

>down

>down
Maintenance Office
The maintenance office is a dim, cluttered space, filled with the smells of grease, sweat, and popcorn. Disorganized shelves are lined with tools and parts, while paint cans and grease jars clutter the workbenches. A battered desk holds wires, gears, and springs, with a bent piece of metal in a vise.

A flickering fluorescent light barely brightens the room. In one corner, a disassembled ride mechanism hangs with chains and pulleys. A greasy manual and a half-empty coffee mug sit on a nearby stool.

Faded safety posters and a worn photo of the carnival decorate the walls, along with a corkboard full of schedules and notes, and a worn photo of the carnival in its prime. The floor is gritty with dust and scattered nails. Despite the mess, the room buzzes with purpose and keeps the carnival running, fueled by sweat and ingenuity.

Exits lead north and south.

Nearby a ladder leads up to Dark Hallway.

Nearby an aqua colored door leads west to the Stocks Room.

You can also see a worn photo and a desk (on which are a coffee mug and a radio) here.

>south

>south
Crawl Space
The crawl space beneath the ride is cramped and dark, filled with the hum of machinery above. The air is thick with oil and rust. Sounds echo - groaning steel, clanking chains, and the rhythmic thrum of motors.

The ground is uneven, a mix of dirt, gravel, and scattered tools. Pipes overhead are wrapped in fraying insulation, crackling as you move. Small puddles of murky water collect.

The backstage area continues north and south.

Nearby a crimson colored door leads west to the Gallows Room.

>south

>south
Mechanical Room North
The north mechanical room is compact, housing auxiliary systems for the ride. A soft hum of capacitors and relays fills the space, interrupted only by the occasional hissing of hydraulic fluid.

Circuit breaker panels line the walls, labeled for different functions. Cables and conduits connect the systems to the main hub. Flickering with gauges, a hydraulic pump in the corner manages lifting arms and platforms.

A small workbench is cluttered with parts, while shelves above hold spare parts like cables and hydraulic tubing. A faded ride diagram with red annotations is pinned nearby. The room feels cool and damp.

There are exists north and south.

Nearby an emerald colored door leads west to the Stake Room.

You can also see a toolbox (in which are some channel locks and a hammer) here.

>south

>south
Mechanical Room South
The south mechanical room is the heart of the ride, with a massive motor powering the thick belts, pulleys, and gears. Electrical panels line the walls, flashing "High Voltage" and colorful indicator lights.

Conduits and wires snake across the ceiling, connecting systems. A cluttered table holds tools, spare parts, and maintenance logs stained with grease. The air smells of oil, metal, and ozone.

A cooling fan struggles to cut the warmth as the hum of machinery mixes with the hiss of hydraulics and clinking chains. The floor is a patchwork of metal grates and worn concrete. The room is busy; every movement is precise and controlled.

You can travel north and south from here.

Nearby a gray colored door leads west to the Dungeon.

You can also see a grate (empty) here.

>south

>south
Generator Room
The generator room is small, with concrete walls stained by oil and grime. The air smells of diesel, metal, and damp earth.

The main generator hums, connected by thick cables to circuit breakers and a cluttered panel with switches and gauges. A flickering display shows power levels. The cracked floor is littered with puddles. Shelves hold spare parts and manuals, and a workbench sits next to a grease canister.

The room is the carnival's power source, hidden but essential.

The backstage area continues north and south of here.

Nearby an indigo colored door leads west to the Guillotine Room.

>south

>south
Electrical Room
The electrical room is small, hidden behind the carnival's attractions. The air smells of overheated wires and metal.

A central breaker panel dominates one wall, with labels like "Ferris Wheel Lights" and "Carousel Motors." Indicator lights blink intermittently. Thick cables hang from the ceiling, connected to the carnival's power network.

A junction box spills wires, and a workbench holds tools and a smudged wiring diagram. The floor is scratched and stained. A faint vibration pulses in the air.

An emergency shutdown panel and fire extinguisher sit nearby. Fluorescent lights cast shifting shadows. The room is raw and essential, a behind-the-scenes look at the carnival's power.

This room is eerily quiet, missing the ever present buzz of electricity. There are exits in all directions.

>south

>south
Storage Room
The storage room is cramped and hidden, with rusted walls and peeling wood. The air smells of dust, damp canvas, and stale popcorn.

Shelves are packed with light bulbs, wire, and old ride parts. Flags, lights, and crates of toys clutter the space. In one corner, tarps and tent poles are stacked.

Spare ride seats and an old carousel horse sit under tarps in the center. A cluttered desk holds schedules and coffee cups, with a bulletin board full of flyers.

The concrete floor is littered with scraps and dirt. Rats scurry and cobwebs move. This forgotten room stores the remnants of the carnival, waiting to be revived.

There is an exit to the north.

Nearby a khaki colored door leads west.

>west

>west
(first opening the khaki colored door)
(first unlocking the khaki colored door)
(with the silver key)

Ride Exit
The exit of Hell Ride leaves you unsettled. You emerge from a dark corridor, the walls peeling and streaked with black and red. Flickering lights cast shifting shadows on the sloped floor, and the air is damp with a metallic tang. Whispers and distant screams echo softly in the background.

In a small courtyard, a rusted fence draped with cobwebs and plastic bones encloses the area. A worn sign reads, "You've Survived? For Now." Nearby, carnival workers in tattered costumes watch quietly, muttering, "Not everyone makes it out."

The nearby gift shop glows red. The bright lights and sounds of the carnival feel distant and jarring after the oppressive atmosphere of the ride.

The exit ensures Hell Ride isn't just an experience - it lingers, blurring the line between thrill and fear.

There is a price list next to the cash register. An attendant is here to assist you with your purchases. The stand has aqua colored fuse, Plastic Bones, Devil Horns, Key Chains, and T-Shirts for sale.

Nearby a wooden door leads east to the Storage Room.

You can also see a merchandise attendant here.

>read sign

>read sign
$2.00 Key Chains
$3.50 Aqua Colored Fuse
$2.00 Devil Horns
$1.00 Plastic Bones
$7.50 T-Shirts

>buy aqua fuse

>buy aqua fuse
You fork over $3.50 for the aqua colored fuse, leaving yourself with $13.50.
(putting the horseshoe magnet into the fanny pack to make room)

[Your score has just gone up by ten points.]

>east

>east
Storage Room
The storage room is cramped and hidden, with rusted walls and peeling wood. The air smells of dust, damp canvas, and stale popcorn.

Shelves are packed with light bulbs, wire, and old ride parts. Flags, lights, and crates of toys clutter the space. In one corner, tarps and tent poles are stacked.

Spare ride seats and an old carousel horse sit under tarps in the center. A cluttered desk holds schedules and coffee cups, with a bulletin board full of flyers.

The concrete floor is littered with scraps and dirt. Rats scurry and cobwebs move. This forgotten room stores the remnants of the carnival, waiting to be revived.

There is an exit to the north.

Nearby a khaki colored door leads west to the Ride Exit.

>north

>north
Electrical Room
The electrical room is small, hidden behind the carnival's attractions. The air smells of overheated wires and metal.

A central breaker panel dominates one wall, with labels like "Ferris Wheel Lights" and "Carousel Motors." Indicator lights blink intermittently. Thick cables hang from the ceiling, connected to the carnival's power network.

A junction box spills wires, and a workbench holds tools and a smudged wiring diagram. The floor is scratched and stained. A faint vibration pulses in the air.

An emergency shutdown panel and fire extinguisher sit nearby. Fluorescent lights cast shifting shadows. The room is raw and essential, a behind-the-scenes look at the carnival's power.

This room is eerily quiet, missing the ever present buzz of electricity. There are exits in all directions.

>northeast

>northeast
Electrical Closet One
This is Electrical Closet One. There's an electrical panel here and an exit to the southwest.

>open panel

>open panel
(first unlocking Electrical Panel 1)
(with the knock-off Swiss Army knife)
Using the screwdriver on the knock-off Swiss Army knife, you remove the screws holding the electrical panel shut.

You open Electrical Panel 1.

>put aqua fuse in socket

>put aqua fuse in socket
You hear a satisfying snick as the aqua fuse slides into place.

>flip switch

>flip switch
You switch Electrical Panel 1's switch on.

The aqua indicator's light goes on.

[Your score has just gone up by five points.]

>southwest

>southwest
Electrical Room
The electrical room is small, hidden behind the carnival's attractions. The air smells of overheated wires and metal.

A central breaker panel dominates one wall, with labels like "Ferris Wheel Lights" and "Carousel Motors." Indicator lights blink intermittently. Thick cables hang from the ceiling, connected to the carnival's power network.

A junction box spills wires, and a workbench holds tools and a smudged wiring diagram. The floor is scratched and stained. A faint vibration pulses in the air.

An emergency shutdown panel and fire extinguisher sit nearby. Fluorescent lights cast shifting shadows. The room is raw and essential, a behind-the-scenes look at the carnival's power.

This room is eerily quiet, missing the ever present buzz of electricity. There are exits in all directions.

>east

>east
Electrical Closet Three
This is Electrical Closet Three. There's an electrical panel here and an exit to the west.

>open panel

>open panel
(first unlocking Electrical Panel 3)
(with the knock-off Swiss Army knife)
Using the screwdriver on the knock-off Swiss Army knife, you remove the screws holding the electrical panel shut.

You open Electrical Panel 3.

>put crimson fuse in socket

>put crimson fuse in socket
You hear a satisfying snick as the crimson fuse slides into place.

>flip switch

>flip switch
You switch Electrical Panel 3's switch on.

The crimson indicator's light goes on.

[Your score has just gone up by five points.]

>west

>west
Electrical Room
The electrical room is small, hidden behind the carnival's attractions. The air smells of overheated wires and metal.

A central breaker panel dominates one wall, with labels like "Ferris Wheel Lights" and "Carousel Motors." Indicator lights blink intermittently. Thick cables hang from the ceiling, connected to the carnival's power network.

A junction box spills wires, and a workbench holds tools and a smudged wiring diagram. The floor is scratched and stained. A faint vibration pulses in the air.

An emergency shutdown panel and fire extinguisher sit nearby. Fluorescent lights cast shifting shadows. The room is raw and essential, a behind-the-scenes look at the carnival's power.

This room is eerily quiet, missing the ever present buzz of electricity. There are exits in all directions.

>southeast

>southeast
Electrical Closet Five
This is Electrical Closet Five. There's an electrical panel here and an exit to the northwest.

>open panel

>open panel
(first unlocking Electrical Panel 5)
(with the knock-off Swiss Army knife)
Using the screwdriver on the knock-off Swiss Army knife, you remove the screws holding the electrical panel shut.

You open Electrical Panel 5.

>put emerald fuse in socket

>put emerald fuse in socket
You hear a satisfying snick as the emerald fuse slides into place.

>flip switch

>flip switch
You switch Electrical Panel 5's switch on.

The emerald indicator's light goes on.

[Your score has just gone up by five points.]

>northwest

>northwest
Electrical Room
The electrical room is small, hidden behind the carnival's attractions. The air smells of overheated wires and metal.

A central breaker panel dominates one wall, with labels like "Ferris Wheel Lights" and "Carousel Motors." Indicator lights blink intermittently. Thick cables hang from the ceiling, connected to the carnival's power network.

A junction box spills wires, and a workbench holds tools and a smudged wiring diagram. The floor is scratched and stained. A faint vibration pulses in the air.

An emergency shutdown panel and fire extinguisher sit nearby. Fluorescent lights cast shifting shadows. The room is raw and essential, a behind-the-scenes look at the carnival's power.

This room is eerily quiet, missing the ever present buzz of electricity. There are exits in all directions.

>southwest

>southwest
Electrical Closet Seven
This is Electrical Closet Seven. There's an electrical panel here and an exit to the northeast.

>open panel

>open panel
(first unlocking Electrical Panel 7)
(with the knock-off Swiss Army knife)
Using the screwdriver on the knock-off Swiss Army knife, you remove the screws holding the electrical panel shut.

You open Electrical Panel 7.

>put gray fuse in socket

>put gray fuse in socket
You hear a satisfying snick as the gray fuse slides into place.

>flip switch

>flip switch
You switch Electrical Panel 7's switch on.

The gray indicator's light goes on.

[Your score has just gone up by five points.]

>northeast

>northeast
Electrical Room
The electrical room is small, hidden behind the carnival's attractions. The air smells of overheated wires and metal.

A central breaker panel dominates one wall, with labels like "Ferris Wheel Lights" and "Carousel Motors." Indicator lights blink intermittently. Thick cables hang from the ceiling, connected to the carnival's power network.

A junction box spills wires, and a workbench holds tools and a smudged wiring diagram. The floor is scratched and stained. A faint vibration pulses in the air.

An emergency shutdown panel and fire extinguisher sit nearby. Fluorescent lights cast shifting shadows. The room is raw and essential, a behind-the-scenes look at the carnival's power.

This room is eerily quiet, missing the ever present buzz of electricity. There are exits in all directions.

>west

>west
Electrical Closet Nine
This is Electrical Closet Nine. There's an electrical panel here and an exit to the east.

>open panel

>open panel
(first unlocking Electrical Panel 9)
(with the knock-off Swiss Army knife)
Using the screwdriver on the knock-off Swiss Army knife, you remove the screws holding the electrical panel shut.

You open Electrical Panel 9.

>put indigo fuse in socket

>put indigo fuse in socket
You hear a satisfying snick as the indigo fuse slides into place.

>flip switch

>flip switch
You switch Electrical Panel 9's switch on.

The indigo indicator's light goes on.

[Your score has just gone up by five points.]

>east

>east
Electrical Room
The electrical room is small, hidden behind the carnival's attractions. The air smells of overheated wires and metal.

A central breaker panel dominates one wall, with labels like "Ferris Wheel Lights" and "Carousel Motors." Indicator lights blink intermittently. Thick cables hang from the ceiling, connected to the carnival's power network.

A junction box spills wires, and a workbench holds tools and a smudged wiring diagram. The floor is scratched and stained. A faint vibration pulses in the air.

An emergency shutdown panel and fire extinguisher sit nearby. Fluorescent lights cast shifting shadows. The room is raw and essential, a behind-the-scenes look at the carnival's power.

This room is eerily quiet, missing the ever present buzz of electricity. There are exits in all directions.

>northwest

>northwest
Electrical Closet Eleven
This is Electrical Closet Eleven. There's an electrical panel here and an exit to the southeast.

>open panel

>open panel
(first unlocking Electrical Panel 11)
(with the knock-off Swiss Army knife)
Using the screwdriver on the knock-off Swiss Army knife, you remove the screws holding the electrical panel shut.

You open Electrical Panel 11.

>put khaki fuse in socket

>put khaki fuse in socket
You hear a satisfying snick as the khaki fuse slides into place.

>flip switch

>flip switch
You switch Electrical Panel 11's switch on.

The khaki indicator's light goes on.

[Your score has just gone up by five points.]

>southeast

>southeast
Electrical Room
The electrical room is small, hidden behind the carnival's attractions. The air smells of overheated wires and metal.

A central breaker panel dominates one wall, with labels like "Ferris Wheel Lights" and "Carousel Motors." Indicator lights blink intermittently. Thick cables hang from the ceiling, connected to the carnival's power network.

A junction box spills wires, and a workbench holds tools and a smudged wiring diagram. The floor is scratched and stained. A faint vibration pulses in the air.

An emergency shutdown panel and fire extinguisher sit nearby. Fluorescent lights cast shifting shadows. The room is raw and essential, a behind-the-scenes look at the carnival's power.

This room is eerily quiet, missing the ever present buzz of electricity. There are exits in all directions.

>north

>north
Generator Room
The generator room is small, with concrete walls stained by oil and grime. The air smells of diesel, metal, and damp earth.

The main generator hums, connected by thick cables to circuit breakers and a cluttered panel with switches and gauges. A flickering display shows power levels. The cracked floor is littered with puddles. Shelves hold spare parts and manuals, and a workbench sits next to a grease canister.

The room is the carnival's power source, hidden but essential.

The backstage area continues north and south of here.

Nearby an indigo colored door leads west to the Guillotine Room.

>north

>north
Mechanical Room South
The south mechanical room is the heart of the ride, with a massive motor powering the thick belts, pulleys, and gears. Electrical panels line the walls, flashing "High Voltage" and colorful indicator lights.

Conduits and wires snake across the ceiling, connecting systems. A cluttered table holds tools, spare parts, and maintenance logs stained with grease. The air smells of oil, metal, and ozone.

A cooling fan struggles to cut the warmth as the hum of machinery mixes with the hiss of hydraulics and clinking chains. The floor is a patchwork of metal grates and worn concrete. The room is busy; every movement is precise and controlled.

You can travel north and south from here.

Nearby a gray colored door leads west to the Dungeon.

You can also see a grate (empty) here.

>north

>north
Mechanical Room North
The north mechanical room is compact, housing auxiliary systems for the ride. A soft hum of capacitors and relays fills the space, interrupted only by the occasional hissing of hydraulic fluid.

Circuit breaker panels line the walls, labeled for different functions. Cables and conduits connect the systems to the main hub. Flickering with gauges, a hydraulic pump in the corner manages lifting arms and platforms.

A small workbench is cluttered with parts, while shelves above hold spare parts like cables and hydraulic tubing. A faded ride diagram with red annotations is pinned nearby. The room feels cool and damp.

There are exists north and south.

Nearby an emerald colored door leads west to the Stake Room.

You can also see a toolbox (in which are some channel locks and a hammer) here.

>north

>north
Crawl Space
The crawl space beneath the ride is cramped and dark, filled with the hum of machinery above. The air is thick with oil and rust. Sounds echo - groaning steel, clanking chains, and the rhythmic thrum of motors.

The ground is uneven, a mix of dirt, gravel, and scattered tools. Pipes overhead are wrapped in fraying insulation, crackling as you move. Small puddles of murky water collect.

The backstage area continues north and south.

Nearby a crimson colored door leads west to the Gallows Room.

>north

>north
Maintenance Office
The maintenance office is a dim, cluttered space, filled with the smells of grease, sweat, and popcorn. Disorganized shelves are lined with tools and parts, while paint cans and grease jars clutter the workbenches. A battered desk holds wires, gears, and springs, with a bent piece of metal in a vise.

A flickering fluorescent light barely brightens the room. In one corner, a disassembled ride mechanism hangs with chains and pulleys. A greasy manual and a half-empty coffee mug sit on a nearby stool.

Faded safety posters and a worn photo of the carnival decorate the walls, along with a corkboard full of schedules and notes, and a worn photo of the carnival in its prime. The floor is gritty with dust and scattered nails. Despite the mess, the room buzzes with purpose and keeps the carnival running, fueled by sweat and ingenuity.

Exits lead north and south.

Nearby a ladder leads up to Dark Hallway.

Nearby an aqua colored door leads west to the Stocks Room.

You can also see a worn photo and a desk (on which are a coffee mug and a radio) here.

>north

>north
Dark Passage
This room is backstage at the Hell Ride attraction. The room is littered with bags of trash, piles of junk, and dust bunnies so large they should be paying rent. There an exit to the south and west.

>west

* * *

>north
Head of the Line
You are standing in front of an attendant. The entrance to the ride is south of here. The ride operator tells you that you're lucky you showed up when you did because this will be the last trip through Hell Ride for the night. You notice that all the other cars are empty. The Ticket Kiosk is north of here.

You can see a Hell Ride attendant here.

The janitor arrives from the Ticket Booth.

>north

>north
Ticket Booth
Painted in bright red and yellow stripes, the ticket kiosk stands at the entrance with flickering lights to draw attention. A smiling cashier hands out tickets, while the cash drawer jingles. A digital payment system sits in the corner. Too bad you don't have a debit card.

To the right, a signboard displays ticket prices alongside illustrations of the rides. Pennant flags flutter and the air is filled with the scent of popcorn, pretzels, and grease.

The ground is worn from the steps of carnival goers eagerly waiting in line as they approach the midway.

The midway continues in all directions from here. There is a cashier here. A price list for attraction tickets is on the signboard. The cashier has Ferris Wheel ticket.

You can see a cashier here.

>south

>south
Head of the Line
You are standing in front of an attendant. The entrance to the ride is south of here. The ride operator tells you that you're lucky you showed up when you did because this will be the last trip through Hell Ride for the night. You notice that all the other cars are empty. The Ticket Kiosk is north of here.

You can see a janitor and a Hell Ride attendant here.

>ask janitor about himself

>ask janitor about himself
The janitor looks at you and waits for you to proceed.

The janitor says, "I'm the maintenance engineer for the carnival. I've been working here for the past four years."

>ask janitor about whidbey

>ask janitor about whidbey
The janitor looks bored as he waits for you to speak.

The janitor says , "Mr. Whidbey? He creeps me out. It always seems like he's hiding something. Just yesterday I caught him sneaking around the guillotine room in Hell Ride."

You've collected some new evidence.

>ask janitor about hell ride

>ask janitor about hell ride
The janitor looks at you expectantly.

"Hell Ride is a finicky ride. I'm fixing something there every week. Last week, Mr. Whidbey asked me to skip Hell Ride's maintenance slot. There was a real fire in the Stakes Room last month. And just yesterday I caught him creeping around the guillotine room" says the janitor.

You've collected some new evidence.

>ask janitor about accidents

>ask janitor about accidents
The janitor looks at you and waits for you to proceed.

The janitor says "The fire, the Ferris wheel, the Bumper Cars... That's a lot of suspicious accidents."

You've collected some new evidence.

>ask janitor about fire

>ask janitor about fire
The janitor looks at you expectantly.

"The very real fire in the Stakes Room in Hell Ride was a scary event. I couldn't put it out with a fire extinguisher. We had to wait for the fire department and by then there was a lot of damage done" says the janitor.

You've collected some new evidence.

>show cash "n" carry to janitor

>show cash "n" carry to janitor
You can only do that to something animate.

>show frank's to janitor

>show frank's to janitor
The janitor says, "Looks like the carnival is in some financial trouble."

You've collected some new evidence.

>show oriental trading to janitor

>show oriental trading to janitor
The janitor says, "These prizes are cheaper and flimsier than usual."

You've collected some new evidence.

>north

>north
Ticket Booth
Painted in bright red and yellow stripes, the ticket kiosk stands at the entrance with flickering lights to draw attention. A smiling cashier hands out tickets, while the cash drawer jingles. A digital payment system sits in the corner. Too bad you don't have a debit card.

To the right, a signboard displays ticket prices alongside illustrations of the rides. Pennant flags flutter and the air is filled with the scent of popcorn, pretzels, and grease.

The ground is worn from the steps of carnival goers eagerly waiting in line as they approach the midway.

The midway continues in all directions from here. There is a cashier here. A price list for attraction tickets is on the signboard. The cashier has Ferris Wheel ticket.

You can see a cashier here.

>northwest

>northwest
Bumper Cars
The bumper cars are a lively scene of flashing lights and vibrant decorations. The arena is surrounded by padded barriers, ensuring the rider's safety. Cars in faded reds, blues, yellows, and greens glide across the slick floor, each equipped with a steering wheel and padded bumper. Riders maneuver their cars with intensity, creating a din of bumps and laughter. Overhead, electric poles hum with energy. While onlookers cheer from the sidelines, the bumper cars offer playful competition and nostalgic fun for all. The Ticket Kiosk is southeast of here.

You can see a janitor and a Bumper Cars attendant here.

>show mystic to janitor

>show mystic to janitor
The janitor says, That fire in Hell Ride was really bad. It took almost two weeks to get it fully repaired. But it shouldn't have cost this much. I think Mr Whidbey got ripped off. Or, he got it fixed on the cheap and pocketed the rest."

You've collected some new evidence.

>ask janitor about ferris wheel

>ask janitor about ferris wheel
The janitor looks at you and waits for you to proceed.

The janitor remarks, "The other day, I found a bolt on one of the gondolas so loose it had almost come off. That would have been a tragedy!"

You've collected some new evidence.

>ask janitor about bumper cars

>ask janitor about bumper cars
The janitor looks at you expectantly.

The janitor says, "That reminds me. Not long ago, one of the bumper cars was shorting out and electrifying the car. A visitor got hurt. A young lad, what was his name? Fred something, I think."

You've collected some new evidence.

>show check stub to janitor

>show check stub to janitor
(first taking the check stub)
The janitor says "What?! That's the name of the kid who got hurt in the Bumper Cars incident."

You've collected some new evidence.

The janitor heads to the Ticket Booth.

[Your score has just gone up by ten points.]

>southeast

>southeast
Ticket Booth
Painted in bright red and yellow stripes, the ticket kiosk stands at the entrance with flickering lights to draw attention. A smiling cashier hands out tickets, while the cash drawer jingles. A digital payment system sits in the corner. Too bad you don't have a debit card.

To the right, a signboard displays ticket prices alongside illustrations of the rides. Pennant flags flutter and the air is filled with the scent of popcorn, pretzels, and grease.

The ground is worn from the steps of carnival goers eagerly waiting in line as they approach the midway.

The midway continues in all directions from here. There is a cashier here. A price list for attraction tickets is on the signboard. The cashier has Ferris Wheel ticket.

You can see a janitor, Mr Whidbey, and a cashier here.

>southeast

>southeast
Fortune Teller
Approaching the fortune teller's booth, you are drawn in by its mysterious allure and inky softness. Draped in deep purple curtains adorned with golden moons and stars, the booth is lit only with the flickering of candles. The air is heavy with the scent of incense, mingling with and then overpowering the ever-present sugary odor of carnival treats. A sign sways slightly in the evening breeze.

You can see Esmeralda here.

>ask esmeralda about accidents

>ask esmeralda about accidents
Esmeralda says "Things sure seem vulnerable at this time."

You've collected some new evidence.

>ask esmeralda about fire

>ask esmeralda about fire
"There was a fire in one of the rooms in Hell Ride," says Esmeralda.

You've collected some new evidence.

>ask esmeralda about hell ride

>ask esmeralda about hell ride
"Hell Ride is the flagship ride at Whidbey Amusements. It's always made me feel nervous," says Esmeralda.

You've collected some new evidence.

>ask esmeralda about whidbey

>ask esmeralda about whidbey
Esmeralda says , "Mr. Whidbey? He creeps me out. He's up to something."

You've collected some new evidence.

>show insurance policy to esmeralda

>show insurance policy to esmeralda
"An insurance policy? For a million dollars? Something is fishy for sure!" Esmeralda says.

You've collected some new evidence.

>give ticket to esmeralda

>give ticket to esmeralda
(the Fortune Teller ticket to Esmeralda)
(first taking the Fortune Teller ticket)
You give the Fortune Teller ticket to Esmeralda.

Stepping inside, you're greeted by Esmeralda, a figure cloaked in flowing robes with a jeweled headpiece catching the flickering light. Her piercing eyes seem to look right through you as they gesture for you to sit at a small round table. At its center rests a glowing crystal ball, surrounded by tarot cards and mysterious trinkets.

Esmeralda's voice is low and melodic, weaving an air of intrigue as they ask you to focus on a question and offer you a tarot reading. The room seems to shrink, the bustling carnival outside fading into the background as she reveals your fate. Each card turned feels significant, as though unlocking a secret you didn't know you carried.

Past: Eight of Cups (reversed)
Eight of Cups reversed indicates suggests that you may be clinging tightly to your comfort zone, even if it no longer serves your best interests. This card urges you to examine whether you are avoiding necessary growth or ignoring your true desires. It may be tempting to remain in familiar territory, but by doing so, you risk missing out on the opportunities that lie ahead. Now is the time to summon the courage to explore new horizons and embrace the unknown.

>wait

>wait
Time passes.

Present: Knight of Swords (reversed)
Knight of Swords reversed signifies a lack of strategy, where actions are taken without much thought or consideration for the consequences. It suggests a tendency to rush into situations without a clear plan, leading to hasty decisions and potential conflicts. This reversed Knight warns against reckless behavior and encourages the need for patience and careful deliberation. It serves as a reminder to slow down, reflect, and align actions with a well-thought-out strategy in order to avoid unnecessary conflicts and achieve the desired outcomes.

>wait

>wait
Time passes.

Challenge: The Devil (reversed)
Devil reversed indicate temptations resisted, stricter moral kept and an escape from the chains from the devil. It offers hope and liberation. The Devil reversed brings the strength and self awareness to confront your inner demons and break free from the suffocating bonds that have kept you trapped in patterns of self-destruction. It is a powerful call to examine your attachments, whether they be toxic relationships, harmful habits, or limiting beliefs.

>wait

>wait
Time passes.

Opportunity: The Fool (upright)
Fool represents new beginnings and feeling carefree. It may indicate a new phase in your life such as starting a new job, moving to a new city, or beginning a new relationship. Embrace this new chapter with optimism and an open heart. The Fool reminds you that it's never too late to start fresh and that you can always take a leap of faith towards your dreams.

>wait

>wait
Time passes.

Future: The Devil (upright)
Devil symbolizes primal behaviors, desires and addictions and materialism. It represents the fears that causes obsession and compulsive behavior. Its ominous appearance serves as a reminder that you may find yourself caught in the snare of worldly desires and unhealthy patterns. This card is a wake-up call to face your fears and conquer them. This is a card of temptation, and it's warning you to be careful of what you allow to control you.

As the reading concludes, Esmeralda gazes into your eyes with a cryptic smile and delivers their final words of wisdom: "The order of things is important. Alphabetically and numerically; one follows another and provides the link between the two. If you will learn, think on this carefully. Also, don't trust Whidbey. He's up to something."

Whether you leave with a sense of wonder or unease, the encounter lingers with you - it's a touch of magic amid the bustling carnival, as if you've glimpsed something beyond the ordinary.

>northwest

>northwest
Ticket Booth
Painted in bright red and yellow stripes, the ticket kiosk stands at the entrance with flickering lights to draw attention. A smiling cashier hands out tickets, while the cash drawer jingles. A digital payment system sits in the corner. Too bad you don't have a debit card.

To the right, a signboard displays ticket prices alongside illustrations of the rides. Pennant flags flutter and the air is filled with the scent of popcorn, pretzels, and grease.

The ground is worn from the steps of carnival goers eagerly waiting in line as they approach the midway.

The midway continues in all directions from here. There is a cashier here. A price list for attraction tickets is on the signboard. The cashier has Fortune Teller ticket and Ferris Wheel ticket.

You can see a janitor and a cashier here.

>south

>south
Head of the Line
You are standing in front of an attendant. The entrance to the ride is south of here. The ride operator tells you that you're lucky you showed up when you did because this will be the last trip through Hell Ride for the night. You notice that all the other cars are empty. The Ticket Kiosk is north of here.

You can see a Hell Ride attendant here.

>south

>south
Ride Entrance
The cars for Hell Ride stop here, and the safety bar clicks into place as riders board the cars. Ahead, the grotesque entrance looms - a twisted metal archway adorned with spikes, skulls, and flickering blood-red lights. A faint sulfuric smell mixes with the scent of popcorn.

The "HELL RIDE" sign pulses above the door, while demon statues with clawed hands seem to beckon. The entrance is shrouded in darkness, broken only by eerie green flashes that reveal twisted paths. Faint whispers and distant organ music grow louder. To one side, the darkness looks a little bit darker than the rest of the room.

You can see a Hell Ride car (empty) here.

>east

>east
Dark Passage
This room is backstage at the Hell Ride attraction. The room is littered with bags of trash, piles of junk, and dust bunnies so large they should be paying rent. There an exit to the south and west.

You can see Mr Whidbey here.

>ask whidbey about himself

>ask whidbey about himself
Mr Whidbey looks at you expectantly.

"I've been at the helm of Whidbey Amusements since 1991. We've seen a lot of changes in that time," says Mr Whidbey.

>ask whidbey about hell ride

>ask whidbey about hell ride
Mr Whidbey waits for you to speak.

"Hell Ride is the premier attraction here at Whidbey Amusements. It's both spooky and fun! The visitors love it! The fire last month was unfortunate and expensive" says Mr Whidbey.

>ask whidbey about accidents

>ask whidbey about accidents
Mr Whidbey nervously shifts his weight from one foot to the other.

Mr Whidbey says, "Oh, that's nothing to worry about. Little things happen all the time, right?"

You've collected some new evidence.

>ask whidbey about fire

>ask whidbey about fire
Mr Whidbey waits for you to speak.

The fire was most unfortunate. It put Hell Ride out of commission for two weeks. Not only did it cost me $22,500 to repair but I lost revenue while it was closed.

Mr. Whidbey's eyes dart up and to the left.

You've collected some new evidence.

>ask whidbey about indigo fuse

>ask whidbey about indigo fuse
Mr Whidbey looks at you expectantly.

"Where did you get that?" Mr Whidbey asks.

You've collected some new evidence.

>ask whidbey about pliers

>ask whidbey about pliers
Mr Whidbey nervously shifts his weight from one foot to the other.

"Oh! I thought I lost... um, those belong to the janitor. Where did you find them?" asks Mr Whidbey.

You've collected some new evidence.

>ask whidbey about bumper cars

>ask whidbey about bumper cars
Mr Whidbey waits for you to speak.

"That incident the other week with that Needleman kid was unfortunate" says Mr Whidbey.

You've collected some new evidence.

>south

>south
Maintenance Office
The maintenance office is a dim, cluttered space, filled with the smells of grease, sweat, and popcorn. Disorganized shelves are lined with tools and parts, while paint cans and grease jars clutter the workbenches. A battered desk holds wires, gears, and springs, with a bent piece of metal in a vise.

A flickering fluorescent light barely brightens the room. In one corner, a disassembled ride mechanism hangs with chains and pulleys. A greasy manual and a half-empty coffee mug sit on a nearby stool.

Faded safety posters and a worn photo of the carnival decorate the walls, along with a corkboard full of schedules and notes, and a worn photo of the carnival in its prime. The floor is gritty with dust and scattered nails. Despite the mess, the room buzzes with purpose and keeps the carnival running, fueled by sweat and ingenuity.

Exits lead north and south.

Nearby a ladder leads up to Dark Hallway.

Nearby an aqua colored door leads west to the Stocks Room.

You can also see a worn photo and a desk (on which are a coffee mug and a radio) here.

>west

>west
Stocks Room
The public square is a cobblestone stretch surrounded by weathered buildings. The air smells of smoke, damp earth, and a nearby smithy. At the center, old stocks stand with iron clasps holding captives in shameful positions. Their tattered clothes offer little against the cold wind.

The animatronics are lifelike, enhancing the grim atmosphere. The crowd mocks the prisoners, hurling insults and rotten food. Jeers mix with their laughter. The square hums with noise. Unnoticed by the crowd, the sky darkens as the spectacle continues.

Nearby a wooden door leads east to the Maintenance Office.

You can also see a wooden stocks here.

>show check stub to whidbey

>show check stub to whidbey
You can't see any such thing.

>ask whidbey about needleman

>ask whidbey about needleman
You can't see any such thing.

>show mystic to whidbey

>show mystic to whidbey
You can't see any such thing.

>show evidence

>show evidence
Weight   Evidence collected:
  ------   --------------------------------------------------------
•    58    Evidence concerning accidents with the attractions
•     8    Evidence concerning insurance
•     6    Evidence concerning Mr Whidbey
•     5    Evidence concerning fuses
•     2    Evidence concerning past due invoices
  ------   --------------------------------------------------------
•    79    Total Weighted Evidence

You've got enough evidence for a conviction.

>east

>east
Maintenance Office
The maintenance office is a dim, cluttered space, filled with the smells of grease, sweat, and popcorn. Disorganized shelves are lined with tools and parts, while paint cans and grease jars clutter the workbenches. A battered desk holds wires, gears, and springs, with a bent piece of metal in a vise.

A flickering fluorescent light barely brightens the room. In one corner, a disassembled ride mechanism hangs with chains and pulleys. A greasy manual and a half-empty coffee mug sit on a nearby stool.

Faded safety posters and a worn photo of the carnival decorate the walls, along with a corkboard full of schedules and notes, and a worn photo of the carnival in its prime. The floor is gritty with dust and scattered nails. Despite the mess, the room buzzes with purpose and keeps the carnival running, fueled by sweat and ingenuity.

Exits lead north and south.

Nearby an aqua colored door leads west to the Stocks Room.

Nearby a ladder leads up to Dark Hallway.

You can also see a worn photo and a desk (on which are a coffee mug and a radio) here.

>up

>up
Dark Hallway
This is a poorly lit hallway. Ahead to the west you can see the glow of an open door.

Nearby a ladder leads down to the Maintenance Office.

Nearby a metal door leads west to Control Room.

>west

>west
Control Room
The backstage control room is a functional space with gray, scuffed walls. A large monitor shows live feeds while control panels with dials, buttons, and lights manage the rides and systems. The panels remain oddly dark.

The hum of electronics is interrupted by a crackling radio: "Maintenance to Bumper Cars - wrench needed!" Papers, tools, and coffee cups clutter the floor. A desk holds logs and schedules, and a corkboard displays charts and red-marked notes, including one that says "Check Zipper circuit breakers."

A single light casts harsh shadows, and the air smells of lubricant and burnt wires, mingling with dampness. The room is hidden but vital, keeping the carnival running. On one wall, a switch sparks with blue and white arcs.

On one wall is a large switch.

Nearby a metal door leads east to Dark Hallway.

You can also see a big switch here.

>spin aqua dial to 1

>spin aqua dial to 1
The aqua colored dial is now set to 1.

>set crimson dial to 3

>set crimson dial to 3
The crimson colored dial is now set to 3.

>set emerald dial to 5

>set emerald dial to 5
The emerald colored dial is now set to 5.

>turn gray dial to 7

>turn gray dial to 7
The gray colored dial is now set to 7.

>turn indigo dial to 9

>turn indigo dial to 9
The indigo colored dial is now set to 9.

>turn khaki dial to 11

>turn khaki dial to 11
The khaki colored dial is now set to 11.

>push indigo button

>push indigo button
You switch the indigo button on.

The monitor flickers for a second and the scene it displays changes to something different.
The monitor now shows a tableau of a guillotine rising and falling over the ride exit.
The indigo light is now on.

As you push the indigo button, the monitor switches to a view of the guillotine room. You still see the blade rising and falling over the cars. Suddenly, the blade starts slowing down, taking longer and longer to fall. Until it finally comes to a complete rest.

The room is heavy with uneasy silence. Hell Ride, once a thrilling spectacle, now looms motionless, as the guillotine blade is frozen halfway down its track. Moments ago, chaos erupted as the malfunctioning mechanism sent the blade crashing unpredictably, ripping through the roofs of cars on the track.

A single car, its roof gashed open, sits under the still blade - a grim reminder of the disaster narrowly averted. Above, a black crow lands on the guillotine's frame, its sharp caw cutting through the murmurs of anger and fear.

Two mechanics climb the scaffolding with tools in hand, their appearance met with wary hope. A crowd has gathered and is watching, holding their breath, as the cursed ride's fate hangs in the balance. After a moment, applause rises from the assembled crowd, cheering your accomplishment.

Mr. Whidbey, the Mayor, the Chief of Police, and the janitor arrive on the scene and extend their gratitude for saving the day, not to mention lives!

"But wait", you say, "There is more afoot here than meets the eye. I think we need to talk to Mr Whidbey some more... confront him about a few things. Accusations might be made."

Mr Whidbey exclaims, "Accusations? What accusations?"

The Police Chief listens with interest to what you have to say.

>show evidence to chief

* * *

>purloin all keys, all tickets, all invoices, all fuses, bubblegum, insurance policy, check stub
[Purloined.]
[Purloined.]
[Purloined.]
[Purloined.]
[Purloined.]
[Purloined.]
[Purloined.]
[Purloined.]
[Purloined.]
[Purloined.]
[Purloined.]
[Purloined.]
[Purloined.]
[Purloined.]
[Purloined.]
[Purloined.]
[Purloined.]
[Purloined.]
[Purloined.]
[Purloined.]
[Purloined.]
[Purloined.]

>gonear barker
Show Facade
As you walk west through the midway, the lights fade to a soft glow, leading you to a tent. A sign reads "Little Egypt Show - A Journey Into the Mysterious and Unknown!" The barker, wearing a fez and smiling, points to another sign: "Little Egypt - Dime Admission." The ticket kiosk is behind you to the east.

There is a stage in front of the tent. The Barker is encouraging you to step up and enjoy.

You can see a Barker here.

[Your score has just gone up by five points.]

[Your score has just gone up by five points.]

[Your score has just gone up by five points.]

[Your score has just gone up by five points.]

[Your score has just gone up by five points.]

[Your score has just gone up by five points.]

[Your score has just gone up by ten points.]

[Your score has just gone up by ten points.]

[Your score has just gone up by ten points.]

[Your score has just gone up by ten points.]

[Your score has just gone up by ten points.]

[Your score has just gone up by ten points.]

[Your score has just gone up by five points.]

[Your score has just gone up by five points.]

[Your score has just gone up by ten points.]

>show cash 'n' carry to barker
The Barker says, "Seems like the carnival is in trouble financially."

You've collected some new evidence.

You've discovered some evidence. To see a list and weighting of the evidence you've collected, type "SHOW EVIDENCE". To collect more evidence, try to ASK someone ABOUT something. Or SHOW something TO someone.

>show oriental to barker
The Barker says, "Seems like the carnival is in trouble financially."

You've collected some new evidence.

>show mystic
(to the Barker)
The Barker says, "Seems like the carnival is in trouble financially."

You've collected some new evidence.

>shot frank's
I didn't understand that sentence.

>show frank's
(to the Barker)
The Barker says, "Seems like the carnival is in trouble financially."

You've collected some new evidence.

>show policy
(to the Barker)
"An insurance policy? For a million dollars? Something is fishy for sure!" the Barker says.

You've collected some new evidence.

>show check stub
(to the Barker)
The Barker says "I know nothing about that."

You've collected some new evidence.

>show check
(to the Barker)
The Barker says "I know nothing about that."

>show evidence
Weight   Evidence collected:
  ------   --------------------------------------------------------
•     3    Evidence concerning past due invoices
•     3    Evidence concerning insurance
•     1    Evidence concerning accidents with the attractions
  ------   --------------------------------------------------------
•     7    Total Weighted Evidence

You haven't got enough evidence for an arrest.

>ask about hell ride
You can't see any such thing.

>ask barker about hell ride
"Hell Ride is our most popular attraction but there always seems to be something wrong with it," says the Barker.

You've collected some new evidence.

>ask barker about whidbey
The Barker says , "Mr. Whidbey? He's always done right by me."

You've collected some new evidence.

>ask barker about invoices
The Barker says, "These are pretty disturbing. I wonder if the carnival will close."

You've collected some new evidence.

>ask barker about policy
"What's that? An insurance policy? That seems suspicious to me," the Barker remarks.

You've collected some new evidence.

>ask barker about bumper cars
The Barker says, "There was an unfortunate accident on the bumper cars a couple of weeks ago."

You've collected some new evidence.

>ask barker about fire
"There was a fire in one of the rooms in Hell Ride," says the Barker.

You've collected some new evidence.

>ask barker about accidents
The Barker says "Things sure seem vulnerable at this time."

You've collected some new evidence.

>ask barker about attractions
"This carnival seems cursed with bad luck when it comes to the rides," says the Barker.

You've collected some new evidence.

>show evidence
Weight   Evidence collected:
  ------   --------------------------------------------------------
•    14    Evidence concerning accidents with the attractions
•     4    Evidence concerning past due invoices
•     4    Evidence concerning insurance
  ------   --------------------------------------------------------
•    22    Total Weighted Evidence

You haven't got enough evidence for an arrest.

>gonear esmeralda
Fortune Teller
Approaching the fortune teller's booth, you are drawn in by its mysterious allure and inky softness. Draped in deep purple curtains adorned with golden moons and stars, the booth is lit only with the flickering of candles. The air is heavy with the scent of incense, mingling with and then overpowering the ever-present sugary odor of carnival treats. A sign sways slightly in the evening breeze.

You can see Esmeralda here.

>show cash 'n' carry
(to Esmeralda)
Esmeralda says, "Seems like the carnival is in trouble financially."

You've collected some new evidence.

>show mystic
(to Esmeralda)
Esmeralda says, "Seems like the carnival is in trouble financially."

You've collected some new evidence.

>show frank's
(to Esmeralda)
Esmeralda says, "Seems like the carnival is in trouble financially."

You've collected some new evidence.

>show oriental
(to Esmeralda)
Esmeralda says, "Seems like the carnival is in trouble financially."

You've collected some new evidence.

>show policy
(to Esmeralda)
"An insurance policy? For a million dollars? Something is fishy for sure!" Esmeralda says.

You've collected some new evidence.

>ask esmeralda about hell ride
"Hell Ride is the flagship ride at Whidbey Amusements. It's always made me feel nervous," says Esmeralda.

You've collected some new evidence.

>ask esmeralda about whidbey
Esmeralda says , "Mr. Whidbey? He creeps me out. He's up to something."

You've collected some new evidence.

>ask esmeralda about invoces
"Hmm, I haven't the faintest," Esmeralda drawls.

>ask esmeralda about invoices
Esmeralda says, "I knew Whidbey was driving this carnival into the ground. Looks like we're all going to have to pay for it now."

You've collected some new evidence.

>ask esmeralda about policy
"An insurance policy? Looks like Mr Whidbey is up to no good," Esmeralda remarks.

You've collected some new evidence.

>ask esmeralda about bumper cars
Esmeralda says, "There was an accident on the bumper cars a couple of weeks ago. One of the riders got a good shock."

You've collected some new evidence.

>ask esmeralda about fire
"There was a fire in one of the rooms in Hell Ride," says Esmeralda.

You've collected some new evidence.

>ask esmeralda about accidents
Esmeralda says "Things sure seem vulnerable at this time."

You've collected some new evidence.

>ask esmeralda about attractions
"This carnival seems cursed with bad luck when it comes to the rides," says Esmeralda.

You've collected some new evidence.

>show evidence
Weight   Evidence collected:
  ------   --------------------------------------------------------
•    28    Evidence concerning accidents with the attractions
•     8    Evidence concerning past due invoices
•     8    Evidence concerning insurance
•     1    Evidence concerning Mr Whidbey
  ------   --------------------------------------------------------
•    45    Total Weighted Evidence

You have enough evidence to press charges.

>gonear whidbey
Dungeon
The dungeon is dark and damp, the air thick with sweat, blood, and mildew. Lanterns flicker on rusted sconces, casting twisted shadows.

Chains rattle, mixed with distant moans and screams. Water drips from a cracked ceiling, pooling on the blood-dark floor.

Instruments of torture clutter the room: a broken rack, a brazier with bloodstained tools, and a spiked chair. Prisoners endure all these things, bound or writhing in agony.

The torturer moves with cold precision, ignoring the suffering. Above, rats scurry in the shadows, and the heavy, oppressive air thickens with despair.

Nearby a wooden door leads east.

You can also see Mr Whidbey, an iron chair, a splintered rack, and a glowing brazier here.

>whidbey off
Whidbey stands still.

>show cash 'n' carry
(to Mr Whidbey)
Mr Whidbey says, "Money's a little tight. The cost of consumables go up every week."

Mr. Whidbey's eyes dart up and to the left.

You've collected some new evidence.

>show oriental
(to Mr Whidbey)
Mr Whidbey says, "There must be prizes for the games otherwise visitors wouldn't play them. Maybe people won't win so often."

You've collected some new evidence.

>show frank's
(to Mr Whidbey)
Mr Whidbey says, "I can't keep up with the cost of ingredients. Everything costs so much!"

You've collected some new evidence.

>show mystic
(to Mr Whidbey)
Mr Whidbey says, "That fire in Hell Ride was very expensive to repair. And it put the ride out of commission for two weeks."

You've collected some new evidence.

>show policy
(to Mr Whidbey)
"An insurance policy? Of course, all reputable business have insurance. Even small time carnivals", Mr Whidbey stammers.

Mr. Whidbey quickly changes the subject
You've collected some new evidence.

>purloin pliers, swiss army knife
[Purloined.]
[Purloined.]

>show pliers
(to Mr Whidbey)
"Oh! I thought I lost... I mean those belong to the janitor. Where did you find them?" asks Mr Whidbey.

You've collected some new evidence.

[Your score has just gone up by five points.]

[Your score has just gone up by five points.]

>show check
(to Mr Whidbey)
Mr Whidbey says "Uh, Fred is a special... contractor... We paid him. For services rendered."

You've collected some new evidence.

>show indigo
(to Mr Whidbey)
"Oh, um, where did you get that?" Mr Whidbey asks.

>ask whidbey about hell ride
Mr Whidbey nervously shifts his weight from one foot to the other.

"Hell Ride is the premier attraction here at Whidbey Amusements. It's both spooky and fun! The visitors love it! The fire last month was unfortunate and expensive" says Mr Whidbey.

Mr. Whidbey's eyes dart up and to the left.

>ask whidbey about invoices
Mr Whidbey looks at you expectantly.

Mr Whidbey says, "I know this doesn't look good but the cost of consumables go up every week and attendance is down. I have to pinch pennies somehow, don't I? And that fire was very expensive to repair."

You've collected some new evidence.

>ask whidbey about policy
Mr Whidbey waits for you to speak.

"An insurance policy? Of course, all reputable businesses have insurance. Even small time carnivals" Mr Whidbey stammers.

You've collected some new evidence.

>ask whidbey about policy
Mr Whidbey nervously shifts his weight from one foot to the other.

"An insurance policy? Of course, all reputable businesses have insurance. Even small time carnivals" Mr Whidbey stammers.

>ask whidbey about bumper cars
Mr Whidbey waits for you to speak.

"That incident the other week with that Needleman kid was unfortunate" says Mr Whidbey.

Mr. Whidbey quickly changes the subject
You've collected some new evidence.

>ask whidbey about carnival
Mr Whidbey nervously shifts his weight from one foot to the other.

"The Whidbey family has owned this carnival since the 1957", Mr Whidbey says. "Unfortunately, I am an only child and never married. Alas, the carnival will close when I am gone. But for now, it's making a comeback!"

You've collected some new evidence.

>ask whidbey about fuses
Mr Whidbey looks at you expectantly.

"I know nothing about fuses", Mr Whidbey says.

>ask whidbey about fire
Mr Whidbey waits for you to speak.

The fire was most unfortunate. It put Hell Ride out of commission for two weeks. Not only did it cost me $22,500 to repair but I lost revenue while it was closed.

You've collected some new evidence.

>ask whidbey about indigo fuse
Mr Whidbey nervously shifts his weight from one foot to the other.

"Where did you get that?" Mr Whidbey asks.

Mr. Whidbey meets your eyes and quickly looks away.

You've collected some new evidence.

>whidbey on
Whidbey walks!.

>show evidence
Weight   Evidence collected:
  ------   --------------------------------------------------------
•    46    Evidence concerning accidents with the attractions
•    20    Evidence concerning past due invoices
•    19    Evidence concerning insurance
•     5    Evidence concerning fuses
•     2    Evidence concerning Mr Whidbey
  ------   --------------------------------------------------------
•    92    Total Weighted Evidence

You've got enough evidence for a conviction.

>gonear janitor
Bumper Cars
The bumper cars are a lively scene of flashing lights and vibrant decorations. The arena is surrounded by padded barriers, ensuring the rider's safety. Cars in faded reds, blues, yellows, and greens glide across the slick floor, each equipped with a steering wheel and padded bumper. Riders maneuver their cars with intensity, creating a din of bumps and laughter. Overhead, electric poles hum with energy. While onlookers cheer from the sidelines, the bumper cars offer playful competition and nostalgic fun for all. The Ticket Kiosk is southeast of here.

You can see a janitor and a Bumper Cars attendant here.

The janitor heads to the Ticket Booth.

>se
Ticket Booth
Painted in bright red and yellow stripes, the ticket kiosk stands at the entrance with flickering lights to draw attention. A smiling cashier hands out tickets, while the cash drawer jingles. A digital payment system sits in the corner. Too bad you don't have a debit card.

To the right, a signboard displays ticket prices alongside illustrations of the rides. Pennant flags flutter and the air is filled with the scent of popcorn, pretzels, and grease.

The ground is worn from the steps of carnival goers eagerly waiting in line as they approach the midway.

The midway continues in all directions from here. There is a cashier here. A price list for attraction tickets is on the signboard. The cashier has nothing.

You can see a janitor and a cashier here.

>janitor off
The janitor stands still.

>show cash 'n' carry to janitor
The janitor says, "Man, this doesn't look good for the carnival."

You've collected some new evidence.

Over the loudspeaker, an announcement blares: Attention please. There is a vehicle being towed from the parking lot for parking illegally. The license plate of the car is "862901". You breathe a sigh of relief as you realize that's not your license plate. I guess it's a good thing you remembered to place the parking stub on the dashboard.

>show oriental to janitor
The janitor says, "These prizes are cheaper and flimsier than usual."

You've collected some new evidence.

>show frank's to janitor
The janitor says, "Looks like the carnival is in some financial trouble."

You've collected some new evidence.

>show frank's to janitor
The janitor says, "Looks like the carnival is in some financial trouble."

>show mystic to janitor
The janitor says, That fire in Hell Ride was really bad. It took almost two weeks to get it fully repaired. But it shouldn't have cost this much. I think Mr Whidbey got ripped off. Or, he got it fixed on the cheap and pocketed the rest."

You've collected some new evidence.

>show policy to janitor
"An insurance policy? For a million dollars? Something is fishy for sure!" the janitor says.

You've collected some new evidence.

>show pliers to janitor
"I've been missing those. " says the janitor.

You've collected some new evidence.

>show check to janitor
The janitor says "What?! That's the name of the kid who got hurt in the Bumper Cars incident."

You've collected some new evidence.

>show aqua to janitor
"Hey! That's important. It should be in an electrical panel", the janitor says.

You've collected some new evidence.

>show indigo to janitor
"Hey! That's important. It should be in an electrical panel" the janitor asks.

You've collected some new evidence.

>ask janitor about hell ride
The janitor looks at you and waits for you to proceed.

"Hell Ride is a finicky ride. I'm fixing something there every week. Last week, Mr. Whidbey asked me to skip Hell Ride's maintenance slot. There was a real fire in the Stakes Room last month. And just yesterday I caught him creeping around the guillotine room" says the janitor.

You've collected some new evidence.

>ask janitor about whidbey
The janitor looks at you expectantly.

The janitor says , "Mr. Whidbey? He creeps me out. It always seems like he's hiding something. Just yesterday I caught him sneaking around the guillotine room in Hell Ride."

You've collected some new evidence.

>ask janitor about invoices
The janitor looks bored as he waits for you to speak.

The janitor says, "Wow! This doesn't look good. It looks like the carnival owes a lot of money! Cash 'N' Carry provides every day supplies. Why is this overdue? I hope I don't lose my job!"

You've collected some new evidence.

>ask janitor about carnival
The janitor looks at you and waits for you to proceed.

"The Whidbey family has owned this carnival since the 1950's" says the janitor.

You've collected some new evidence.

>ask janitor about ferris wheel
The janitor looks at you expectantly.

The janitor remarks, "The other day, I found a bolt on one of the gondolas so loose it had almost come off. That would have been a tragedy!"

You've collected some new evidence.

>ask janitor about accidents
The janitor looks at you and waits for you to proceed.

The janitor says "The fire, the Ferris wheel, the Bumper Cars... That's a lot of suspicious accidents."

You've collected some new evidence.

>ask janitor about bumper cars
The janitor looks bored as he waits for you to speak.

The janitor says, "That reminds me. Not long ago, one of the bumper cars was shorting out and electrifying the car. A visitor got hurt. A young lad, what was his name? Fred something, I think."

You've collected some new evidence.

>ask janitor about fire
The janitor looks at you and waits for you to proceed.

"The very real fire in the Stakes Room in Hell Ride was a scary event. I couldn't put it out with a fire extinguisher. We had to wait for the fire department and by then there was a lot of damage done" says the janitor.

You've collected some new evidence.

>ask janitor about fireaccidents
The janitor looks bored as he waits for you to speak.

"I'm afraid you've got me there," the janitor comments.

>ask janitor about accidents
The janitor looks at you expectantly.

The janitor says "The fire, the Ferris wheel, the Bumper Cars... That's a lot of suspicious accidents."

>show evidence
Weight   Evidence collected:
  ------   --------------------------------------------------------
•    75    Evidence concerning accidents with the attractions
•    27    Evidence concerning insurance
•    24    Evidence concerning past due invoices
•     8    Evidence concerning Mr Whidbey
•     7    Evidence concerning fuses
  ------   --------------------------------------------------------
•   141    Total Weighted Evidence

You've got enough evidence for a conviction.

>show total evidence
Evidence acquired by asking the janitor about:
• Hell Ride.
• Mr Whidbey.
• Ferris Wheel.
• Bumper Cars.
• The Stake Room Fire.
• Accidents.
• Invoices.
• .

Evidence acquired by showing something to the janitor:
• The Pliers
• Check Stub
• Mystic Industries Invoice
• Insurance Policy
• Cash 'N' Carry Invoice
• Frank's Market Invoice
• Oriental Trading Invoice
• Aqua Fuse
• Indigo Fuse

Evidence acquired by asking Mr Whidbey about:
• The Indigo Fuse
• The Stake Room Fire
• Invoices
• Bumper Cars
• Insurance Policy
• Carnival

Evidence acquired by showing something to Mr Whidbey:
• Mystic Industries Invoice
• Insurance Policy
• The Pliers
• Check Stub
• Cash 'N' Carry Invoice
• Frank's Market Invoice
• Oriental Trading Invoice

* * *

>test misc
(Testing.)

>[1] brief
Hell Ride is now in its "brief" printing mode, which gives long descriptions of places never before visited and short descriptions otherwise.

>[2] xyzzy
A  hollow voice says "Plugh".

>[3] plugh
Nothing happens.

>[4] hello sailor
Nothing happens here.

>[5] please get the dime
Please do not say "please."

>[6] i
You are carrying:
  an indigo colored fuse
  a khaki colored fuse
  some Bubblegum
  a Soft Pretzel
  Cotton Candy
  a Candy Apple
  a Bucket of Popcorn
  an empty Drink
  a brass ring
    a brass key (which opens the sturdy door)
  a gray colored fuse
  a knock-off Swiss Army knife
  a sledgehammer
  a lit flashlight (providing light)
  a crimson colored fuse
  a mallet
  a lit lantern (providing light)
  a sheer veil (being worn)
  an air freshener
  a pair of gloves (being worn)
  a 14" long piece of string
  a dime
  a parking ticket
  a fanny pack (being worn, and open)
    a wallet
      $10.00 in cash
    a notebook

>[7] score
Wow, you've received 85 points out of a possible 200 in 168 moves! I'm very proud of you. This was a triumph. I'm being so sincere right now.

You have received points for the following: 

•  Eating the blueberries:                   5 points
•  Finding the coins and keys:               5 points
•  Taking the lantern:                       5 points
•  Wearing the sheer veil:                   5 points
•  Winning the Crimson fuse:                 10 points
•  Buying the Hell Ride ticket:              5 points
•  Finding the Dark Passage:                 5 points
•  Taking the flashlight:                    5 points
•  Winning the knock-off Swiss Army knife:   5 points
•  Bringing the wrench to the Bumper Cars:   5 points
•  Acquiring the Gray fuse:                  10 points
•  Acquiring the Khaki fuse:                 10 points
•  Acquiring the Indigo fuse:                10 points

You haven't collected any evidence yet.

>[8] bite fingernails
That's a bad habit. You should really try to stop biting your fingernails.

>[9] clip fingernails
Your fingernails look much neater now that you've trimmed them.

* * *

>push indigo button
You switch the indigo button on.

The monitor flickers for a second and the scene it displays changes to something different.
The monitor now shows a tableau of a guillotine rising and falling over the ride exit.
The indigo light is now on.

As you push the indigo button, the monitor switches to a view of the guillotine room. You still see the blade rising and falling over the cars. Suddenly, the blade starts slowing down, taking longer and longer to fall. Until it finally comes to a complete rest.

The room is heavy with uneasy silence. Hell Ride, once a thrilling spectacle, now looms motionless, as the guillotine blade is frozen halfway down its track. Moments ago, chaos erupted as the malfunctioning mechanism sent the blade crashing unpredictably, ripping through the roofs of cars on the track.

A single car, its roof gashed open, sits under the still blade - a grim reminder of the disaster narrowly averted. Above, a black crow lands on the guillotine's frame, its sharp caw cutting through the murmurs of anger and fear.

Two mechanics climb the scaffolding with tools in hand, their appearance met with wary hope. A crowd has gathered and is watching, holding their breath, as the cursed ride's fate hangs in the balance. After a moment, applause rises from the assembled crowd, cheering your accomplishment.

Mr. Whidbey, the Mayor, the Chief of Police, and the janitor arrive on the scene and extend their gratitude for saving the day, not to mention lives!

"But wait", you say, "There is more afoot here than meets the eye. I think we need to talk to Mr Whidbey some more... confront him about a few things. Accusations might be made."

Mr Whidbey exclaims, "Accusations? What accusations?"

The Police Chief listens with interest to what you have to say.

You sing along to Boston's "More Than A Feeling".

>accuse whidbey of insurance fraud
Mr Whidbey waits for you to speak.

Mr Whidbey says. "You don't have enough evidence to confront anyone about anything."

The DJ announces that "Born To Run" by Bruce Springsteen will be up next.

* * *

>transcript
Start of a transcript of:

Hell Ride
The ride of a lifetime... by Dana Montgomery
Release 1 / Serial number 250326 / Inform 7 v10.1.2 / D
Inform 7 v10.1.2
Identification number: //E0A5AFB9-18BF-4485-B083-426CA51CCE70//
Interpreter version 0.6.0 / VM 3.1.3
Hacking by Mathbrush
Simple Multimedia Effects For V10 version 6 by Mathbrush
Basic Help Menu version 4 by Wade Clarke
Menus version 5 by Wade Clarke
Undo Output Control version 6.0.220529 by Nathanael Nerode (based on the extension by Erik Temple;
integrates Empty Command Handling by Daniel Stelzer based on code by Matt Weiner)
Command Preloading version 1.0.20230916 by Daniel Stelzer (based on I6 code by Andrew Plotkin)
Autosave version 2.0.231013 by Daniel Stelzer (based on I6 code from Ultra Undo by Danii Willis)
Story Mode version 2.0.1 by Drew Cook
Object Response Tests version 7 by Juhana Leinonen

* * *

>transcript on
Start of a transcript of:

Hell Ride
The ride of a lifetime... by Dana Montgomery
Release 1 / Serial number 250326 / Inform 7 v10.1.2 / D
Inform 7 v10.1.2
Identification number: //E0A5AFB9-18BF-4485-B083-426CA51CCE70//
Interpreter version 0.6.0 / VM 3.1.3
Hacking by Mathbrush
Simple Multimedia Effects For V10 version 6 by Mathbrush
Basic Help Menu version 4 by Wade Clarke
Menus version 5 by Wade Clarke
Undo Output Control version 6.0.220529 by Nathanael Nerode (based on the extension by Erik Temple;
integrates Empty Command Handling by Daniel Stelzer based on code by Matt Weiner)
Command Preloading version 1.0.20230916 by Daniel Stelzer (based on I6 code by Andrew Plotkin)
Autosave version 2.0.231013 by Daniel Stelzer (based on I6 code from Ultra Undo by Danii Willis)
Story Mode version 2.0.1 by Drew Cook
Object Response Tests version 7 by Juhana Leinonen

>images on
Images on. Game images will be displayed.

>look
Parking Lot
The lot stretches across an open field, gravel crunching under the tires of arriving cars. Floodlights and the carnival's colorful glow light the area, accompanied by distant laughter, music, and the hum of rides.

Cars park haphazardly, guided by makeshift signs and fluttering flags. Families and visitors mingle, some lingering in vehicles, preparing for the chilly evening ahead. Shadows from encroaching trees are pierced by the occasional flash of a flashlight. At the entrance, an attendant collects fees in a weathered booth, making change from a cash box.

Puddles from recent rain shimmer under the lights, while patches of mud cling to shoes. In the distance, RVs and trailers sit quietly, their occupants watching the Ferris wheel turn against the evening sky. The lot serves as a transition between the mundane and the magical world inside the carnival.

The midway is to the south. There is a blueberry bush here. There are blueberries on the bush.

Your car is here. It's a bit of a beater. Inside the car, you can see the glove box, the seat, the rear view mirror, the ignition, and the dashboard.

The attendant has a parking ticket. The price of a parking is $5.00.

You can see a parking attendant here.

>brief
Hell Ride is now in its "brief" printing mode, which gives long descriptions of places never before visited and short descriptions otherwise.

>listen
You can hear all the sounds of the carnival. The sounds of a calliope waft across the thoroughfare from the carousel. You can hear the laughter and screams as other patrons ride the rides and play the games.

>smell
You smell the odors of the carnival. As you inhale deeply, you can discern fresh, hot buttered popcorn, the sweet aroma of cotton candy, and the warm doughy scent of pretzels.

>l at attendant
This is another bored teenager. He's thinking about the big game on Friday night.

>ask attendant about hell ride
"Hell Ride is behind on its maintenance schedule. Might want to skip that one." says the parking attendant.

You've collected some new evidence.

You've discovered some evidence. To see a list and weighting of the evidence you've collected, type "SHOW EVIDENCE". To collect more evidence, try to ASK someone ABOUT something. Or SHOW something TO someone.

>talk to attendant about ferris wheel
The parking attendant says, "You can see the whole carnival from up there!"

>l at puddles
You carefully skirt the mud and puddles to avoid getting your feet wet.

>l at signs
The signs are painted with arrows pointing the way to the parking spaces.

>l at flags
The flags are strung from saw horse to saw horse marking the space between rows.

>l at cars
The cars are parked, filling the lot.

>x bush
This is a high bush blueberry plant.

In the blueberry bush are some blueberries.

>get berries
Taken.

>eat berries
The blueberries were delicious. A true taste of summer!

[Your score has just gone up by five points.]

>x cash box
The cash box is full of change and paper money.

>x car
This is your car. It's a 2002 Honda Civic and it's seen better days.

Although it's old, it feels like an old friend. From the faux leather seats to the crack in the windshield, it's familiar and comforting. There are old fast food wrappers on the floor, dirty clothes and text books in the back seat. There is an air freshener hanging from the rear view mirror.

In the beater car is an air freshener.

>l under seat
You find the three quarters, the nickel, the five dimes, and your keys!

[Your score has just gone up by five points.]

>get all
your keys: Taken.
dime: Taken.
dime: Taken.
dime: Taken.
dime: Taken.
dime: Taken.
nickel: Taken.
quarter: Taken.
quarter: Taken.
quarter: Taken.
air freshener: Taken.
parking ticket: You'll have to pay for that.

>l at seat
A faux leather seat that looked great when it was new.

>l at ignition
It's an ignition. You put your car key here and start your car.

>l at dashboard
It looks like you could set something there.

>l at glove box
This glove box contains things like your registration and insurance information.

>l at rear view mirror
You catch a glimpse of yourself in the rear view mirror. "Looking good!" you think.

>l at coupon
You found this in a stack of coupons on the counter of the gas station.

>smell air freshener
It smells like fake pine trees. The odor is pretty strong.

>l at wrappers
McDonald's, Burger King, Jack In The Box, Taco Bell, Carl's Jr., Five Guys... You're a regular equal opportunity garbage gut.

>l at books
The titles you see are Introduction to Calculus, Statistics, and Heart of Darkness here.

>l at clothes
Your dirty clothes are strewn about. You really meant to do laundry days ago.

>give coupon to attendant
(first taking the coupon)
Done. The price of a parking ticket is now $3.00.

>buy parking ticket
The attendant mumbles something about the stub.

You fork over $3.00 for the parking ticket, leaving yourself with $32.00.

>put stub on dashboard
You put the parking stub on the dashboard.

>open glove box
(first unlocking the glove box)
(with your keys)
You open the glove box, revealing a 14" long piece of string and a pair of gloves.

>get all from the glove box
14" long piece of string: Taken.
pair of gloves: Taken.

>wear gloves
You put on the pair of gloves.

>put keys in ignition
You put your keys into the ignition.

>turn keys
If you left now you would be abandoning your story. You want that full-time position, don't you? You decide to stay and investigate the carnival after all.

>s
Ticket Booth
Painted in bright red and yellow stripes, the ticket kiosk stands at the entrance with flickering lights to draw attention. A smiling cashier hands out tickets, while the cash drawer jingles. A digital payment system sits in the corner. Too bad you don't have a debit card.

To the right, a signboard displays ticket prices alongside illustrations of the rides. Pennant flags flutter and the air is filled with the scent of popcorn, pretzels, and grease.

The ground is worn from the steps of carnival goers eagerly waiting in line as they approach the midway.

The midway continues in all directions from here. There is a cashier here. A price list for attraction tickets is on the signboard. The cashier has Hell Ride ticket, Fortune Teller ticket, Ferris Wheel ticket, Bumper Cars ticket, and Carousel ticket.

You can see a janitor and a cashier here.

>buy tickets
Hell Ride ticket: You fork over $4.00 for the Hell Ride ticket, leaving yourself with $28.00.
Fortune Teller ticket: You fork over $3.00 for the Fortune Teller ticket, leaving yourself with $25.00.
Ferris Wheel ticket: You fork over $2.00 for the Ferris Wheel ticket, leaving yourself with $23.00.
Bumper Cars ticket: You fork over $2.00 for the Bumper Cars ticket, leaving yourself with $21.00.
Carousel ticket: You fork over $1.00 for the Carousel ticket, leaving yourself with $20.00.

[Your score has just gone up by five points.]

>l at kiosk
(the ticket kiosk)
A single window serves visitors, where a smiling cashier dispenses colorful tickets from neatly arranged rolls. Beside the tickets, a cash drawer jingles as change is counted, and a digital payment system glows faintly for modern convenience. Too bad you don't have a debit card.

Next to the kiosk, a vibrant signboard lists ticket prices with playful illustrations of rides.

The janitor heads to the High Striker.

>read sign
$4.00 Hell Ride Ticket (purchased)
$3.00 Fortune Teller Ticket (purchased)
$2.00 Ferris Wheel Ticket (purchased)
$2.00 Bumper Cars Ticket (purchased)
$1.00 Carousel Ticket (purchased)

>l at rolls
Neatly arranged rolls of colorful tickets are displayed behind the cashier.

>l at rolls of tickets
Neatly arranged rolls of colorful tickets are displayed behind the cashier.

>x cash drawer
The cash drawer is full of change and paper money.

>l at flags
Pennant flags flutter from the kiosk's roof.

>smell
The smell of popcorn and pretzels wafts from the southwest.

>listen
You can hear all the sounds of the carnival. The sounds of a calliope waft across the thoroughfare from the carousel. You can hear the laughter and screams as other patrons ride the rides and play the games.

>l at families
Families, couples, and friends form a buzzing line, their excitement building as they approach this first step into the magic of the carnival.

>ne
Carousel
The carousel radiates charm with its brightly painted horses, lights, and calliope music. The platform features a canopy of colors and decorative mirrors. Hand-carved animals, including horses, lions, tigers, and sea dragons, circle as the carousel spins. The animals rise and fall gently, adding to the charm. The music rises from the Carousel inviting riders of all ages to enjoy this most basic symbol of the carnival.

The Ticket Kiosk is back to the southwest; the way you came.

You can see a Carousel attendant here.

>give ticket to attendant
(the Carousel ticket to the Carousel attendant)
You give the Carousel ticket to the Carousel attendant.

Stepping onto the carousel, you're surrounded by colorful beasts, glittering lights, and carved details. The cheerful calliope music fills the air as you choose your mount - a galloping horse, a snarling lion, or a graceful giraffe. Gripping the pole, you settle into the saddle as the carousel begins to spin.

As it speeds up, the world blurs in a swirl of colors, and the gentle rise and fall mimics a playful gallop. Laughter mixes with the music, creating a nostalgic atmosphere.

As the ride slows, you step off smiling, the music still echoing in your ears, and return to the bustling carnival.

>l at horses
The horses are mounted on poles which go up and down as the Carousel turns.

>l at lions
The majestic lions and tigers are mounted on poles which go up and down as the carousel turns.

>l at giraffe
The giraffes are mounted on poles which go up and down as the carousel turns.

>l at saddles
Each animal is painted in vivid colors, detailed with golden saddles and ribbons.

>listen
The carousel's warm, playful tunes drift across the midway, inviting riders of all ages to enjoy its simple delight.

>l at calliope
The sounds of the calliope fill the air with pleasant music.

>listen to calliope
The carousel's warm, playful tunes drift across the midway, inviting riders of all ages to enjoy its simple delight.

>sw
Ticket Booth
You can see a janitor and a cashier here.

>steal brass key
You reach toward the brass ring, but pull back your hand. You were almost caught!

>steal brass key
You reach toward the brass ring, but pull back your hand. You were almost caught!

The janitor heads to the Concession Stand.

>sw
Concession Stand
The concession stand is a destination for many along the midway. Twinkling lights frame the stand making it glow amid the carnival's buzz.

Behind the counter, popcorn churns in the machine, candy apples gleam, and cotton candy spins in clouds. Warm pretzels sit under a heat lamp, while sodas chill in a frosted cooler. The counter is cluttered with bags, napkins, and sprinkle cups. Kids tug at parents, teens share pretzels, and the crowd buzzes with energy.

There is a menu to the right of the window. You can see the treats inside the stand. There are exits to the south and northeast.

Nearby a sturdy door leads south.

You can also see a janitor, a concession attendant, and a menu here.

>steal brass key
You reach toward the brass ring, but pull back your hand. You were almost caught!

>steal brass key
You reach toward the brass ring, but pull back your hand. You were almost caught!

>steal brass ring
You reach toward the brass ring, but pull back your hand. You were almost caught!

>steal brass ring
While the janitor is distracted, you manage to steal the brass ring.

The janitor heads to the Ticket Booth.

>ne
Ticket Booth
You can see a janitor and a cashier here.

>ask janitor about hell ride
The janitor looks bored as he waits for you to speak.

"Hell Ride is a finicky ride. I'm fixing something there every week. Last week, Mr. Whidbey asked me to skip Hell Ride's maintenance slot. There was a real fire in the Stakes Room last month. And just yesterday I caught him creeping around the guillotine room" says the janitor.

You've collected some new evidence.

>ask janitor about ferris wheel
The janitor looks at you expectantly.

The janitor remarks, "The other day, I found a bolt on one of the gondolas so loose it had almost come off. That would have been a tragedy!"

You've collected some new evidence.

>ask janitor about bumper cars
The janitor looks bored as he waits for you to speak.

The janitor says, "That reminds me. Not long ago, one of the bumper cars was shorting out and electrifying the car. A visitor got hurt. A young lad, what was his name? Fred something, I think."

You've collected some new evidence.

>ask janitor about whidbey
The janitor looks at you and waits for you to proceed.

The janitor says , "Mr. Whidbey? He creeps me out. It always seems like he's hiding something. Just yesterday I caught him sneaking around the guillotine room in Hell Ride."

You've collected some new evidence.

>ask janitor about fuses
The janitor looks at you expectantly.

The janitor says "Funny thing about that. The fuses that belong in the electrical panels in the electrical area of backstage seem to be missing. Finding them might help with disabling Hell Ride."

You've collected some new evidence.

>ask janitor about fire
The janitor looks bored as he waits for you to speak.

"The very real fire in the Stakes Room in Hell Ride was a scary event. I couldn't put it out with a fire extinguisher. We had to wait for the fire department and by then there was a lot of damage done" says the janitor.

You've collected some new evidence.

>ask janitor about accidents
The janitor looks at you and waits for you to proceed.

The janitor says "The fire, the Ferris wheel, the Bumper Cars... That's a lot of suspicious accidents."

You've collected some new evidence.

>ask janitor about rides
The janitor looks at you expectantly.

"Almost every ride is falling apart. I do what I can to keep things in good repair but it's a lot of work" says the janitor.

You've collected some new evidence.

>nw
Bumper Cars
The bumper cars are a lively scene of flashing lights and vibrant decorations. The arena is surrounded by padded barriers, ensuring the rider's safety. Cars in faded reds, blues, yellows, and greens glide across the slick floor, each equipped with a steering wheel and padded bumper. Riders maneuver their cars with intensity, creating a din of bumps and laughter. Overhead, electric poles hum with energy. While onlookers cheer from the sidelines, the bumper cars offer playful competition and nostalgic fun for all. The Ticket Kiosk is southeast of here.

You can see a Bumper Cars attendant here.

>l at cars
(the Bumper Cars)
The Bumper Cars are small, colorful, electric-powered vehicles equipped with a padded outer rim to absorb impacts. This allows riders to safely bump into each other as part of the game. The ceiling has a conductive surface that powers the cars. Riders enjoy the challenge of maneuvering away from - or into - other drivers.

>l at riders
Drivers of all ages eagerly maneuver their cars, aiming for others.

>l at bumper
(the Bumper Cars)
The Bumper Cars are small, colorful, electric-powered vehicles equipped with a padded outer rim to absorb impacts. This allows riders to safely bump into each other as part of the game. The ceiling has a conductive surface that powers the cars. Riders enjoy the challenge of maneuvering away from - or into - other drivers.

>l at steering wheel
The steering wheel turns 360 degrees adding to the fun and excitement.

>x drivers
Drivers of all ages eagerly maneuver their cars, aiming for others.

The janitor arrives from the Ticket Booth.

>x poles
The electric poles connects the cars to the ceiling, sparking faintly as they supply power to the vehicles.

>l at booth
The operator stands in this booth overseeing the action below.

>se
Ticket Booth
You can see a cashier here.

Mr Whidbey arrives from the Concession Stand.

>se
Fortune Teller
Approaching the fortune teller's booth, you are drawn in by its mysterious allure and inky softness. Draped in deep purple curtains adorned with golden moons and stars, the booth is lit only with the flickering of candles. The air is heavy with the scent of incense, mingling with and then overpowering the ever-present sugary odor of carnival treats. A sign sways slightly in the evening breeze.

You can see Esmeralda here.

>l at booth
Draped in deep purple curtains adorned with golden moons and stars, the booth glows with the soft, inviting light of candles. The air is heavy with the scent of incense, mingling with the sweet aroma of carnival treats.

>l at curtains
The curtains are deep purple with golden moons and stars.

>smell
The smell of incense wafts through the air mixed with the scent of fresh, buttered popcorn.

Over the loudspeaker, an announcement blares: Attention please. There is a vehicle being towed from the parking lot for parking illegally. The license plate of the car is "862901". You breathe a sigh of relief as you realize that's not your license plate. I guess it's a good thing you remembered to place the parking stub on the dashboard.

>listen
You can hear all the sounds of the carnival. The sounds of a calliope waft across the thoroughfare from the carousel. You can hear the laughter and screams as other patrons ride the rides and play the games.

>l at esmeralda
The fortune teller sits in a dimly lit booth, draped in rich fabrics of deep purple and gold adorned with celestial patterns of stars and moons. Her appearance is enigmatic, with piercing eyes that seem to look right through you and a knowing smile that hints at secrets yet untold. She wears flowing robes embellished with shimmering beads, and a jeweled headpiece catches the flickering light of nearby candles.

>l at robes
Esmeralda wears flowing robes embellished with shimmering beads, and a jeweled headpiece.

>l at candles
The candles flicker in the soft breeze casting light on Esmeralda's face.

>take candles
Esmeralda says, "Hey! I need those!"

>read sign
"Fortunes Told - What Does Your Future Hold?" Underneath that it says "Ticket Required"

>give ticket to fortune teller
(the Fortune Teller ticket to Esmeralda)
You give the Fortune Teller ticket to Esmeralda.

Stepping inside, you're greeted by Esmeralda, a figure cloaked in flowing robes with a jeweled headpiece catching the flickering light. Her piercing eyes seem to look right through you as they gesture for you to sit at a small round table. At its center rests a glowing crystal ball, surrounded by tarot cards and mysterious trinkets.

Esmeralda's voice is low and melodic, weaving an air of intrigue as they ask you to focus on a question and offer you a tarot reading. The room seems to shrink, the bustling carnival outside fading into the background as she reveals your fate. Each card turned feels significant, as though unlocking a secret you didn't know you carried.

Past: Ten of Wands (upright)
Ten of Wands suggests that you may be shouldering too many responsibilities or taking on more than you can handle. You may feel overwhelmed, exhausted, or weighed down by the tasks and obligations in your life. This card serves as a reminder to evaluate your commitments and consider whether you need to delegate, seek support, or let go of some burdens.

>z
Time passes.

Present: Nine of Wands (upright)
Nine of Wands is the card for strength, courage, resilience and endurance. Never give up and never surrender. It suggests that while you may be tired or worn out from the struggles you've faced, it's important to remain alert and prepared for any further challenges that may arise. This card encourages you to draw upon your past experiences and learn from them, using them as sources of wisdom and guidance.

>z
Time passes.

Challenge: The World (upright)
World is the final Major Arcana card and represents fulfillment and successful completion of a cycle. You know your place in the world, and your life lessons have served you well. It serves as a gentle reminder that the universe is aligning perfectly in your favor, propelling you forward towards the triumphant realization of your ambitions. The world is at your feet. You're on the right path towards the attainment of your long-cherished aspirations and dreams.

>z
Time passes.

Opportunity: Two of Swords (reversed)
Two of Swords reversed suggests that poor choices and hasty decision-making are likely to lead to movement in the wrong direction. It serves as a reminder that impulsive actions can often result in unfavorable outcomes, urging you to carefully consider your options and approach situations with thoughtfulness and patience. By taking the time to weigh your choices and make deliberate decisions, you can avoid the pitfalls that come with rushing into action without considering the potential consequences.

>z
Time passes.

Future: Four of Wands (reversed)
Four of Wands reversed indicates the foundation not laid or not ready. Something has caused a disruption in your plans. This could be due to external factors, such as unexpected events that have thrown you off course. Alternatively, it could be self-sabotage, your wavering self-belief or lack of confidence in your abilities can be hindering you from achieving your goals.

As the reading concludes, Esmeralda gazes into your eyes with a cryptic smile and delivers their final words of wisdom: "The order of things is important. Alphabetically and numerically; one follows another and provides the link between the two. If you will learn, think on this carefully. Also, don't trust Whidbey. He's up to something."

Whether you leave with a sense of wonder or unease, the encounter lingers with you - it's a touch of magic amid the bustling carnival, as if you've glimpsed something beyond the ordinary.

>nw
Ticket Booth
You can see a janitor and a cashier here.

>e
High Striker
A tall machine stands with bright red, yellow, and blue lights. A sign sits at the top reading "Test Your Strength!" The base is dark, polished wood, with a sturdy metal pole and a bell at the top. Markings along the pole indicate strength. A smaller sign says, "Buy a mallet, strike the bell, win a prize." Spectators cheer as the sound of the mallet hitting the target fills the night.

The Ticket Kiosk is to the west. Other games are northeast and southeast of here. The Ferris Wheel lies to the east.

You can see a High Striker attendant, a bullseye, and some High Striker prizes here.

The attendant is holding a mallet.

The janitor arrives from the Ticket Booth.

>e
Ferris Wheel
The Ferris wheel dominates the carnival, its bright lights visible from every corner. Its massive steel frame arches high, with colorful gondolas swaying as it turns. At night, flashing in bursts of red, green, and white, the wheel dazzles with lights. The air buzzes with the hum of the motor. The operator calls, "Step right up! The best view of the carnival awaits!" From the top, riders get a panoramic view of the fairgrounds, with city lights stretching to the horizon.

Hey! Is that a two dollar bill on the ground?

You can also see a Ferris Wheel attendant here.

>give ticket to attendant
(the Ferris Wheel ticket to the Ferris Wheel attendant)
You give the Ferris Wheel ticket to the Ferris Wheel attendant.

As you enter the gondola, the safety bar clicks into place, and the Ferris wheel begins its ascent. The sounds of the carnival fade, replaced by the hum of machinery and a soft breeze. At the peak, the carnival sprawls below, its lights twinkling against the twilight sky. The world falls quiet up here. The gondola sways gently, adding excitement to the serene view. From the top you can see something to the west of the concession stand. As you descend, the sounds of the carnival return, bringing you back to the fun.

>l at beams
The Ferris wheel towers above the carnival and is illuminated with vibrant lights, creating a dazzling display. As the wheel turns slowly, the gondolas remain upright, offering riders a thrilling yet gentle experience and spectacular views from the top.

>l at gondolas
Each gondola, painted in bright hues like red, yellow, and blue, dangles from the wheel, swaying gently as it turns.

>l at bulbs
The Ferris wheel towers above the carnival and is illuminated with vibrant lights, creating a dazzling display. As the wheel turns slowly, the gondolas remain upright, offering riders a thrilling yet gentle experience and spectacular views from the top.

The janitor arrives from the High Striker.

>l at bill
It has a picture of Thomas Jefferson on it.

>get it
Taken.

You now have $22.00.

>l at safety bar
The safety bar is locked in place.

>raise safety bar
The safety bar is locked in place.

>w
High Striker
You can see a High Striker attendant, a bullseye, and some High Striker prizes here.

The attendant is holding a mallet.

The janitor arrives from the Ferris Wheel.

>l
High Striker
A tall machine stands with bright red, yellow, and blue lights. A sign sits at the top reading "Test Your Strength!" The base is dark, polished wood, with a sturdy metal pole and a bell at the top. Markings along the pole indicate strength. A smaller sign says, "Buy a mallet, strike the bell, win a prize." Spectators cheer as the sound of the mallet hitting the target fills the night.

The Ticket Kiosk is to the west. Other games are northeast and southeast of here. The Ferris Wheel lies to the east.

You can see a janitor, a High Striker attendant, a bullseye, and some High Striker prizes here.

The attendant is holding a mallet.

>read sign
Which do you mean, the markings or the High Striker sign?

>markings
There are five levels marked on the pole: Weakling, Getting There, Average, Almost There, and Muscle Man.

>read high striker sign
Buy a mallet, strike the bell, win a prize.

>l at base
(the High Striker)
The High Striker is a tall, eye-catching machine adorned with bright, colorful lights. A large sign at the top reads "Test Your Strength!". The machine's base is made of polished wood. At the center is a sturdy metal pole, with a large bell hanging at the top.

>l at pole
There are five levels marked on the pole: Weakling, Getting There, Average, Almost There, and Muscle Man.

The janitor heads to the Ticket Booth.

>l at spectators
Spectators gather around, cheering on participants and offering lighthearted jabs and encouragement.

>listen
The sound of the mallet hitting the target is followed by the resonant clang of the bell ), alongside the buzz of carnival music in the background.

>smell
You smell the odors of the carnival. As you inhale deeply, you can discern fresh, hot buttered popcorn, the sweet aroma of cotton candy, and the warm doughy scent of pretzels.

>l at bell
This is the bell that will ring out when you prove to everyone that you're a "Muscle Man".

>buy mallet
You fork over $2.00 for the mallet, leaving yourself with $20.00.

>hit bullseye with mallet
You lift the mallet high and bring it down on the bullseye with all your might! The striker rises towards the bell stopping at "Weakling".

>g
You lift the mallet high and bring it down on the bullseye with all your might! The striker rises towards the bell stopping at "Average".

>g
You lift the mallet high and bring it down on the bullseye with all your might! The striker rises towards the bell stopping at "Almost There".

>g
You lift the mallet high and bring it down on the bullseye with all your might! The striker rises towards the bell stopping at "Getting Stronger".
 
You can't be sure of it but it seems as if the mallet isn't heavy enough to ring the bell.

>g
You lift the mallet high and bring it down on the bullseye with all your might! The striker rises towards the bell stopping at "Almost There".

>se
Pitchers Mound
The milk bottle toss is a classic game of skill and luck. A pyramid of colorful bottles sits on a sturdy platform - three on the bottom, two in the middle, and one at the top. Players throw baseballs to knock down the stack and win a prize. The booth is lively, with cheering and the clatter of falling bottles. The attendant calls, "Step right up! Three balls for a dime!" Prizes from toys to stuffed animals hang nearby. With this carnival favorite, every toss is filled with suspense.  You thought you caught a flash of something coming from the area of the booth.

You're surprised to see that this game only costs a dime. The High Striker is to the northwest.

The milk bottles are stacked in three neat rows: three bottles on the bottom, two in the middle, and one on top.

         1         
       2   3     
     4   5   6     

You can also see a Pitchers Mound attendant and some Pitchers Mound prizes here.

>l at booth
With its colorful banners and flashing lights, the booth buzzes with energy, drawing a crowd.  You can see something shiny on the ground under the booth.

>l under booth
You find the Mercury dime!

>get mercury dime
Taken.

[Your score has just gone up by five points.]

>nw
High Striker
You can see a High Striker attendant, a bullseye, and some High Striker prizes here.

>ne
Dime Toss Game
The booth is brightly colored with red-and-white stripes, twinkling lights, and a sign reading "TOSS A DIME - WIN A PRIZE!" Prizes hang around the booth, from stuffed animals to shiny trinkets. Gleaming plates reflect the light, waiting for dimes. The "ping" of dimes hitting plates is followed by the satisfying "plop" when they land. Shouts of victory and playful groans mix with carnival music and laughter. The operator calls out, drawing in onlookers.

You're surprised to see that this game only costs a dime. The exit is to the southwest.

You can see a Dime Toss attendant, some Dime Toss prizes, and a plate here.

>l at awnings
The game booth is adorned with vibrant colors - red-and-white striped awnings, twinkling lights, and eye-catching signage.

>read sign
The sign reads, "TOSS A DIME - WIN A PRIZE!".

>l at prizes
The prizes are a stuffed monkey, an orange colored fuse, a poster of Billie Eilish, and a horseshoe magnet.

>listen
The distinctive "ping" of dimes hitting plates creates a rhythmic soundtrack.

>smell
You smell the odors of the carnival. As you inhale deeply, you can discern fresh, hot buttered popcorn, the sweet aroma of cotton candy, and the warm doughy scent of pretzels.

>l at plates
These are small, flat plates, almost saucers. You are meant to toss a dime on these plates to win a prize!

>x it
These are small, flat plates, almost saucers. You are meant to toss a dime on these plates to win a prize!

>toss dime at plate
(the Mercury dime at the plate)
You toss the dime. The heavier Mercury dime hits the plate, starts to spins, and lands in the center of the plate. The attendant shouts out, "Winner! Winner!"

Which prize would you like? 1) a stuffed monkey, 2) an orange colored fuse, 3) a poster of Billie Eilish, 4) a horseshoe magnet?

>toss dime at plate
(the dime at the plate)
You toss the dime. The dime lands on the edge of the plate. You watch in anticipation until the dime falls off the plate.

>4
You are now holding a horseshoe magnet.

[Your score has just gone up by five points.]

>sw
High Striker
You can see a High Striker attendant, a bullseye, and some High Striker prizes here.

>se
Pitchers Mound
The milk bottles are stacked in three neat rows: three bottles on the bottom, two in the middle, and one on top.

         1         
       2   3     
     4   5   6     

You can also see a Pitchers Mound attendant and some Pitchers Mound prizes here.

>l at milk bottles
The milk bottles are stacked in three neat rows: three on the bottom, two in the middle, and one on top. 

         1         
       2   3     
     4   5   6

>l at pyramid
The milk bottles are stacked in three neat rows: three on the bottom, two in the middle, and one on top. 

         1         
       2   3     
     4   5   6

>l at banners
The booth buzzes with energy, its colorful banners and flashing lights drawing a lively crowd.

>l at spectators
The satisfying clatter of falling bottles mixes with cheers and groans from players and spectators.

>l at prizes
The prizes are a crimson colored fuse, a plush donkey, a goldfish in a bowl, and a poster of Lourde.

>give dime to attendant
The attendant gives you three baseballs in return.

>throw baseball at bottle 1
You wind up and throw the baseball at the milk bottles. You knocked over one bottle. You can do better than that.

>throw baseball at bottle 3
You wind up and throw the baseball at the milk bottles. You knocked over five bottles. Better luck next time.

>throw baseball at bottle 5
You wind up and throw the baseball at the milk bottles. The ball hits the bottles in the sweet spot and they topple over onto the platform. The attendant shouts out, "Winner! Winner!"

Which prize would you like? 1) a crimson colored fuse, 2) a plush donkey, 3) a goldfish in a bowl, 4) a poster of Lourde?

>1
You are now holding a crimson colored fuse.

[Your score has just gone up by ten points.]

>nw
High Striker
You can see a High Striker attendant, a bullseye, and some High Striker prizes here.

>l at prizes
The prizes are a teddy bear, a knock-off Swiss Army knife, a magenta colored fuse, and a poster of Taylor Swift.

>w
Ticket Booth
You can see a cashier here.

>sw
Concession Stand
Nearby a sturdy door leads south.

You can also see a concession attendant and a menu here.

>l at stand
The Concession Stand, perched along the midway, is a colorful and bustling hub. Painted in bright reds, blues, and yellows, it features bold lettering announcing treats like "SODA! POPCORN! CANDY APPLES!" Strings of twinkling lights frame the stand, making it a glowing beacon amid the carnival excitement.

>read sign
$2.00 Drink Of Cola
$2.50 Bucket Of Popcorn
$1.50 Candy Apple
$1.50 Cotton Candy
$1.50 Soft Pretzel
$1.00 Bubblegum

>ask attendant about popcorn
The concession attendant says, "The popcorn is really good. It's hot and fresh."

>ask attendant about pretzels
The concession attendant says, "I prefer to eat my pretzels with mustard."

>ask attendant about cotton candy
"I love the way cotton candy melts in my mouth", says the concession attendant.

>ask attendant about candy apples
The concession attendant says, "I can't eat these. They get stuck in my braces."

>ask attendant about bubblegum
"It's Bazooka Joe! My favorite!", the concession attendant says.

>l at counter
On the counter there are paper bags, napkins, and cups of cheese and sugar sprinkles.

>l at machine
The machines faithfully prepares batch of batch of treats for the crowd.

>l at bags
The paper bags are used to send the customer off with their goodies.

>l at napkins
It's the kind of dispenser that doesn't allow you to take more than one at a time.

>l at cups
The cups are full of cheese and sugar sprinkles Not together though. That's nasty!

>read chalkboard
$2.00 Drink Of Cola
$2.50 Bucket Of Popcorn
$1.50 Candy Apple
$1.50 Cotton Candy
$1.50 Soft Pretzel
$1.00 Bubblegum

>l at aprons
These are full-sized aprons with the carnival's logo printed on them.

>buy bubblegum
You fork over $1.00 for the Bubblegum, leaving yourself with $19.00.

>w
Behind the Concession Stand
Behind the concession stand, to one side, is the trash generated from the day's activities and to the other side boxes of supplies. There is a chair here surrounded by cigarette butts. There is an exit to the east.

You can see a trash can (closed) and some concession boxes here.

>open trash can
You open the trash can, revealing a khaki colored fuse.

>get fuse
(the khaki colored fuse)
Taken.

[Your score has just gone up by ten points.]

>l at chair
The employees sit in this chair while on break.

>l at trash
This a garbage can overflowing with trash.

>l at butts
The chair is surrounded by cigarette butts carelessly discarded on the ground.

>e
Concession Stand
Nearby a sturdy door leads south.

You can also see a concession attendant and a menu here.

>s
(first opening the sturdy door)
(first unlocking the sturdy door)
(with the brass key)

Carnival Office
Dim, yellow light from an overhead bulb casts long shadows over the room, A single desk lamp, flickering provides additional light. A few carnival-themed knick-knacks sit atop the desk. A framed photograph hangs askew on the wall.

The desk is covered in stacks of paperwork, old receipts, invoices, and faded carnival brochures. A locked cabinet is tucked away against one wall. Next to it, there's a small, heavy safe.

Nearby a sturdy door leads north to the Concession Stand.

On the messy desk are a mini Ferris wheel and a mini carousel.

You can also see a safe (closed), a filing cabinet (closed), and a framed photograph here.

As you enter the room, you see Mr Whidbey with his back to the door. He's talking on the telephone.

"Hello? Oh, it's you." says Mr. Whidbey.

>z
Time passes.

Mr. Whidbey listens to the other end of the conversation.

>z
Time passes.

"I know, I know, but what am I supposed to do. We have to get that Needleman kid more money. Another $15,000 ought to do it."

>z
Time passes.

Isn't this why I buy insurance? Don't worry. You'll get your piece. Everyone will get their piece.

>n
You're afraid if you move too much, Mr Whidbey will notice you!

Mr. Whidbey says "I need that money in a hurry though before anyone gets suspicious. If anything happens then you'll go down too."

>z
Time passes.

"Ok, I'll try to stall for a bit but I won't be able to do it for long."

>z
Time passes.

"Hey! What are you doing here? This is area is for employees only," Mr. Whidbey shouts at you. "Get out of here. Now!"

Concession Stand
The concession stand is a destination for many along the midway. Twinkling lights frame the stand making it glow amid the carnival's buzz.

Behind the counter, popcorn churns in the machine, candy apples gleam, and cotton candy spins in clouds. Warm pretzels sit under a heat lamp, while sodas chill in a frosted cooler. The counter is cluttered with bags, napkins, and sprinkle cups. Kids tug at parents, teens share pretzels, and the crowd buzzes with energy.

There is a menu to the right of the window. You can see the treats inside the stand. There are exits to the south, west, and northeast.

Nearby a sturdy door leads south to the Carnival Office.

You can also see a janitor, a concession attendant, and a menu here.

You suddenly find yourself escorted outside the Carnival Office unceremoniously only to find yourself in the Concession Stand.

>s
Carnival Office
Nearby a sturdy door leads north to the Concession Stand.

On the messy desk are a mini Ferris wheel and a mini carousel.

You can also see a safe (closed), a filing cabinet (closed), and a framed photograph here.

>l at photo
This appears to be a photo of the carnival's opening night, a once proud moment lost in time. On the back reads a date: "03/22/62".

>turn dial to 62
You turn the knob to 62.

>set knob to 22
You turn the knob to 22.

>spin safe to 3
You turn the knob to 3, and you hear a click.

>open safe
You open the safe, revealing an indigo colored fuse, a gold key, and an insurance policy.

>get all from safe
indigo colored fuse: (putting the notebook into the fanny pack to make room)
Taken.
gold key: (putting the wallet into the fanny pack to make room)
Taken.
insurance policy: (putting the dime into the fanny pack to make room)
Taken.

[Your score has just gone up by five points.]

[Your score has just gone up by ten points.]

>l at paperwork
Piles of receipts and old financial statements cover much of the desk, but the documents seem to be a mix of chaotic disorganization and purposeful concealment. Most of these are for the regular day to day expenses such as: paper goods, consumables, etc. Closer inspection shows a steadily declining volume of goods ordered. Almost as if the carnival couldn't afford the full cost. Some are marked paid and others are not. Some are marked "Past Due". I wonder if the carnival is in some kind of financial trouble.

>open filing cabinet
(first unlocking the filing cabinet)
(with the gold key)
You open the filing cabinet, revealing an envelope, a Cash 'N' Carry invoice, a Frank's Market invoice, an Oriental Trading invoice, and a Mystic Industries invoice.

Mr Whidbey arrives from the Guillotine Room.

>get all invoices
Cash 'N' Carry invoice: (putting the dime into the fanny pack to make room)
Taken.
Frank's Market invoice: (putting the dime into the fanny pack to make room)
Taken.
Oriental Trading invoice: (putting the nickel into the fanny pack to make room)
Taken.
Mystic Industries invoice: (putting the quarter into the fanny pack to make room)
Taken.

Mr Whidbey shouts, "Hey! Get out of here! Can't you read the sign? Employees only!"

Concession Stand
The concession stand is a destination for many along the midway. Twinkling lights frame the stand making it glow amid the carnival's buzz.

Behind the counter, popcorn churns in the machine, candy apples gleam, and cotton candy spins in clouds. Warm pretzels sit under a heat lamp, while sodas chill in a frosted cooler. The counter is cluttered with bags, napkins, and sprinkle cups. Kids tug at parents, teens share pretzels, and the crowd buzzes with energy.

There is a menu to the right of the window. You can see the treats inside the stand. There are exits to the south, west, and northeast.

Nearby a sturdy door leads south to the Carnival Office.

You can also see a concession attendant and a menu here.

You suddenly find yourself escorted outside the Carnival Office unceremoniously only to find yourself in the Concession Stand.

[Your score has just gone up by five points.]

[Your score has just gone up by five points.]

[Your score has just gone up by five points.]

[Your score has just gone up by five points.]

>s
Carnival Office
Nearby a sturdy door leads north to the Concession Stand.

On the messy desk are a mini Ferris wheel and a mini carousel.

You can also see Mr Whidbey, a safe (empty), a filing cabinet (in which is an envelope (closed)), and a framed photograph here.

Mr Whidbey shouts, "Hey! Get out of here! Can't you read the sign? Employees only!"

Concession Stand
The concession stand is a destination for many along the midway. Twinkling lights frame the stand making it glow amid the carnival's buzz.

Behind the counter, popcorn churns in the machine, candy apples gleam, and cotton candy spins in clouds. Warm pretzels sit under a heat lamp, while sodas chill in a frosted cooler. The counter is cluttered with bags, napkins, and sprinkle cups. Kids tug at parents, teens share pretzels, and the crowd buzzes with energy.

There is a menu to the right of the window. You can see the treats inside the stand. There are exits to the south, west, and northeast.

Nearby a sturdy door leads south to the Carnival Office.

You can also see a concession attendant and a menu here.

You suddenly find yourself escorted outside the Carnival Office unceremoniously only to find yourself in the Concession Stand.

>s
Carnival Office
Nearby a sturdy door leads north to the Concession Stand.

On the messy desk are a mini Ferris wheel and a mini carousel.

You can also see Mr Whidbey, a safe (empty), a filing cabinet (in which is an envelope (closed)), and a framed photograph here.

Mr Whidbey shouts, "Hey! Get out of here! Can't you read the sign? Employees only!"

Concession Stand
The concession stand is a destination for many along the midway. Twinkling lights frame the stand making it glow amid the carnival's buzz.

Behind the counter, popcorn churns in the machine, candy apples gleam, and cotton candy spins in clouds. Warm pretzels sit under a heat lamp, while sodas chill in a frosted cooler. The counter is cluttered with bags, napkins, and sprinkle cups. Kids tug at parents, teens share pretzels, and the crowd buzzes with energy.

There is a menu to the right of the window. You can see the treats inside the stand. There are exits to the south, west, and northeast.

Nearby a sturdy door leads south to the Carnival Office.

You can also see a concession attendant and a menu here.

You suddenly find yourself escorted outside the Carnival Office unceremoniously only to find yourself in the Concession Stand.

>s
Carnival Office
Nearby a sturdy door leads north to the Concession Stand.

On the messy desk are a mini Ferris wheel and a mini carousel.

You can also see Mr Whidbey, a safe (empty), a filing cabinet (in which is an envelope (closed)), and a framed photograph here.

Mr Whidbey shouts, "Hey! Get out of here! Can't you read the sign? Employees only!"

Concession Stand
The concession stand is a destination for many along the midway. Twinkling lights frame the stand making it glow amid the carnival's buzz.

Behind the counter, popcorn churns in the machine, candy apples gleam, and cotton candy spins in clouds. Warm pretzels sit under a heat lamp, while sodas chill in a frosted cooler. The counter is cluttered with bags, napkins, and sprinkle cups. Kids tug at parents, teens share pretzels, and the crowd buzzes with energy.

There is a menu to the right of the window. You can see the treats inside the stand. There are exits to the south, west, and northeast.

Nearby a sturdy door leads south to the Carnival Office.

You can also see a concession attendant and a menu here.

You suddenly find yourself escorted outside the Carnival Office unceremoniously only to find yourself in the Concession Stand.

Mr Whidbey arrives from the Carnival Office.

>s
Carnival Office
Nearby a sturdy door leads north to the Concession Stand.

On the messy desk are a mini Ferris wheel and a mini carousel.

You can also see a safe (empty), a filing cabinet (in which is an envelope (closed)), and a framed photograph here.

>get envelope
(putting the quarter into the fanny pack to make room)
Taken.

>open envelope
You open the envelope, revealing a check stub.

>get check
(putting the quarter into the fanny pack to make room)
Taken.

[Your score has just gone up by ten points.]

>l at check
This check stub is for a check made payable to "Fred Needleman". The amount is $10,000 and the memo line reads "For services rendered."

>l at Cash 'n' carry
The Cash 'N' Carry invoice reads:

 Cash 'N' Carry.
 121 Maple St
 Stoneham, WA 98132

 2 cases of Soda Cups                   $82.50
 1 case of Popcorn Buckets             $106.73
 3 cases of Napkins                     $56.41
 Total:                                $245.64

 After the 10th of the month, this invoice will be assessed a finance charge of 3.75% per month, We appreciate your prompt payment.

>l at frank's market
Frank's Market invoice reads:

 Frank's Market Wholesale
 1 Market Pl
 Cambridge, WA 98325

 8 dozen lemons                                $85.00
 10 bags of flour (50 pounds)                 $200.00
 5 bags of sugar (50 pounds)                  $250.00
 10 Cases of Coca-Cola                        $210.00
 Total:                                       $745.00

 Notice: Your account has been closed. Kindly remit the balance due immediately!

>l at oriental trading
The Oriental Trading invoice reads:

 Oriental Trading Company
 P.O. Box 2308
 Omaha, NE 68103-2308

 Mega Bulk 1000 Pc. Multicolor Toy & Novelty Handout Assortment             $184.99
 19" x 11" Bulk 500 Pc. Everyday Toy Treasure Chest Assortment              $119.98
 7" Bulk 72 Pc. Mini Solid Color Plastic Outdoor Bubble Wands                $77.98
 2" Bulk 100 Pc. Mega Everyday Fun Yellow Rubber Ducks Assortment            $44.99
 Total:                                                                     $427.94

 Your account is past due. Please pay immediately!

>l at mystic industries
The Mystic Industries invoice reads:

 Mystic Industries, Inc.
 40 Elm St
 Medford, WA 98101

 For services rendered:
 Repairs to the Stake Room in the Hell Ride Attraction after Fire   $22,500.00

 Please note that this invoice is overdue and will be assessed a finance charge of 2.5% per month, We appreciate your prompt payment.

>s
From here, the only way out is north.

>l at bulb
The flickering light from the lamps casts a yellow hue about the office.

>l at knick-knacks
These are little bits of memorabilia from the carnival life. There is a miniature Ferris wheel here. You can also see a mini carousel here.

>l at ferris wheel
(the mini Ferris wheel)
This is a miniature reproduction of the Ferris wheel.

>x carousel
This is a miniature replica of the Carousel.

>l at brochures
The brochures are meant to be left at convenience stores restaurants, and other businesses as a way to attract visitors to the carnival.

>l at cabinet
A locked cabinet, likely filled with old carnival financial records, is tucked away against one wall.

>l at safe
Next to the filing cabinet, there's a small, heavy safe where the owner keeps more sensitive materials. There is a knob on the front of the safe. You have turned the knob to 62, 22, and 3.

>read receipts
Piles of receipts and old financial statements cover much of the desk, but the documents seem to be a mix of chaotic disorganization and purposeful concealment. Most of these are for the regular day to day expenses such as: paper goods, consumables, etc. Closer inspection shows a steadily declining volume of goods ordered. Almost as if the carnival couldn't afford the full cost. Some are marked paid and others are not. Some are marked "Past Due". I wonder if the carnival is in some kind of financial trouble.

>get ferris wheel
(the mini Ferris wheel)
(putting the air freshener into the fanny pack to make room)
Taken.

>n
Concession Stand
Nearby a sturdy door leads south to the Carnival Office.

You can also see a concession attendant and a menu here.

>l at ferris wheel
(the Ferris Wheel)
The Ferris wheel towers above the carnival and is illuminated with vibrant lights, creating a dazzling display. As the wheel turns slowly, the gondolas remain upright, offering riders a thrilling yet gentle experience and spectacular views from the top.

>drop ferris wheel
(the mini Ferris wheel)
Dropped.

>l at ferris wheel
(the Ferris Wheel)
The Ferris wheel towers above the carnival and is illuminated with vibrant lights, creating a dazzling display. As the wheel turns slowly, the gondolas remain upright, offering riders a thrilling yet gentle experience and spectacular views from the top.

>ne
Ticket Booth
You can see a cashier here.

>w
In front of the tent, the barker gestures excitedly, calling out:

Ladies and gentlemen, boys and girls, gather 'round! 
Step right up and witness the spectacle that's taken the world by storm! 
She walks, she talks, she crawls on her belly like a reptile. 
Behold the one, the only Little Egypt, performing her legendary Dance of the Pyramids - a dazzling display of mystery, grace, and allure! 
For just a dime, a mere one tenth of a dollar, prepare to be transported to the sands of Cairo, where enchantment and wonder await!

Show Facade
As you walk west through the midway, the lights fade to a soft glow, leading you to a tent. A sign reads "Little Egypt Show - A Journey Into the Mysterious and Unknown!" The barker, wearing a fez and smiling, points to another sign: "Little Egypt - Dime Admission." The ticket kiosk is behind you to the east.

There is a stage in front of the tent. The Barker is encouraging you to step up and enjoy.

You can see a Barker here.

>l at tent
Inside the tent is the Little Egypt show.

>read sign
The sign reads, "Little Egypt Show - Dime Admission". Underneath it says "The show starts every 15 minutes beginning at the top of the hour."

>give dime to barker
(first taking the dime)
You hand over a dime, and the barker nods, waving you through. As you step up to the entrance, the air feels thicker and the sounds of the carnival fade away. You've entered an entirely different world now. Before you, there is a tent. Intrigued, you take your first step towards the Little Egypt Show. You can now head west into the show.

>w
Show Tent
You are inside the Little Egypt Show. The attraction's facade is to the east. There are folding chairs standing vigil in neat in rows. The show should start soon.

>sit in chair
You get onto the folding chair.

>smell
The smell of incense and spices wafts through the tent.

>listen
The soft sounds of unfamiliar music fill the air.

>l at palace
The stage is decorated to resemble a Middle Eastern palace, featuring rich, colorful fabrics, brass ornaments, and lanterns casting a warm, flickering glow. Scents of incense waft through the air, enhancing the atmosphere of mystique. The canvas displays painted scenes of pyramids, desert landscapes, and domed structures to evoking a sense of being transported to the "Middle East".

>l at stage
The stage is decorated to resemble a Middle Eastern palace, featuring rich, colorful fabrics, brass ornaments, and lanterns casting a warm, flickering glow. Scents of incense waft through the air, enhancing the atmosphere of mystique. The canvas displays painted scenes of pyramids, desert landscapes, and domed structures to evoking a sense of being transported to the "Middle East".

>l at pyramids
The canvas displays painted scenes of pyramids, desert landscapes, and domed structures .

>l at landscapes
The canvas displays painted scenes of pyramids, desert landscapes, and domed structures .

>l at lanterns
This is a highly polished brass lantern.

It is currently switched off.

The tent is dimly lit, the stage is a fully decorated representation of some Middle Eastern palace, featuring rich, colorful fabrics, brass ornaments, and lanterns casting a warm, flickering glow. Heady incense wafts through the air, softening everything around the edges. Enhancing the mystique, the backdrop displays painted scenes of pyramids, desert landscapes, and domed structures. The colorful onion topped buildings and jewel tones set to the sepia colored landscape have you transported far away.

>get lantern
You're much too entranced by the show to do anything other than watch the show. You are riveted!

Little Egypt emerges, draped in flowing silken veils. Skillfully she twirls using them as part of the dance. A sparkling, sequined bodice opens into a gauze skirt, adorned with jingling coin belts and jewelry that accentuate her dance.

>turn it on
You're much too entranced by the show to do anything other than watch the show. You are riveted!

The performance begins with slow, undulating movements, drawing you into the rhythm of the music. Traditional instruments like the oud, darbuka, or zurna are an accompanying chorus. As the tempo builds, her hips, torso, and hands twist in an intricate and mesmerizing pattern. Little Egypt demonstrates remarkable control and fluidity. She dramatically spins, drops, and shimmies, often punctuating the beat with a quick jingle of her coin belt.

>l at backdrop
Elegantly painted on linen, the backdrop shows scenes of Middle Eastern life.

Little Egypt makes eye contact with you and smiles enigmatically. In her performance she balances a fine silver sword on her head and accents her dance with tinkling finger cymbals.

>look at veils
Little Egypt is a beautiful woman who is draped in flowing silk veils which she skillfully uses as part of the dance. Her attire consists of a sparkling, sequined bodice and a flowing skirt, adorned with jingling coin belts and jewelry that accentuate her movements.

The music oscillates between hauntingly slow melodies and rapid, energetic drum beats, a roller coaster of emotion that leaves you entranced. Little Egypt relies on the music's dynamic changes to tell a story with movements reflecting joy, sorrow, seduction, and celebration.

>l at scenes
The canvas displays painted scenes of pyramids, desert landscapes, and domed structures .

The performance concludes with a dramatic flourish, an energetic shimmy, a bold spin, and Little Egypt casts off her veils. The dancer takes a bow to thunderous applause, leaving you spellbound by the sensual display.

You applaud until your hands are sore. Did she just wink at you?

As she leaves the stage, Little Egypt tosses one of her veils to you!

>wear veil
You wrap the veil around your head, shrouding your eyes. The world is a lovely color pink as you look through the veil while her perfume fills your nostrils in the most delightful way. You look pretty!

[Your score has just gone up by five points.]

>get lantern
Taken.

[Your score has just gone up by five points.]

>turn it on
You flip a switch. A strong, narrow beam of light shines from the lit lantern.

>l at landscapes
The canvas displays painted scenes of pyramids, desert landscapes, and domed structures .

>l at incense
The smell of incense and spices wafts through the tent.

>l at oud
The musical instrument is of traditional Middle Eastern origins.

>l at fabric
The linen and silk fabrics come in all different colors.

>l at brass ornaments
There are highly polished incense holders and brass lanterns here.

>l at canvas
Elegantly painted on linen, the backdrop shows scenes of Middle Eastern life.

>l at backdrop
Elegantly painted on linen, the backdrop shows scenes of Middle Eastern life.

The tent is dimly lit, the stage is a fully decorated representation of some Middle Eastern palace, featuring rich, colorful fabrics, brass ornaments, and lanterns casting a warm, flickering glow. Heady incense wafts through the air, softening everything around the edges. Enhancing the mystique, the backdrop displays painted scenes of pyramids, desert landscapes, and domed structures. The colorful onion topped buildings and jewel tones set to the sepia colored landscape have you transported far away.

>l at cymbals
The cymbals are placed on the thumb and index finger of each hand. Tapping them together produces a ringing sound.

Little Egypt emerges, draped in flowing silken veils. Skillfully she twirls using them as part of the dance. A sparkling, sequined bodice opens into a gauze skirt, adorned with jingling coin belts and jewelry that accentuate her dance.

>l at sword
This is a beautiful silver sword with a filigreed handle and blade.

The performance begins with slow, undulating movements, drawing you into the rhythm of the music. Traditional instruments like the oud, darbuka, or zurna are an accompanying chorus. As the tempo builds, her hips, torso, and hands twist in an intricate and mesmerizing pattern. Little Egypt demonstrates remarkable control and fluidity. She dramatically spins, drops, and shimmies, often punctuating the beat with a quick jingle of her coin belt.

>l at wall
You see nothing special about the wall.

Little Egypt makes eye contact with you and smiles enigmatically. In her performance she balances a fine silver sword on her head and accents her dance with tinkling finger cymbals.

>l at instruments
The musical instrument is of traditional Middle Eastern origins.

The music oscillates between hauntingly slow melodies and rapid, energetic drum beats, a roller coaster of emotion that leaves you entranced. Little Egypt relies on the music's dynamic changes to tell a story with movements reflecting joy, sorrow, seduction, and celebration.

>z
Time passes.

The performance concludes with a dramatic flourish, an energetic shimmy, a bold spin, and Little Egypt casts off her veils. The dancer takes a bow to thunderous applause, leaving you spellbound by the sensual display.

You applaud until your hands are sore. Did she just wink at you?

>e
(first getting off the folding chair)

Show Facade
You can see a Barker here.

>look
Show Facade
As you walk west through the midway, the lights fade to a soft glow, leading you to a tent. A sign reads "Little Egypt Show - A Journey Into the Mysterious and Unknown!" The barker, wearing a fez and smiling, points to another sign: "Little Egypt - Dime Admission." The ticket kiosk is behind you to the east.

There is a stage in front of the tent. The Barker is encouraging you to step up and enjoy.

You can see a Barker here.

>read sign
The sign reads, "Little Egypt Show - Dime Admission". Underneath it says "The show starts every 15 minutes beginning at the top of the hour."

>l at barker
Here is a man dressed in black pants, a blue shirt, a red vest, a hat much like a fez, and a dazzling smile.

In front of the tent, the barker gestures excitedly, calling out:

Ladies and gentlemen, boys and girls, gather 'round! 
Step right up and witness the spectacle that's taken the world by storm! 
She walks, she talks, she crawls on her belly like a reptile. 
Behold the one, the only Little Egypt, performing her legendary Dance of the Pyramids - a dazzling display of mystery, grace, and allure! 
For just a dime, a mere one tenth of a dollar, prepare to be transported to the sands of Cairo, where enchantment and wonder await!

>gonear janitor
Ticket Booth
Painted in bright red and yellow stripes, the ticket kiosk stands at the entrance with flickering lights to draw attention. A smiling cashier hands out tickets, while the cash drawer jingles. A digital payment system sits in the corner. Too bad you don't have a debit card.

To the right, a signboard displays ticket prices alongside illustrations of the rides. Pennant flags flutter and the air is filled with the scent of popcorn, pretzels, and grease.

The ground is worn from the steps of carnival goers eagerly waiting in line as they approach the midway.

The midway continues in all directions from here. There is a cashier here. A price list for attraction tickets is on the signboard. The cashier has Ferris Wheel ticket, Fortune Teller ticket, and Carousel ticket.

You can see a janitor and a cashier here.

The janitor heads to the Bumper Cars.

>nw
Bumper Cars
You can see a janitor and a Bumper Cars attendant here.

>janitor off
The janitor stands still.

>show cash 'n' carry to janitor
The janitor says, "Man, this doesn't look good for the carnival."

You've collected some new evidence.

>show frank's market to janitor
The janitor says, "Looks like the carnival is in some financial trouble."

You've collected some new evidence.

>show mystic industries to janitor
The janitor says, That fire in Hell Ride was really bad. It took almost two weeks to get it fully repaired. But it shouldn't have cost this much. I think Mr Whidbey got ripped off. Or, he got it fixed on the cheap and pocketed the rest."

You've collected some new evidence.

>show oriental trading to janitor
The janitor says, "These prizes are cheaper and flimsier than usual."

You've collected some new evidence.

>show insurance policy to janitor
"An insurance policy? For a million dollars? Something is fishy for sure!" the janitor says.

You've collected some new evidence.

>show pliers to janitor
You can't see any such thing.

>show check to janitor
The janitor says "What?! That's the name of the kid who got hurt in the Bumper Cars incident."

You've collected some new evidence.

>display evidence
Weight   Evidence collected:
  ------   --------------------------------------------------------
•    28    Evidence concerning accidents with the attractions
•     8    Evidence concerning insurance
•     5    Evidence concerning Mr Whidbey
•     3    Evidence concerning past due invoices
  ------   --------------------------------------------------------
•    44    Total Weighted Evidence

You have enough evidence to press charges.

>se
Ticket Booth
You can see Mr Whidbey and a cashier here.

Mr Whidbey heads to the Head of the Line.

>l at attendant
This is another bored teenager. He wonders how is he supposed to look cool dressed in this awful uniform.

>g
This is another bored teenager. He wonders how is he supposed to look cool dressed in this awful uniform.

>g
This is another bored teenager. He's just trying to earn enough money to take his sweetie to the movies next week.

>ask attendant about uniform
Wearing blue pants and a pink shirt, the cashier says, "This is just awful! I look like a lollipop."

>ask attendant about brewski
"A nice cold Coors Light would taste good about now", the cashier replies

>ask attendant about beer
"A nice cold Coors Light would taste good about now", the cashier replies

>ask attendant about game
The cashier says, "Friday night is the league championship. I hope we win!"

>s
Head of the Line
You are standing in front of an attendant with his hand open waiting for your ticket. The entrance to the ride is south of here. The ride operator tells you that you're lucky you showed up when you did because this will be the last trip through Hell Ride for the night. You notice that all the other cars are empty. The Ticket Kiosk is north of here.

You can see a Hell Ride attendant here.

>give ticket
(the Hell Ride ticket to the Hell Ride attendant)
You give the Hell Ride ticket to the Hell Ride attendant.

>l at cars
(the hell ride cars)
These cars ferry carnival goers into the depths of Hell Ride.

>l at car
These cars ferry carnival goers into the depths of Hell Ride.

>screw attendant
Hell Ride isn't that kind of game!

>damn
Real adventurers don't use that sort of language!

>shit
And you kiss your mother with that mouth?

>damn
Real adventurers don't use that sort of language!

>give hell ride ticket to attendant
(first taking the Hell Ride ticket)
That seems to belong to the Hell Ride attendant.

>s
Ride Entrance
The cars for Hell Ride stop here, and the safety bar clicks into place as riders board the cars. Ahead, the grotesque entrance looms - a twisted metal archway adorned with spikes, skulls, and flickering blood-red lights. A faint sulfuric smell mixes with the scent of popcorn.

The "HELL RIDE" sign pulses above the door, while demon statues with clawed hands seem to beckon. The entrance is shrouded in darkness, broken only by eerie green flashes that reveal twisted paths. Faint whispers and distant organ music grow louder. To one side, the darkness looks a little bit darker than the rest of the room.

You can see a Hell Ride car (empty) here.

>l at cars
(the Hell Ride car)
A car waits to take you through the horror that is Hell Ride.

>smell
You can smell a faint sulfuric tang in the air.

>listen
The sound of organ music, shrieks, and grinding machinery fills the air.

>l at lights
The archway surrounds the entrance to the ride.

>l at flames
The archway surrounds the entrance to the ride.

>l at sculptures
On either side of the doors are sculptures of demons welcoming you inside.

>l at paths
The paths lead through the darkness into Hell Ride.

>l at shapes
Shadowy figures in the shape of demons can be seen through the door.

>l at threshold
There are skulls scattered about the threshold of the ride entrance.

>l at flashes
Flashes of sickly green light reveal twisted paths and grotesque shapes in the dark of the ride.

>e
Dark Passage
This room is backstage at the Hell Ride attraction. The room is littered with bags of trash, piles of junk, and dust bunnies so large they should be paying rent. There an exit to the south and west.

[Your score has just gone up by five points.]

>l at bags of trash
This is a pile of assorted flotsam and jetsam from the carnival. None of it looks very interesting.

In the pile of junk is a flashlight.

>l at junk
This is a pile of assorted flotsam and jetsam from the carnival. None of it looks very interesting.

In the pile of junk is a flashlight.

>get flashlight
Taken.

[Your score has just gone up by five points.]

>turn it on
You flip a switch. A strong, narrow beam of light shines from the lit flashlight.

>w
Ride Entrance
You can see a Hell Ride car (empty) here.

>n
Head of the Line
You can see a Hell Ride attendant here.

>n
Ticket Booth
You can see a cashier here.

>s
Head of the Line
You can see a Hell Ride attendant here.

>n
Ticket Booth
You can see a cashier here.

>e
High Striker
You can see a High Striker attendant, a bullseye, and some High Striker prizes here.

>l at janitor
You can't see any such thing.

>e
Ferris Wheel
You can see a Ferris Wheel attendant here.

>give flashlight to janitor
You can't see any such thing.

>w
High Striker
You can see a High Striker attendant, a bullseye, and some High Striker prizes here.

>w
Ticket Booth
You can see a cashier here.

>s
Head of the Line
You can see a Hell Ride attendant here.

>s
Ride Entrance
You can see a Hell Ride car (empty) here.

>e
Dark Passage

>l at bunnies
These are some massive dust bunnies. Be careful, I've heard they bite.

>s
Maintenance Office
The maintenance office is a dim, cluttered space, filled with the smells of grease, sweat, and popcorn. Disorganized shelves are lined with tools and parts, while paint cans and grease jars clutter the workbenches. A battered desk holds wires, gears, and springs, with a bent piece of metal in a vise.

A flickering fluorescent light barely brightens the room. In one corner, a disassembled ride mechanism hangs with chains and pulleys. A greasy manual and a half-empty coffee mug sit on a nearby stool.

Faded safety posters and a worn photo of the carnival decorate the walls, along with a corkboard full of schedules and notes, and a worn photo of the carnival in its prime. The floor is gritty with dust and scattered nails. Despite the mess, the room buzzes with purpose and keeps the carnival running, fueled by sweat and ingenuity.

Exits lead north and south.

Nearby a ladder leads up.

Nearby an aqua colored door leads west.

You can also see a worn photo and a desk (on which are a coffee mug and a radio) here.

>smell
You smell grease, oil, and the other scents that linger back stage.

>listen
You can hear a clock ticking softly nearby.

>l at shelves
The shelves hold all manner of things.

>l at labels
The labels have faded so much that they are illegible.

>l at jars
Screws, grease jars, and cans of paint are here.

>l at tools
The tools are varied and surely fit all manner of things around the carnival.

>l at parts
The parts are varied and surely fit all manner of things around the carnival.

>l at screws
Screws, grease jars, and cans of paint are here.

>l at workbenches
The workbenches are messy, cluttered, and covered with things.

>l at wires
The wires lay in twisted tangles on the desk.

>turn on radio
You switch the radio on.

You hear Dolly Parton's "Jolene" playing on the radio.

>l at gears
The gears and springs are strewn on the desk.

The DJ announces that "Tracks Of My Tears" by Smokey Robinson will be up next.

>l at posters
You're the safe choice for safety!

"Margaritaville" by Jimmy Buffet plays on the radio.

>l at schedules
Looking at the maintenance schedules and notes, all you can see are the illegible scribbles of a child.

Nearby, you can hear "More Than A Feeling" by Boston.

>look
Maintenance Office
The maintenance office is a dim, cluttered space, filled with the smells of grease, sweat, and popcorn. Disorganized shelves are lined with tools and parts, while paint cans and grease jars clutter the workbenches. A battered desk holds wires, gears, and springs, with a bent piece of metal in a vise.

A flickering fluorescent light barely brightens the room. In one corner, a disassembled ride mechanism hangs with chains and pulleys. A greasy manual and a half-empty coffee mug sit on a nearby stool.

Faded safety posters and a worn photo of the carnival decorate the walls, along with a corkboard full of schedules and notes, and a worn photo of the carnival in its prime. The floor is gritty with dust and scattered nails. Despite the mess, the room buzzes with purpose and keeps the carnival running, fueled by sweat and ingenuity.

Exits lead north and south.

Nearby a ladder leads up.

Nearby an aqua colored door leads west.

You can also see a worn photo and a desk (on which are a coffee mug and a radio) here.

You hear Bob Marley's "No Woman, No Cry" playing on the radio.

>read manual
The manual is titled: "Fixing Your Ferris Wheel. It's Easier Than You Think!"

You sing along to R.E.M.'s "Losing My Religion".

>drink coffee
That looks nasty. There's something floating on the top. I wouldn't drink that if I was you.

"Respect" by Aretha Franklin plays on the radio.

>drink coffee
You decide to drink it after all. Your stomach lurches as the cold, nasty coffee settles.

You hear Led Zeppelin's "Fool In The Rain" playing on the radio.

>drink coffee
You've learned your lesson and set the coffee cup down.

The DJ announces that "Young Americans" by David Bowie will be up next.

>drink coffee
There's nothing suitable to drink here.

"Over The Rainbow" by Bruddah Iz plays on the radio.

>l at clock
The clock is wildly off the correct time. I guess it's broken.

The DJ announces that "Ripple" by The Grateful Dead will be up next.

>turn off radio
You switch the radio off.

>u
Dark Hallway
This is a poorly lit hallway. Ahead to the west you can see a closed door.

Nearby a ladder leads down to the Maintenance Office.

Nearby a metal door leads west.

>w
(first opening the metal door)
(first unlocking the metal door)
(with the brass key)

Control Room
The backstage control room is a functional space with gray, scuffed walls. A large monitor shows live feeds while control panels with dials, buttons, and lights manage the rides and systems. The panels remain oddly dark.

The hum of electronics is interrupted by a crackling radio: "Maintenance to Bumper Cars - wrench needed!" Papers, tools, and coffee cups clutter the floor. A desk holds logs and schedules, and a corkboard displays charts and red-marked notes, including one that says "Check Zipper circuit breakers."

A single light casts harsh shadows, and the air smells of lubricant and burnt wires, mingling with dampness. The room is hidden but vital, keeping the carnival running. On one wall, a switch sparks with blue and white arcs.

On one wall is a large switch with sparks arcing out from it.

Nearby a metal door leads east to Dark Hallway.

Currently there are sparks arcing out from the switch. It looks dangerous.

[Your score has just gone up by five points.]

>l at monitor
The monitor flickers for a second and the scene it displays changes to something different.
The monitor now shows nothing but snow.

>l at papers
The worn floor is scattered with papers, tools, and coffee cups.

>l at desk
The desk is covered with all matter of detritus.

>l at cork board
The cork board displays charts and notes.

>l at charts
There is nothing interesting about the charts and notes.

>listen
The hum of electronics fills the air, punctuated by the crackle of a radio: "Maintenance to Bumper Cars - wrench needed!"

>flip switch
You switch the big switch off.

[Your score has just gone up by five points.]

>e
Dark Hallway
Nearby a metal door leads west to Control Room.

Nearby a ladder leads down to the Maintenance Office.

>d
Maintenance Office
Nearby a ladder leads up to Dark Hallway.

Nearby an aqua colored door leads west.

You can also see Mr Whidbey, a worn photo, and a desk (on which are a coffee mug and a radio) here.

>get photo
(putting the parking ticket into the fanny pack to make room)
Taken.

Mr Whidbey heads to the Stocks Room.

>look at it
This is a photo of the carnival in its heyday! A ragtag bunch of people are featured in the picture in front of the Hell Ride facade. On the back reads a date: "03/22/62". This looks like the same photo you found in the Carnival Office.

>s
Crawl Space
The crawl space beneath the ride is cramped and dark, filled with the hum of machinery above. The air is thick with oil and rust. Sounds echo - groaning steel, clanking chains, and the rhythmic thrum of motors.

The ground is uneven, a mix of dirt, gravel, and scattered tools. Pipes overhead are wrapped in fraying insulation, crackling as you move. Small puddles of murky water collect.

The backstage area continues north and south.

Nearby a crimson colored door leads west.

>listen
You can hear the hum of the machinery above.

>smell
The air is stale and heavy, carrying the sharp metallic scent of oil and the faint tang of rust.

>l at tools
Scattered on the floor are some long forgotten tools.

>l at pipes
The pipes head in every direction.

>l at wires
Scattered on the floor are some hopelessly tangled wires.

>l at scraps
These scraps are mostly angle iron and scaffolding.

>l at insulation
The insulation is ratty and not doing much good to protect the cables and pipes.

>l at puddles
You move gingerly to avoid the puddles. It's much more pleasant to be dry.

>s
Mechanical Room North
The north mechanical room is compact, housing auxiliary systems for the ride. A soft hum of capacitors and relays fills the space, interrupted only by the occasional hissing of hydraulic fluid.

Circuit breaker panels line the walls, labeled for different functions. Cables and conduits connect the systems to the main hub. Flickering with gauges, a hydraulic pump in the corner manages lifting arms and platforms.

A small workbench is cluttered with parts, while shelves above hold spare parts like cables and hydraulic tubing. A faded ride diagram with red annotations is pinned nearby. The room feels cool and damp.

There are exists north and south.

Nearby an emerald colored door leads west.

You can also see a toolbox (closed) and a sledgehammer here.

>listen
You hear the subdued hum of capacitors and relays.

>smell
You smell grease, oil, and the other scents that linger back stage.

>l at  capacitors
The subdued hum of capacitors and relays fills the air.

>l at relays
The subdued hum of capacitors and relays fills the air.

>l at circuit breaker
These are electrical panels for other parts of the carnival.

>l at cables
The cables snake along the walls.

>l at pump
This is some of the equipment that keeps the carnival running smoothly.

>l at gauges
The room is full of gauges reporting on the condition of the carnival.

>l at tools
Just some of the many tools used to maintain the carnival.

>l at wires
The cables snake along the walls.

>l at diagram
This is an electrical diagram for something.

>l at bulb
This single bulb is feebly trying to light the room.

>s
Mechanical Room South
The south mechanical room is the heart of the ride, with a massive motor powering the thick belts, pulleys, and gears. Electrical panels line the walls, flashing "High Voltage" and colorful indicator lights.

Conduits and wires snake across the ceiling, connecting systems. A cluttered table holds tools, spare parts, and maintenance logs stained with grease. The air smells of oil, metal, and ozone.

A cooling fan struggles to cut the warmth as the hum of machinery mixes with the hiss of hydraulics and clinking chains. The floor is a patchwork of metal grates and worn concrete. The room is busy; every movement is precise and controlled.

You can travel north and south from here.

Nearby a gray colored door leads west.

You can also see a grate (in which is an emerald colored fuse) here.

>l at motor
There is all manner of unidentifiable equipment here.

>l at pulleys
The table is covered with belts, lubricants, gears, pulleys, gears and bolts.

>l at panels
These are electrical panels controlling other parts of the carnival.

>l at wires
The wires snake across the ceiling, in and out of the conduits.

>l at conduits
The labeled conduits and wires snake across the ceiling.

>l at gears
The table is covered with belts, lubricants, gears, pulleys, gears and bolts.

>l at table
The table is covered with belts, lubricants, gears, pulleys, gears and bolts.

>l at fan
This is an overworked fan.

>l at chains
The chains clink as they sway against the vibrations of the machinery.

>l at maintenance logs
These logs record the dates, times, and repairs made for the carnival rides. You notice that Hell Ride is conspicuously missing from the logs. One week, the bumper cars were missing from the schedule.

>l at fingerprints
The police could use these to track down a criminal.

>l at wire cages
The wire cages protect the fluorescent lights from becoming damaged.

>l at grate
This grate leads down into the darkness. Too bad it's locked.

In the grate is an emerald colored fuse.

>get fuse
(the emerald colored fuse)
Your fingers won't fit inside the grate. You can't reach the emerald colored fuse.
If only you could grab the emerald colored fuse with something.

>put parking ticket in grate
(first taking the parking ticket)
(putting the 14" long piece of string into the fanny pack to make room)
You put the parking ticket into the grate.

>get parking ticket
Your fingers won't fit inside the grate. You can't reach the parking ticket.
If only you could grab the parking ticket with something.

>tie string to mallet
You tie the 14" long piece of string to the mallet.

>put mallet in grate
Nothing happens.

>untie string from mallet
You untie the 14" long piece of string (tied to a mallet) from the mallet.

>tie string to bubblegum
You tie the 14" long piece of string to the Bubblegum.

>put bubblegum in grate
It's a hard square of bubblegum and won't stick to the fuse.

>chew bubblegum
You chew the bubblegum, blowing a few bubbles as you do so.

>put bubblegum in grate
You drop the chewed bubblegum into the grate. The emerald colored fuse attaches to the chewed bubblegum. You quickly and carefully raise the chewed bubblegum and drop emerald colored fuse into your hand.

[Your score has just gone up by ten points.]

>n
Mechanical Room North
Nearby an emerald colored door leads west.

You can also see a toolbox (closed) and a sledgehammer here.

>open tool box
You open the toolbox, revealing an adjustable wrench, some channel locks, and a hammer.

>get wrench
(putting the Bumper Cars ticket into the fanny pack to make room)
Taken.

>get sledgehammer
(putting the brass ring into the fanny pack to make room)
Taken.

>i
You are carrying:
  a sledgehammer
  an adjustable wrench
  an emerald colored fuse
  a worn photo
  a lit flashlight (providing light)
  a lit lantern (providing light)
  a sheer veil (being worn)
  a check stub
  an envelope (open but empty)
  a Mystic Industries invoice
  an Oriental Trading invoice
  a Frank's Market invoice
  a Cash 'N' Carry invoice
  an insurance policy
  a gold key
  an indigo colored fuse
  a khaki colored fuse
  some chewed bubblegum
  a crimson colored fuse
  a horseshoe magnet
  a mallet
  a pair of gloves (being worn)
  a fanny pack (being worn, and open)
    a brass ring
      a brass key (which opens the sturdy door and the metal door)
    a Bumper Cars ticket
    a 14" long piece of string (tied to some chewed bubblegum)
    an air freshener
    three quarters
    a nickel
    two dimes
    a wallet
      $19.00 in cash
    a notebook

>put all invoices in fanny pack
Cash 'N' Carry invoice: Done.
Mystic Industries invoice: Done.
Oriental Trading invoice: Done.
Frank's Market invoice: There's no room in the fanny pack to hold the Frank's Market invoice.

>drop flashlight
Dropped.

>drop magnet
Dropped.

>get wrench
You already have that.

>n
Crawl Space
Nearby a crimson colored door leads west.

>n
Maintenance Office
Nearby a ladder leads up to Dark Hallway.

Nearby an aqua colored door leads west.

You can also see Mr Whidbey and a desk (on which are a coffee mug and a radio) here.

>open drawer
You open the drawer, revealing some scissors, a stapler, a ballpoint pen, a pad of paper, and a silver key.

>get silver key
Taken.

Mr Whidbey heads to the Stocks Room.

>n
Dark Passage

>w
Ride Entrance
You can see a Hell Ride car (empty) here.

* * *

>n
Ticket Booth
You can see a cashier here.

>nw
Bumper Cars
You can see a janitor and a Bumper Cars attendant here.

>give wrench to attendant
Hey! Thanks, I really appreciate it. Usually no one ever responds to the radio in the Control Room. Here, take this fuse.

Taken.

[Your score has just gone up by five points.]

[Your score has just gone up by ten points.]

>give ticket to attendant
(first taking the Bumper Cars ticket)
You give the Bumper Cars ticket to the Bumper Cars attendant.

You hand your ticket to the attendant and slide into the bucket seat, gripping the wheel as the arena comes alive with flashing lights and the hum of electric currents. Riders lock eyes, eager for the ride to begin.

The car jolts forward, and you steer into the fray. A sudden crash spins you around, but you recover and aim for a friend. Each collision is met with laughs as you dodge, swerve, and plot your next move in the chaos.

You find yourself giddy as you exit the ride.

>i
You are carrying:
  a gray colored fuse
  a silver key
  a sledgehammer
  an emerald colored fuse
  a worn photo
  a lit lantern (providing light)
  a sheer veil (being worn)
  a check stub
  an envelope (open but empty)
  a Frank's Market invoice
  an insurance policy
  a gold key
  an indigo colored fuse
  a khaki colored fuse
  some chewed bubblegum
  a crimson colored fuse
  a mallet
  a pair of gloves (being worn)
  a fanny pack (being worn, and open)
    an Oriental Trading invoice
    a Mystic Industries invoice
    a Cash 'N' Carry invoice
    a brass ring
      a brass key (which opens the sturdy door and the metal door)
    a 14" long piece of string (tied to some chewed bubblegum)
    an air freshener
    three quarters
    a nickel
    two dimes
    a wallet
      $19.00 in cash
    a notebook

>se
Ticket Booth
You can see a cashier here.

>e
High Striker
You can see a High Striker attendant, a bullseye, and some High Striker prizes here.

>hit bullseye with sledgehammer
As you swing, you feel the extra weight from the sledgehammer. As it comes down on the bullseye, you can't help but feel like the extra weight gives you an edge. The bell rings as the striker reaches the top of the pole. The attendant says, "You're a Muscle Man. Here's a prize for you."

Which prize would you like? 1) a teddy bear, 2) a knock-off Swiss Army knife, 3) a magenta colored fuse, 4) a poster of Taylor Swift?

>2
You are now holding a knock-off Swiss Army knife.

[Your score has just gone up by five points.]

>hit bullseye with sledgehammer
As you swing, you feel the extra weight from the sledgehammer. As it comes down on the bullseye, you can't help but feel like the extra weight gives you an edge. The bell rings as the striker reaches the top of the pole. The attendant says, "You're a Muscle Man. Here's a prize for you."

Which prize would you like? 1) a teddy bear, 3) a magenta colored fuse, 4) a poster of Taylor Swift?

>3
You are now holding a magenta colored fuse.

[Your score has just gone up by five points.]

>w
Ticket Booth
You can see a cashier here.

* * *

>e
Dark Passage

>s
Maintenance Office
Nearby a ladder leads up to Dark Hallway.

Nearby an aqua colored door leads west.

You can also see a desk (on which are a coffee mug and a radio) here.

>s
Crawl Space
Nearby a crimson colored door leads west.

>s
Mechanical Room North
Nearby an emerald colored door leads west.

You can also see a horseshoe magnet, a lit flashlight (providing light), and a toolbox (in which are some channel locks and a hammer) here.

>s
Mechanical Room South
Nearby a gray colored door leads west.

You can also see a grate (in which is a parking ticket) here.

>s
Generator Room
The generator room is small, with concrete walls stained by oil and grime. The air smells of diesel, metal, and damp earth.

The main generator hums, connected by thick cables to circuit breakers and a cluttered panel with switches and gauges. A flickering display shows power levels. The cracked floor is littered with puddles. Shelves hold spare parts and manuals, and a workbench sits next to a grease canister.

The room is the carnival's power source, hidden but essential.

The backstage area continues north and south of here.

Nearby an indigo colored door leads west.

>l at graffiti
The graffiti is varied, from "Peace, Love, Goodwill on Earth" to "Anarchy Rules".

>smell
The air carries a mix of diesel, hot metal, ozone, and damp earth, creating a distinctly industrial scent.

>l at generator
(the main generator)
The main generator hums steadily.

>l at cables
These cables connect different parts of the ride to the hydraulics.

>l at puddles
Not wanting to get your shoes wet, you carefully avoid the puddles.

>l at shelves
The shelves are piled high with filters, spark plugs, and wire coils.

>l at spare parts
The shelves are piled high with filters, spark plugs, and wire coils.

>l at filters
The filters litter the shelves.

>l at spark plugs
The spark plugs are piled on the shelves.

>l at coils
The wire coils littler the shelves.

>l at canister
This is a canister of grease used to provide proper lubrication to the machinery.

>read sign
The sign reads, "Fuel Safety - No Open Flames!"

>l at diesel canisters
The canisters are full of diesel fuel.

>s
Electrical Room
The electrical room is small, hidden behind the carnival's attractions. The air smells of overheated wires and metal.

A central breaker panel dominates one wall, with labels like "Ferris Wheel Lights" and "Carousel Motors." Indicator lights blink intermittently. Thick cables hang from the ceiling, connected to the carnival's power network.

A junction box spills wires, and a workbench holds tools and a smudged wiring diagram. The floor is scratched and stained. A faint vibration pulses in the air.

An emergency shutdown panel and fire extinguisher sit nearby. Fluorescent lights cast shifting shadows. The room is raw and essential, a behind-the-scenes look at the carnival's power.

This room is eerily quiet, missing the ever present buzz of electricity. There are exits in all directions.

>smell
The air vibrates with electric energy, carrying the acrid scent of overheated wires and metal.

>listen
You hear the buzz of electricity all around you.

>l at breaker
This breaker panel controls various portions of the carnival.

>l at junction box
This is a junction box routing the various wires and electrical cables running through the back stage area.

>l at workbench
This is a cluttered work bench. You would have a hard time finding room to do anything on it.

>l at shutdown
This is an emergency shut down panel. There is a switch on the panel.

>l at switch
This is a big red switch, presumably to shut down the carnival rides.

It is currently switched on.

>flip switch
You apply a considerable amount of force and push the red switch. You listen and can still hear the sounds of the machinery working somewhere. Nothing happens.

You switch the red switch off.

>l at fire extinguisher
This is a Class E fire extinguisher, specially made for electrical fires.

>l at poster
The poster reads, "Safety First!"

>l at diagram
It's hard to make out what this is supposed to be. Better leave it alone.

>l at tools
These are various tools you might use to repair electrical equipment.

>s
Storage Room
The storage room is cramped and hidden, with rusted walls and peeling wood. The air smells of dust, damp canvas, and stale popcorn.

Shelves are packed with light bulbs, wire, and old ride parts. Flags, lights, and crates of toys clutter the space. In one corner, tarps and tent poles are stacked.

Spare ride seats and an old carousel horse sit under tarps in the center. A cluttered desk holds schedules and coffee cups, with a bulletin board full of flyers.

The concrete floor is littered with scraps and dirt. Rats scurry and cobwebs move. This forgotten room stores the remnants of the carnival, waiting to be revived.

There is an exit to the north.

Nearby a khaki colored door leads west.

>l at walls
The rusted metal and peeling wooden walls bear the marks of years of use.

>l at shelves
The shelves are full of supplies, light bulbs, and ride parts

>smell
The air hangs heavy with grease, dust, damp canvas, and a faint trace of stale popcorn.

>listen
You hear mechanical sounds: the screech metal upon metal, gears turning in precision, and the thump of the cars as they traverse the tracks through the ride.

>l at seats
These are broken seats from some of the rides.

>l at booths
It's impossible to tell which parts belong to which attraction.

>l at horse
This is one of the horses from the carousel ride. It looks like its tail is broken.

>l at tarps
The tarps and tent poles are used to provide shelter to the attendants if it should rain.

>l at desk
The desk is covered with supplies, light bulbs, and ride parts.

>l at battered desk
The desk is covered with supplies, light bulbs, and ride parts.

>l at coffee cups
People just use the desk as a trash can.

>l at logs
You can't see any such thing.

>l at bulletin board
So much tattered paper on this bulletin board. Most of it is illegible.

>l at repair requests
So much tattered paper on this bulletin board. Most of it is illegible.

>l at schedules
So much tattered paper on this bulletin board. Most of it is illegible.

>l at bulb
The fluorescent bulb flickers overhead.

>l at nuts
The shelves are full of supplies, light bulbs, and ride parts.

>l at rates
You can't see any such thing.

>l at rats
You see rats scurry in all directions fleeing from the light cast by you.

>l at cobwebs
There are cobwebs everywhere. I guess it's been a while since this place was cleaned.

>n
Electrical Room

>ne
Electrical Closet One
This is Electrical Closet One. There's an electrical panel here and an exit to the southwest.

>l at electrical panel
Electrical Panel 1 is a standard issue 200 amp electrical panel supplying 220 power throughout the ride. The electrical panel is closed. There are screws holding it shut.

>sw
Electrical Room

>s
Storage Room
Nearby a khaki colored door leads west.

>w
(first opening the khaki colored door)
(first unlocking the khaki colored door)
(with the silver key)

Ride Exit
The exit of Hell Ride leaves you unsettled. You emerge from a dark corridor, the walls peeling and streaked with black and red. Flickering lights cast shifting shadows on the sloped floor, and the air is damp with a metallic tang. Whispers and distant screams echo softly in the background.

In a small courtyard, a rusted fence draped with cobwebs and plastic bones encloses the area. A worn sign reads, "You've Survived? For Now." Nearby, carnival workers in tattered costumes watch quietly, muttering, "Not everyone makes it out."

The nearby gift shop glows red. The bright lights and sounds of the carnival feel distant and jarring after the oppressive atmosphere of the ride.

The exit ensures Hell Ride isn't just an experience - it lingers, blurring the line between thrill and fear.

There is a price list next to the cash register. An attendant is here to assist you with your purchases. The stand has aqua colored fuse, Plastic Bones, Devil Horns, Key Chains, and T-Shirts for sale.

Nearby a wooden door leads east to the Storage Room.

You can also see a merchandise attendant here.

>read sign
$2.00 Key Chains
$3.50 Aqua Colored Fuse
$2.00 Devil Horns
$1.00 Plastic Bones
$7.50 T-Shirts

>buy aqua fuse
You fork over $3.50 for the aqua colored fuse, leaving yourself with $15.50.

[Your score has just gone up by ten points.]

>l at fencing
The jagged, rusted fencing is draped with cobwebs and plastic skulls.

>l at cobwebs
The fake cobwebs and skulls cover the rusty fencing.

>l at plastic skulls
The fake cobwebs and skulls cover the rusty fencing.

>l at workers
The actors are here dressed in their tattered costumes muttering things like "You made it!"

>l at actors
The actors are here dressed in their tattered costumes muttering things like "You made it!"

>l at riders
The riders exit Hell Ride. Some are laughing while others look rather upset.

>l at walls
Leading out of the ride a dark corridor with peeling black and red-streaked walls, flickering lights cast erratic shadows on the uneven floor.

>l at cash register
The cash register accommodates both cash and electronic payments. Too bad you don't have a debit card.

>bite fingernails
That's a bad habit. You should really try to stop biting your fingernails.

>clip fingernails
Your fingernails look much neater now that you've trimmed them.

>n
As you enter the room, you can see Mr Whidbey across the way. He seems to be doing something around the guillotine platform. You walk closer to see what he is doing and startle him. Mr Whidbey spins around and glares at you. As he turns and walks out of the room, you think you saw him drop something.

Guillotine Room
The public square hums with tension under gray skies. A wooden platform stands at the center, a grim focal point.

A lone figure, hands bound and head bowed, stands on the scaffold. Their tattered clothes reveal a once-gilded past.

The crowd jeers while children watch wide-eyed. The town crier proclaims, "High treason against the crown!"

The condemned remains silent as the executioner, robed in black, stands beside the guillotine. The blade gleams in the dim light. The crowd's murmurs die, replaced by silence.

As the condemned approaches, the guillotine's timing falters. Instead of falling on the scaffold, the blade swings over the cars, threatening any unlucky passenger who passes beneath.

There is just one problem: the guillotine is being raised and lowered by some mechanism. It appears that the timing of the guillotine is off and it is being lowered onto the cars instead of between them. If a person were to be in a car as it passed under the guillotine, they would be seriously injured.

You're glad you're not in one of those cars now. You must do something to stop it before someone gets hurt! 

Nearby a wooden door leads east to the Generator Room.

You can also see Mr Whidbey and a guillotine platform here.

Mr Whidbey heads to the Carnival Office.

>l at crowd
The crowd encircles the platform, emotions ranging from jeers and curses to silent, grim observation. Children sit on shoulders, their curious eyes unaware of the event's gravity.

>l at platform
At the center of the square stands a raised wooden platform, stark and imposing, where the grim sentence is to be carried out. You can just make out something underneath the platform in the dark.

>l at figure
A lone figure stands on the scaffold, bound hands behind their back and head bowed low, avoiding the crowd's gaze.

>l at children
The crowd encircles the platform, emotions ranging from jeers and curses to silent, grim observation. Children sit on shoulders, their curious eyes unaware of the event's gravity.

>l at town crier
The town crier proclaims the crime: "High treason against the crown. Let this be a warning to all who defy the realm!"

>l at condemned
A lone figure stands on the scaffold, bound hands behind their back and head bowed low, avoiding the crowd's gaze.

>l at executioner
The executioner - a hooded figure in black - stands ready beside the guillotine.

>l at scaffold
At the center of the square stands a raised wooden platform, stark and imposing, where the grim sentence is to be carried out. You can just make out something underneath the platform in the dark.

>l at crow
The crow sits, sleek and black, on a nearby rooftop.

>l under platform
You find the pliers!

>get pliers
Taken.

[Your score has just gone up by five points.]

>l at cars
The cars keep coming and move under the malfunctioning guillotine. You shudder at just the thought of it

>n
Dungeon
The dungeon is dark and damp, the air thick with sweat, blood, and mildew. Lanterns flicker on rusted sconces, casting twisted shadows.

Chains rattle, mixed with distant moans and screams. Water drips from a cracked ceiling, pooling on the blood-dark floor.

Instruments of torture clutter the room: a broken rack, a brazier with bloodstained tools, and a spiked chair. Prisoners endure all these things, bound or writhing in agony.

The torturer moves with cold precision, ignoring the suffering. Above, rats scurry in the shadows, and the heavy, oppressive air thickens with despair.

Nearby a wooden door leads east to the Mechanical Room South.

You can also see an iron chair, a splintered rack, and a glowing brazier here.

>l at walls
The its stone walls slick with moisture and grime.

>smell
The air reeks of sweat, blood, mildew, and burning oil from flickering torches mounted on rusted sconces.

>listen
Chains hang from walls and ceilings, their faint clinking blending with the moans and occasional screams of prisoners.

>l at chains
The chains rattle against the walls.

>l at rack
The rack has a prisoner splayed in four directions.

>l at brazier
It is glowing red with an infernal heat raising the temperature of the bloodstained tools.

>l at torches
These are oil burning lamps.

>l at sconces
These are oil burning lamps.

>l at prisoners
Prisoners endure their own horrors - one stretched on the rack, another hanging limply from manacles, and a third gasping weakly in the spiked chair.

>l at torturer
The hooded torturer wears a leather apron stained with the evidence of countless victims.

>l at rats
You see rats scurry in all directions fleeing from the light cast by you.

>l at walls
The its stone walls slick with moisture and grime.

>l at rats
You see rats scurry in all directions fleeing from the light cast by you.

>n
Stake Room
The public square is silent, broken only by crackling flames. At its center, three women are bound to wooden stakes, their faces showing defiance, resignation, and terror.

A crowd watches, some jeering, others praying or looking away. Torch in hand, the executioner steps forward igniting the pyre. Flames roar as the women cry out, their voices lost in the heat.

Gray clouds loom above as a raven caws. Church bells toll, marking the tragedy. Some onlookers stay, others quietly leave.

Nearby a wooden door leads east to the Mechanical Room North.

The flames of the pyre burn ever brighter and rise ever higher engulfing the victims.

>l at square
The public square is steeped in grim silence, broken only by the crackling of flames.

>l at flames
The flames burn ever higher.

In the pyre is a quartz colored fuse.

>get quartz fuse
(putting the mallet into the fanny pack to make room)
Taken.

>l at pyre
The flames burn ever higher.

>l at logs
The flames burn ever higher.

>l at stakes
(stakes)
Three wooden stakes rise from a pyre. Bound to the stakes are three women.

>l at women
Bound to the stakes are three women, their faces reflecting defiance, resignation, and terror.

>l at crowd
A crowd encircles the scene, expressions ranging from morbid fascination to righteous fury.

>l at children
A crowd encircles the scene, expressions ranging from morbid fascination to righteous fury.

>listen
A raven caws from the bell tower as slow church bells toll.

>smell
The smell of smoke permeates the air.

>l at apron
The leather apron appears to have seen its share of action.

>l at executioner
The executioner, hooded and clad in a leather apron, steps forward with a blazing torch, igniting the pyre in a sudden roar.

>l at torch
The executioner carries the torch to light the pyre.

>n
Gallows Room
The public square, wet from morning drizzle, lies under a dark sky. At its center, the gallows loom, ropes swaying. Their eyes fixed on the scene, the crowd stands in silence.

A hooded executioner, cold and focused, adjusts the noose. Pale and bound, the condemned man trembles as his eyes dart around the crowd. Sweat and rain mix on his face as he breathes shallowly.

Vendors shout, children push forward, and an old man whispers prayers. Above, the bell tolls, marking the man's final moments. A raven watches from the gallows beam. The air is heavy as distant thunder rumbles.

Nearby a wooden door leads east to the Crawl Space.

You can also see Mr Whidbey and a gallows platform here.

>score
You've received 170 points out of a possible 200 in 534 moves!

You have received points for the following: 

•  Eating the blueberries:                   5 points
•  Finding the coins and keys:               5 points
•  Buying the Hell Ride ticket:              5 points
•  Taking the Mercury dime:                  5 points
•  Winning the horseshoe magnet:             5 points
•  Winning the Crimson fuse:                 10 points
•  Acquiring the Khaki fuse:                 10 points
•  Finding the insurance policy:             5 points
•  Acquiring the Indigo fuse:                10 points
•  Finding the Cash 'N' Carry invoice:       5 points
•  Finding the Oriental Trading invoice:     5 points
•  Finding the Frank's Market invoice:       5 points
•  Finding the Mystic Industries invoice:    5 points
•  Acquiring the cashier's check stub:       10 points
•  Wearing the sheer veil:                   5 points
•  Taking the lantern:                       5 points
•  Finding the Dark Passage:                 5 points
•  Taking the flashlight:                    5 points
•  Finding the Control Room:                 5 points
•  Turning off the big switch:               5 points
•  Acquiring the Emerald fuse:               10 points
•  Bringing the wrench to the Bumper Cars:   5 points
•  Acquiring the Gray fuse:                  10 points
•  Winning the knock-off Swiss Army knife:   5 points
•  Winning the Magenta fuse:                 5 points
•  Acquiring the Aqua fuse:                  10 points
•  Acquiring the pliers:                     5 points

  Weight   Evidence collected:
  ------   --------------------------------------------------------
•    28    Evidence concerning accidents with the attractions
•     8    Evidence concerning insurance
•     5    Evidence concerning Mr Whidbey
•     3    Evidence concerning past due invoices
  ------   --------------------------------------------------------
•    44    Total Weighted Evidence

You have enough evidence to press charges.

>i
You are carrying:
  a quartz colored fuse
  some pliers
  an aqua colored fuse
  a magenta colored fuse
  a knock-off Swiss Army knife
  a gray colored fuse
  a silver key
  a sledgehammer
  an emerald colored fuse
  a worn photo
  a lit lantern (providing light)
  a sheer veil (being worn)
  a check stub
  an envelope (open but empty)
  a Frank's Market invoice
  an insurance policy
  a gold key
  an indigo colored fuse
  a khaki colored fuse
  some chewed bubblegum
  a crimson colored fuse
  a pair of gloves (being worn)
  a fanny pack (being worn, and open)
    a mallet
    an Oriental Trading invoice
    a Mystic Industries invoice
    a Cash 'N' Carry invoice
    a brass ring
      a brass key (which opens the sturdy door and the metal door)
    a 14" long piece of string (tied to some chewed bubblegum)
    an air freshener
    three quarters
    a nickel
    two dimes
    a wallet
      $15.50 in cash
    a notebook

>l
Gallows Room
The public square, wet from morning drizzle, lies under a dark sky. At its center, the gallows loom, ropes swaying. Their eyes fixed on the scene, the crowd stands in silence.

A hooded executioner, cold and focused, adjusts the noose. Pale and bound, the condemned man trembles as his eyes dart around the crowd. Sweat and rain mix on his face as he breathes shallowly.

Vendors shout, children push forward, and an old man whispers prayers. Above, the bell tolls, marking the man's final moments. A raven watches from the gallows beam. The air is heavy as distant thunder rumbles.

Nearby a wooden door leads east to the Crawl Space.

You can also see Mr Whidbey and a gallows platform here.

>listen
Above, the bell tower tolls, its mournful chime marking the passage of the man's final moments.

Mr Whidbey heads to the Stake Room.

>smell
You smell incense as it permeates through Hell Ride.

>l at square
The public square, slick with morning drizzle, lies under a brooding, overcast sky. At its center looms the gallows, a weathered wooden platform with thick ropes swaying ominously.

>l at gallows
(the gallows platform)
At the center of the square, rising like a grim monument to mortality, stands the gallows - a wooden platform, darkened by age and weather, with thick ropes hanging like vipers poised to strike.

>l at platform
At the center of the square, rising like a grim monument to mortality, stands the gallows - a wooden platform, darkened by age and weather, with thick ropes hanging like vipers poised to strike.

>l at crowd
The crowd stands in somber silence, broken by the shuffle of feet or faint murmurs, their eyes fixed on the grim scene.

>l at executioner
A hooded executioner, cloaked in black, adjusts the frayed noose with practiced precision, his cold presence exuding purpose.

>l at condemned
The condemned man, pale and trembling, has his bound hands behind him.

>l at vendors
Vendors hawk bread and cider, while children strain for a better view.

>l at old man
An old man clutches a rosary, whispering prayers, as others smirk and place bets.

>l at raven
A raven perches on the gallows' beam, its unblinking gaze fixed on the scene below.

>l at noose
The noose has been tied and hangs from the gallows proper.

>n
Stocks Room
The public square is a cobblestone stretch surrounded by weathered buildings. The air smells of smoke, damp earth, and a nearby smithy. At the center, old stocks stand with iron clasps holding captives in shameful positions. Their tattered clothes offer little against the cold wind.

The animatronics are lifelike, enhancing the grim atmosphere. The crowd mocks the prisoners, hurling insults and rotten food. Jeers mix with their laughter. The square hums with noise. Unnoticed by the crowd, the sky darkens as the spectacle continues.

Nearby a wooden door leads east to the Maintenance Office.

You can also see a wooden stocks here.

>l at square
The public square is a cobblestone expanse bordered by weathered timber-framed buildings.

>smell
The air carries the mingling scents of chimney smoke, damp earth, and the faint tang of a nearby smithy.

>listen
As you travel through Hell Ride, you hear ominous music, the murmurs of the crowd, and the occasional scream in the distance.

>l at stocks
(the wooden stocks)
At the square's center stand a row of crude wooden stocks, their heavy beams stained from years of weather and use. Iron clasps hold the unfortunate captives by their wrists and necks, their bodies forced into unnatural, humiliating postures.

>l at beams
At the square's center stand a row of crude wooden stocks, their heavy beams stained from years of weather and use. Iron clasps hold the unfortunate captives by their wrists and necks, their bodies forced into unnatural, humiliating postures.

>l at clasps
Iron clasps lock the prisoners in place.

>l at animatronics
The animatronics and wax figures are extremely life like. Hell Ride sure lives up to its name.

>l at wax figures
The animatronics and wax figures are extremely life like. Hell Ride sure lives up to its name.

>l at the wax figures
The animatronics and wax figures are extremely life like. Hell Ride sure lives up to its name.

>l at vegetables
The rotten fruit and vegetables splatter as each hits its mark, coating the prisoners with rank vegetation.

>e
(first opening the wooden door)
(first unlocking the wooden door)
(with the silver key)

Maintenance Office
Nearby an aqua colored door leads west to the Stocks Room.

Nearby a ladder leads up to Dark Hallway.

You can also see a desk (on which are a coffee mug and a radio) here.

>i
You are carrying:
  a quartz colored fuse
  some pliers
  an aqua colored fuse
  a magenta colored fuse
  a knock-off Swiss Army knife
  a gray colored fuse
  a silver key
  a sledgehammer
  an emerald colored fuse
  a worn photo
  a lit lantern (providing light)
  a sheer veil (being worn)
  a check stub
  an envelope (open but empty)
  a Frank's Market invoice
  an insurance policy
  a gold key
  an indigo colored fuse
  a khaki colored fuse
  some chewed bubblegum
  a crimson colored fuse
  a pair of gloves (being worn)
  a fanny pack (being worn, and open)
    a mallet
    an Oriental Trading invoice
    a Mystic Industries invoice
    a Cash 'N' Carry invoice
    a brass ring
      a brass key (which opens the sturdy door and the metal door)
    a 14" long piece of string (tied to some chewed bubblegum)
    an air freshener
    three quarters
    a nickel
    two dimes
    a wallet
      $15.50 in cash
    a notebook

>s
Crawl Space
Nearby a crimson colored door leads west to the Gallows Room.

>s
Mechanical Room North
Nearby an emerald colored door leads west to the Stake Room.

You can also see a horseshoe magnet, a lit flashlight (providing light), and a toolbox (in which are some channel locks and a hammer) here.

>s
Mechanical Room South
Nearby a gray colored door leads west to the Dungeon.

You can also see a grate (in which is a parking ticket) here.

>s
Generator Room
Nearby an indigo colored door leads west to the Guillotine Room.

>s
Electrical Room

>ne
Electrical Closet One

>open panel
(first unlocking Electrical Panel 1)
(with the knock-off Swiss Army knife)
Using the screwdriver on the knock-off Swiss Army knife, you remove the screws holding the electrical panel shut.

You open Electrical Panel 1.

>l at panel
Electrical Panel 1 is a standard issue 200 amp electrical panel supplying 220 power throughout the ride. The electrical panel is open. Inside the panel you see a switch, a socket, and an indicator light. The screws for the door are gone.

>l at indicator
The indicator is currently indicating nothing.

>put aqua in socket
(the aqua colored fuse in socket 1)
You hear a satisfying snick as the aqua fuse slides into place.

>flip switch
You switch Electrical Panel 1's switch on.

The aqua indicator's light goes on.

[Your score has just gone up by five points.]

>l at indicator
The indicator is glowing aqua and is currently indicating something.

>sw
Electrical Room

>e
Electrical Closet Three
This is Electrical Closet Three. There's an electrical panel here and an exit to the west.

>open panel
(first unlocking Electrical Panel 3)
(with the knock-off Swiss Army knife)
Using the screwdriver on the knock-off Swiss Army knife, you remove the screws holding the electrical panel shut.

You open Electrical Panel 3.

>put crimson in socket
(the crimson colored fuse in socket 3)
You hear a satisfying snick as the crimson fuse slides into place.

>flip switch
You switch Electrical Panel 3's switch on.

The crimson indicator's light goes on.

[Your score has just gone up by five points.]

>w
Electrical Room

>se
Electrical Closet Five
This is Electrical Closet Five. There's an electrical panel here and an exit to the northwest.

>open panel
(first unlocking Electrical Panel 5)
(with the knock-off Swiss Army knife)
Using the screwdriver on the knock-off Swiss Army knife, you remove the screws holding the electrical panel shut.

You open Electrical Panel 5.

>put emerald fuse in socket
You hear a satisfying snick as the emerald fuse slides into place.

>flip switch
You switch Electrical Panel 5's switch on.

The emerald indicator's light goes on.

[Your score has just gone up by five points.]

>nw
Electrical Room

>sw
Electrical Closet Seven
This is Electrical Closet Seven. There's an electrical panel here and an exit to the northeast.

>open panel
(first unlocking Electrical Panel 7)
(with the knock-off Swiss Army knife)
Using the screwdriver on the knock-off Swiss Army knife, you remove the screws holding the electrical panel shut.

You open Electrical Panel 7.

>put gray in socket
(the gray colored fuse in socket 7)
You hear a satisfying snick as the gray fuse slides into place.

>flip switch
You switch Electrical Panel 7's switch on.

The gray indicator's light goes on.

[Your score has just gone up by five points.]

>ne
Electrical Room

>w
Electrical Closet Nine
This is Electrical Closet Nine. There's an electrical panel here and an exit to the east.

>open panel
(first unlocking Electrical Panel 9)
(with the knock-off Swiss Army knife)
Using the screwdriver on the knock-off Swiss Army knife, you remove the screws holding the electrical panel shut.

You open Electrical Panel 9.

>put indigo in socket
(the indigo colored fuse in socket 9)
You hear a satisfying snick as the indigo fuse slides into place.

>flip switch
You switch Electrical Panel 9's switch on.

The indigo indicator's light goes on.

[Your score has just gone up by five points.]

>e
Electrical Room

>nw
Electrical Closet Eleven
This is Electrical Closet Eleven. There's an electrical panel here and an exit to the southeast.

>open panel
(first unlocking Electrical Panel 11)
(with the knock-off Swiss Army knife)
Using the screwdriver on the knock-off Swiss Army knife, you remove the screws holding the electrical panel shut.

You open Electrical Panel 11.

>put khaki in socket
(the khaki colored fuse in socket 11)
You hear a satisfying snick as the khaki fuse slides into place.

>flip switch
You switch Electrical Panel 11's switch on.

The khaki indicator's light goes on.

[Your score has just gone up by five points.]

>se
Electrical Room

>n
Generator Room
Nearby an indigo colored door leads west to the Guillotine Room.

>n
Mechanical Room South
Nearby a gray colored door leads west to the Dungeon.

You can also see a grate (in which is a parking ticket) here.

>n
Mechanical Room North
Nearby an emerald colored door leads west to the Stake Room.

You can also see a horseshoe magnet, a lit flashlight (providing light), and a toolbox (in which are some channel locks and a hammer) here.

>n
Crawl Space
Nearby a crimson colored door leads west to the Gallows Room.

>n
Maintenance Office
Nearby an aqua colored door leads west to the Stocks Room.

Nearby a ladder leads up to Dark Hallway.

You can also see a desk (on which are a coffee mug and a radio) here.

>n
Dark Passage

>s
Maintenance Office
Nearby an aqua colored door leads west to the Stocks Room.

Nearby a ladder leads up to Dark Hallway.

You can also see a desk (on which are a coffee mug and a radio) here.

>w
Stocks Room
Nearby a wooden door leads east to the Maintenance Office.

You can also see a wooden stocks here.

>s
Gallows Room
Nearby a wooden door leads east to the Crawl Space.

You can also see a gallows platform here.

>s
Stake Room
Nearby a wooden door leads east to the Mechanical Room North.

The flames of the pyre burn ever brighter and rise ever higher engulfing the victims.

>gonear whidbey
Guillotine Room
The public square hums with tension under gray skies. A wooden platform stands at the center, a grim focal point.

A lone figure, hands bound and head bowed, stands on the scaffold. Their tattered clothes reveal a once-gilded past.

The crowd jeers while children watch wide-eyed. The town crier proclaims, "High treason against the crown!"

The condemned remains silent as the executioner, robed in black, stands beside the guillotine. The blade gleams in the dim light. The crowd's murmurs die, replaced by silence.

As the condemned approaches, the guillotine's timing falters. Instead of falling on the scaffold, the blade swings over the cars, threatening any unlucky passenger who passes beneath.

There is just one problem: the guillotine is being raised and lowered by some mechanism. It appears that the timing of the guillotine is off and it is being lowered onto the cars instead of between them. If a person were to be in a car as it passed under the guillotine, they would be seriously injured.

You're glad you're not in one of those cars now. You must do something to stop it before someone gets hurt! 

Nearby a wooden door leads east to the Generator Room.

You can also see Mr Whidbey and a guillotine platform here.

>whidbey off
Whidbey stands still.

>ask whidbey about hell ride
Mr Whidbey nervously shifts his weight from one foot to the other.

"Hell Ride is the premier attraction here at Whidbey Amusements. It's both spooky and fun! The visitors love it! The fire last month was unfortunate and expensive" says Mr Whidbey.

Mr. Whidbey's eyes dart up and to the left.

* * *

>ask whidbey about invoices
Mr Whidbey looks at you expectantly.

Mr Whidbey says, "I know this doesn't look good but the cost of consumables go up every week and attendance is down. I have to pinch pennies somehow, don't I? And that fire was very expensive to repair."

You've collected some new evidence.

>ask whidbey about insurance policy
Mr Whidbey nervously shifts his weight from one foot to the other.

"An insurance policy? Of course, all reputable businesses have insurance. Even small time carnivals" Mr Whidbey stammers.

You've collected some new evidence.

>ask whidbey about carnival
Mr Whidbey waits for you to speak.

"The Whidbey family has owned this carnival since the 1957", Mr Whidbey says. "Unfortunately, I am an only child and never married. Alas, the carnival will close when I am gone. But for now, it's making a comeback!"

You've collected some new evidence.

>ask whidbey about ferris wheel
Mr Whidbey looks at you expectantly.

Mr Whidbey says "The Ferris Wheel is my favorite ride. It's always relaxing and romantic."

Mr. Whidbey quickly changes the subject

>ask whidbey about bumper cars
Mr Whidbey nervously shifts his weight from one foot to the other.

"That incident the other week with that Needleman kid was unfortunate" says Mr Whidbey.

You've collected some new evidence.

>ask whidbey about esmeralda
Mr Whidbey looks at you expectantly.

Mr Whidbey says "I see her regularly to have my fortune told. We're lucky to have her here. She's very beautiful. It's a wonder she's never been married."

>ask whidbey about carousel
Mr Whidbey waits for you to speak.

"The carousel is just one of the many rides that thrill and delight our visitors every day," says Mr Whidbey

>ask whidbey about dime toss
Mr Whidbey looks at you expectantly.

"The Dime Toss is is one of the many games that thrill and delight our visitors every day!" says Mr Whidbey.

Mr. Whidbey meets your eyes and quickly looks away.

>ask whidbey about pitchers mound
Mr Whidbey nervously shifts his weight from one foot to the other.

"The Pitchers Mound is is one of the many games that thrill and delight our visitors every day!" says Mr Whidbey.

>ask whidbey about high striker
Mr Whidbey waits for you to speak.

"The High Striker is is one of the many games that thrill and delight our visitors every day!" says Mr Whidbey.

>ask whidbey about fuses
Mr Whidbey nervously shifts his weight from one foot to the other.

"I know nothing about fuses", Mr Whidbey says.

>ask whidbey about indigo fuse
Mr Whidbey waits for you to speak.

"Where did you get that?" Mr Whidbey asks.

Mr. Whidbey's eyes dart up and to the left.

You've collected some new evidence.

>ask whidbey about fire
Mr Whidbey nervously shifts his weight from one foot to the other.

The fire was most unfortunate. It put Hell Ride out of commission for two weeks. Not only did it cost me $22,500 to repair but I lost revenue while it was closed.

You've collected some new evidence.

>ask whidbey about accidents
Mr Whidbey looks at you expectantly.

Mr Whidbey says, "Oh, that's nothing to worry about. Little things happen all the time, right?"

You've collected some new evidence.

>ask whidbey about pliers
Mr Whidbey waits for you to speak.

"Oh! I thought I lost... um, those belong to the janitor. Where did you find them?" asks Mr Whidbey.

You've collected some new evidence.

>ask whidbey about needleman
Mr Whidbey looks at you expectantly.

Mr Whidbey says "Uh, Fred is a special... contractor... We paid him. For services rendered."

Mr. Whidbey quickly changes the subject
You've collected some new evidence.

>ask whidbey about services rendered
Mr Whidbey nervously shifts his weight from one foot to the other.

"Fred did some work over at the bumper cars" says Mr Whidbey.

You've collected some new evidence.

>accuse whidbey of fraud
Mr Whidbey looks at you expectantly.

"Any evidence you have is circumstantial. It'll be thrown out on day one of the trial!", says Mr Whidbey

>show cash 'n' carry
(to Mr Whidbey)
(first taking the Cash 'N' Carry invoice)
Mr Whidbey says, "Money's a little tight. The cost of consumables go up every week."

You've collected some new evidence.

>show Frank's market
(to Mr Whidbey)
Mr Whidbey says, "I can't keep up with the cost of ingredients. Everything costs so much!"

You've collected some new evidence.

>show mystic industries to whidbey
(first taking the Mystic Industries invoice)
Mr Whidbey says, "That fire in Hell Ride was very expensive to repair. And it put the ride out of commission for two weeks."

Mr. Whidbey's eyes dart up and to the left.

You've collected some new evidence.

>accuse whidbey of fraud
Mr Whidbey waits for you to speak.

As much as you would like to confront Mr Whidbey about fraud you should probably take care of disabling Hell Ride first.

>show insurance policy to whidbey
"An insurance policy? Of course, all reputable business have insurance. Even small time carnivals", Mr Whidbey stammers.

You've collected some new evidence.

>show pliers to whidbey
"Oh! I thought I lost... I mean those belong to the janitor. Where did you find them?" asks Mr Whidbey.

You've collected some new evidence.

>show check stub to whidbey
Mr Whidbey says "Uh, Fred is a special... contractor... We paid him. For services rendered."

You've collected some new evidence.

>e
(first opening the wooden door)
(first unlocking the wooden door)
(with the silver key)

Generator Room
Nearby an indigo colored door leads west to the Guillotine Room.

>n
Mechanical Room South
Nearby a gray colored door leads west to the Dungeon.

You can also see a grate (in which is a parking ticket) here.

* * *

>n
Maintenance Office
Nearby an aqua colored door leads west to the Stocks Room.

Nearby a ladder leads up to Dark Hallway.

You can also see a desk (on which are a coffee mug and a radio) here.

>u
Dark Hallway
Nearby a ladder leads down to the Maintenance Office.

Nearby a metal door leads west to Control Room.

>w
Control Room
Nearby a metal door leads east to Dark Hallway.

You can also see a big switch here.

>turn aqua dial to 1
The aqua colored dial is now set to 1.

>turn crimson dial to 3
The crimson colored dial is now set to 3.

>turn emerald dial to 5
The emerald colored dial is now set to 5.

>set gray dial to 7
The gray colored dial is now set to 7.

>spin indigo dial to 9
The indigo colored dial is now set to 9.

>set khaki dial to 11
The khaki colored dial is now set to 11.

>push aqua button
You switch the aqua button on.

The monitor flickers for a second and the scene it displays changes to something different.
The monitor now shows a tableau of poor unfortunate townsfolk locked in stocks.
The aqua light is now on.

>push aqua button
You switch the aqua button off.

The monitor turns off and the screen goes black.
The monitor now shows nothing but snow.
The aqua light is now off.

>push crimson button
You switch the crimson button on.

The monitor flickers for a second and the scene it displays changes to something different.
The monitor now shows a scene of someone waiting to be hanged.
The crimson light is now on.

>push emerald button
You switch the emerald button on.

The monitor flickers for a second and the scene it displays changes to something different.
The monitor now displays a scene of three women being burned at the stake.
The emerald light is now on.

>push gray button
You switch the gray button on.

The monitor flickers for a second and the scene it displays changes to something different.
The monitor now shows the implements of torture in the dungeon.
The gray light is now on.

>push khaki button
You switch the khaki button on.

The monitor flickers for a second and the scene it displays changes to something different.
The monitor shows the gift shop located at the Hell Ride exit.
The khaki light is now on.

>push indigo button
You switch the indigo button on.

The monitor flickers for a second and the scene it displays changes to something different.
The monitor now shows a tableau of a guillotine rising and falling over the ride exit.
The indigo light is now on.

As you push the indigo button, the monitor switches to a view of the guillotine room. You still see the blade rising and falling over the cars. Suddenly, the blade starts slowing down, taking longer and longer to fall. Until it finally comes to a complete rest.

The room is heavy with uneasy silence. Hell Ride, once a thrilling spectacle, now looms motionless, as the guillotine blade is frozen halfway down its track. Moments ago, chaos erupted as the malfunctioning mechanism sent the blade crashing unpredictably, ripping through the roofs of cars on the track.

A single car, its roof gashed open, sits under the still blade - a grim reminder of the disaster narrowly averted. Above, a black crow lands on the guillotine's frame, its sharp caw cutting through the murmurs of anger and fear.

Two mechanics climb the scaffolding with tools in hand, their appearance met with wary hope. A crowd has gathered and is watching, holding their breath, as the cursed ride's fate hangs in the balance. After a moment, applause rises from the assembled crowd, cheering your accomplishment.

Mr. Whidbey, the Mayor, the Chief of Police, and the janitor arrive on the scene and extend their gratitude for saving the day, not to mention lives!

"But wait", you say, "There is more afoot here than meets the eye. I think we need to talk to Mr Whidbey some more... confront him about a few things. Accusations might be made."

Mr Whidbey exclaims, "Accusations? What accusations?"

The Police Chief listens with interest to what you have to say.

>show evidence
Weight   Evidence collected:
  ------   --------------------------------------------------------
•    50    Evidence concerning accidents with the attractions
•    23    Evidence concerning insurance
•    12    Evidence concerning past due invoices
•     6    Evidence concerning Mr Whidbey
•     5    Evidence concerning fuses
  ------   --------------------------------------------------------
•    96    Total Weighted Evidence

You've got enough evidence for a conviction.

>ask janitor about hell ride
The janitor looks at you and waits for you to proceed.

"Hell Ride is a finicky ride. I'm fixing something there every week. Last week, Mr. Whidbey asked me to skip Hell Ride's maintenance slot. There was a real fire in the Stakes Room last month. And just yesterday I caught him creeping around the guillotine room" says the janitor.

>ask janitor about mystic
The janitor looks bored as he waits for you to speak.

"Sorry, I haven't the faintest," the janitor replies.

>show mystic invoice to janitor
The janitor says, That fire in Hell Ride was really bad. It took almost two weeks to get it fully repaired. But it shouldn't have cost this much. I think Mr Whidbey got ripped off. Or, he got it fixed on the cheap and pocketed the rest."

>ask janitor about bumper cars
The janitor looks at you and waits for you to proceed.

The janitor says, "That reminds me. Not long ago, one of the bumper cars was shorting out and electrifying the car. A visitor got hurt. A young lad, what was his name? Fred something, I think."

>show evidence
Weight   Evidence collected:
  ------   --------------------------------------------------------
•    50    Evidence concerning accidents with the attractions
•    23    Evidence concerning insurance
•    12    Evidence concerning past due invoices
•     6    Evidence concerning Mr Whidbey
•     5    Evidence concerning fuses
  ------   --------------------------------------------------------
•    96    Total Weighted Evidence

You've got enough evidence for a conviction.

* * *

>brief
Hell Ride is now in its "brief" printing mode, which gives long descriptions of places never before visited and short descriptions otherwise.

>images on
Images on. Game images will be displayed.

>get berries
Taken.

>eat blueberries
The blueberries were delicious. A true taste of summer!

[Your score has just gone up by five points.]

>look under seat
You find the three quarters, the nickel, the five dimes, and your keys!

[Your score has just gone up by five points.]

>get dimes, keys
dime: Taken.
dime: Taken.
dime: Taken.
dime: Taken.
dime: Taken.
your keys: Taken.

>open glove box
(first unlocking the glove box)
(with your keys)
You open the glove box, revealing a 14" long piece of string and a pair of gloves.

>get all from glove compartment
14" long piece of string: Taken.
pair of gloves: Taken.

>wear gloves
You put on the pair of gloves.

>give coupon to attendant
(first taking the coupon)
Done. The price of a parking ticket is now $3.00.

>buy ticket
The attendant mumbles something about the stub.

You fork over $3.00 for the parking ticket, leaving yourself with $32.00.

>put stub on dashboard
You put the parking stub on the dashboard.

>south
Ticket Booth
Painted in bright red and yellow stripes, the ticket kiosk stands at the entrance with flickering lights to draw attention. A smiling cashier hands out tickets, while the cash drawer jingles. A digital payment system sits in the corner. Too bad you don't have a debit card.

To the right, a signboard displays ticket prices alongside illustrations of the rides. Pennant flags flutter and the air is filled with the scent of popcorn, pretzels, and grease.

The ground is worn from the steps of carnival goers eagerly waiting in line as they approach the midway.

The midway continues in all directions from here. There is a cashier here. A price list for attraction tickets is on the signboard. The cashier has Hell Ride ticket, Fortune Teller ticket, Ferris Wheel ticket, Bumper Cars ticket, and Carousel ticket.

You can see a cashier here.

>buy tickets
Hell Ride ticket: You fork over $4.00 for the Hell Ride ticket, leaving yourself with $28.00.
Fortune Teller ticket: You fork over $3.00 for the Fortune Teller ticket, leaving yourself with $25.00.
Ferris Wheel ticket: You fork over $2.00 for the Ferris Wheel ticket, leaving yourself with $23.00.
Bumper Cars ticket: You fork over $2.00 for the Bumper Cars ticket, leaving yourself with $21.00.
Carousel ticket: You fork over $1.00 for the Carousel ticket, leaving yourself with $20.00.

[Your score has just gone up by five points.]

>east
High Striker
A tall machine stands with bright red, yellow, and blue lights. A sign sits at the top reading "Test Your Strength!" The base is dark, polished wood, with a sturdy metal pole and a bell at the top. Markings along the pole indicate strength. A smaller sign says, "Buy a mallet, strike the bell, win a prize." Spectators cheer as the sound of the mallet hitting the target fills the night.

The Ticket Kiosk is to the west. Other games are northeast and southeast of here. The Ferris Wheel lies to the east.

You can see a High Striker attendant, a bullseye, and some High Striker prizes here.

The attendant is holding a mallet.

>look at prizes
The prizes are a teddy bear, a knock-off Swiss Army knife, a magenta colored fuse, and a poster of Taylor Swift.

>buy mallet
You fork over $2.00 for the mallet, leaving yourself with $18.00.

>hit bullseye with mallet
You lift the mallet high and bring it down on the bullseye with all your might! The striker rises towards the bell stopping at "Weakling".

>again
You lift the mallet high and bring it down on the bullseye with all your might! The striker rises towards the bell stopping at "Getting Stronger".

>again
You lift the mallet high and bring it down on the bullseye with all your might! The striker rises towards the bell stopping at "Getting Stronger".

>again
You lift the mallet high and bring it down on the bullseye with all your might! The striker rises towards the bell stopping at "Average".
 
You can't be sure of it but it seems as if the mallet isn't heavy enough to ring the bell.

>southeast
Pitchers Mound
The milk bottle toss is a classic game of skill and luck. A pyramid of colorful bottles sits on a sturdy platform - three on the bottom, two in the middle, and one at the top. Players throw baseballs to knock down the stack and win a prize. The booth is lively, with cheering and the clatter of falling bottles. The attendant calls, "Step right up! Three balls for a dime!" Prizes from toys to stuffed animals hang nearby. With this carnival favorite, every toss is filled with suspense.  You thought you caught a flash of something coming from the area of the booth.

You're surprised to see that this game only costs a dime. The High Striker is to the northwest.

The milk bottles are stacked in three neat rows: three bottles on the bottom, two in the middle, and one on top.

         1         
       2   3     
     4   5   6     

You can also see a Pitchers Mound attendant and some Pitchers Mound prizes here.

>look under booth
You find the Mercury dime!

>get mercury dime
Taken.

[Your score has just gone up by five points.]

>northwest
High Striker
You can see a High Striker attendant, a bullseye, and some High Striker prizes here.

>northeast
Dime Toss Game
The booth is brightly colored with red-and-white stripes, twinkling lights, and a sign reading "TOSS A DIME - WIN A PRIZE!" Prizes hang around the booth, from stuffed animals to shiny trinkets. Gleaming plates reflect the light, waiting for dimes. The "ping" of dimes hitting plates is followed by the satisfying "plop" when they land. Shouts of victory and playful groans mix with carnival music and laughter. The operator calls out, drawing in onlookers.

You're surprised to see that this game only costs a dime. The exit is to the southwest.

You can see a Dime Toss attendant, some Dime Toss prizes, and a plate here.

>flip mercury dime on plate
You toss the dime. The heavier Mercury dime hits the plate, starts to spins, and lands in the center of the plate. The attendant shouts out, "Winner! Winner!"

Which prize would you like? 1) a stuffed monkey, 2) an orange colored fuse, 3) a poster of Billie Eilish, 4) a horseshoe magnet?

>4
You are now holding a horseshoe magnet.

[Your score has just gone up by five points.]

>southwest
High Striker
You can see a High Striker attendant, a bullseye, and some High Striker prizes here.

>southeast
Pitchers Mound
The milk bottles are stacked in three neat rows: three bottles on the bottom, two in the middle, and one on top.

         1         
       2   3     
     4   5   6     

You can also see a Pitchers Mound attendant and some Pitchers Mound prizes here.

>give dime to attendant
The attendant gives you three baseballs in return.

>throw baseball at bottle 5
You wind up and throw the baseball at the milk bottles. The ball hits the bottles in the sweet spot and they topple over onto the platform. The attendant shouts out, "Winner! Winner!"

Which prize would you like? 1) a crimson colored fuse, 2) a plush donkey, 3) a goldfish in a bowl, 4) a poster of Lourde?

* * *

>1
You are now holding a crimson colored fuse.

[Your score has just gone up by ten points.]

>give dime
(to the Pitchers Mound attendant)
The Pitchers Mound attendant says, "Sorry. You only get to play once."

>northwest
High Striker
You can see a High Striker attendant, a bullseye, and some High Striker prizes here.

>east
Ferris Wheel
The Ferris wheel dominates the carnival, its bright lights visible from every corner. Its massive steel frame arches high, with colorful gondolas swaying as it turns. At night, flashing in bursts of red, green, and white, the wheel dazzles with lights. The air buzzes with the hum of the motor. The operator calls, "Step right up! The best view of the carnival awaits!" From the top, riders get a panoramic view of the fairgrounds, with city lights stretching to the horizon.

Hey! Is that a two dollar bill on the ground?

You can also see a Ferris Wheel attendant here.

>give ticket to attendant
(the Ferris Wheel ticket to the Ferris Wheel attendant)
You give the Ferris Wheel ticket to the Ferris Wheel attendant.

As you enter the gondola, the safety bar clicks into place, and the Ferris wheel begins its ascent. The sounds of the carnival fade, replaced by the hum of machinery and a soft breeze. At the peak, the carnival sprawls below, its lights twinkling against the twilight sky. The world falls quiet up here. The gondola sways gently, adding excitement to the serene view. From the top you can see something to the west of the concession stand. As you descend, the sounds of the carnival return, bringing you back to the fun.

>west
High Striker
You can see a High Striker attendant, a bullseye, and some High Striker prizes here.

>west
Ticket Booth
You can see a janitor and a cashier here.

>southwest
Concession Stand
The concession stand is a destination for many along the midway. Twinkling lights frame the stand making it glow amid the carnival's buzz.

Behind the counter, popcorn churns in the machine, candy apples gleam, and cotton candy spins in clouds. Warm pretzels sit under a heat lamp, while sodas chill in a frosted cooler. The counter is cluttered with bags, napkins, and sprinkle cups. Kids tug at parents, teens share pretzels, and the crowd buzzes with energy.

There is a menu to the right of the window. You can see the treats inside the stand. There are exits to the south, west, and northeast.

Nearby a sturdy door leads south.

You can also see a concession attendant and a menu here.

>buy bubblegum
You fork over $1.00 for the Bubblegum, leaving yourself with $17.00.

>west
Behind the Concession Stand
Behind the concession stand, to one side, is the trash generated from the day's activities and to the other side boxes of supplies. There is a chair here surrounded by cigarette butts. There is an exit to the east.

You can see a trash can (closed) and some concession boxes here.

>open trash can
You open the trash can, revealing a khaki colored fuse.

>get khaki fuse
Taken.

[Your score has just gone up by ten points.]

>east
Concession Stand
Nearby a sturdy door leads south.

You can also see a concession attendant and a menu here.

>northeast
Ticket Booth
You can see a cashier here.

>south
Head of the Line
You are standing in front of an attendant with his hand open waiting for your ticket. The entrance to the ride is south of here. The ride operator tells you that you're lucky you showed up when you did because this will be the last trip through Hell Ride for the night. You notice that all the other cars are empty. The Ticket Kiosk is north of here.

You can see a Hell Ride attendant here.

>give ticket to attendant
(the Hell Ride ticket to the Hell Ride attendant)
You give the Hell Ride ticket to the Hell Ride attendant.

>south
Ride Entrance
The cars for Hell Ride stop here, and the safety bar clicks into place as riders board the cars. Ahead, the grotesque entrance looms - a twisted metal archway adorned with spikes, skulls, and flickering blood-red lights. A faint sulfuric smell mixes with the scent of popcorn.

The "HELL RIDE" sign pulses above the door, while demon statues with clawed hands seem to beckon. The entrance is shrouded in darkness, broken only by eerie green flashes that reveal twisted paths. Faint whispers and distant organ music grow louder. To one side, the darkness looks a little bit darker than the rest of the room.

You can see a Hell Ride car (empty) here.

>east
Dark Passage
This room is backstage at the Hell Ride attraction. The room is littered with bags of trash, piles of junk, and dust bunnies so large they should be paying rent. There an exit to the south and west.

[Your score has just gone up by five points.]

>look at junk
This is a pile of assorted flotsam and jetsam from the carnival. None of it looks very interesting.

In the pile of junk is a flashlight.

>get flashlight
Taken.

[Your score has just gone up by five points.]

* * *

>turn it on
You flip a switch. A strong, narrow beam of light shines from the lit flashlight.

>south
Maintenance Office
The maintenance office is a dim, cluttered space, filled with the smells of grease, sweat, and popcorn. Disorganized shelves are lined with tools and parts, while paint cans and grease jars clutter the workbenches. A battered desk holds wires, gears, and springs, with a bent piece of metal in a vise.

A flickering fluorescent light barely brightens the room. In one corner, a disassembled ride mechanism hangs with chains and pulleys. A greasy manual and a half-empty coffee mug sit on a nearby stool.

Faded safety posters and a worn photo of the carnival decorate the walls, along with a corkboard full of schedules and notes, and a worn photo of the carnival in its prime. The floor is gritty with dust and scattered nails. Despite the mess, the room buzzes with purpose and keeps the carnival running, fueled by sweat and ingenuity.

Exits lead north and south.

Nearby a ladder leads up.

Nearby an aqua colored door leads west.

You can also see a worn photo and a desk (on which are a coffee mug and a radio) here.

>open drawer
You open the drawer, revealing some scissors, a stapler, a ballpoint pen, a pad of paper, and a silver key.

>get silver key
Taken.

>south
Crawl Space
The crawl space beneath the ride is cramped and dark, filled with the hum of machinery above. The air is thick with oil and rust. Sounds echo - groaning steel, clanking chains, and the rhythmic thrum of motors.

The ground is uneven, a mix of dirt, gravel, and scattered tools. Pipes overhead are wrapped in fraying insulation, crackling as you move. Small puddles of murky water collect.

The backstage area continues north and south.

Nearby a crimson colored door leads west.

>south
Mechanical Room North
The north mechanical room is compact, housing auxiliary systems for the ride. A soft hum of capacitors and relays fills the space, interrupted only by the occasional hissing of hydraulic fluid.

Circuit breaker panels line the walls, labeled for different functions. Cables and conduits connect the systems to the main hub. Flickering with gauges, a hydraulic pump in the corner manages lifting arms and platforms.

A small workbench is cluttered with parts, while shelves above hold spare parts like cables and hydraulic tubing. A faded ride diagram with red annotations is pinned nearby. The room feels cool and damp.

There are exists north and south.

Nearby an emerald colored door leads west.

You can also see a toolbox (closed) and a sledgehammer here.

>open toolbox
You open the toolbox, revealing an adjustable wrench, some channel locks, and a hammer.

>get wrench
Taken.

>get sledgehammer
Taken.

>south
Mechanical Room South
The south mechanical room is the heart of the ride, with a massive motor powering the thick belts, pulleys, and gears. Electrical panels line the walls, flashing "High Voltage" and colorful indicator lights.

Conduits and wires snake across the ceiling, connecting systems. A cluttered table holds tools, spare parts, and maintenance logs stained with grease. The air smells of oil, metal, and ozone.

A cooling fan struggles to cut the warmth as the hum of machinery mixes with the hiss of hydraulics and clinking chains. The floor is a patchwork of metal grates and worn concrete. The room is busy; every movement is precise and controlled.

You can travel north and south from here.

Nearby a gray colored door leads west.

You can also see a grate (in which is an emerald colored fuse) here.

>chew gum
You chew the bubblegum, blowing a few bubbles as you do so.

>tie string to gum
You tie the 14" long piece of string to the chewed bubblegum.

>lower gum into grate
You drop the chewed bubblegum into the grate. The emerald colored fuse attaches to the chewed bubblegum. You quickly and carefully raise the chewed bubblegum and drop emerald colored fuse into your hand.

[Your score has just gone up by ten points.]

>south
Generator Room
The generator room is small, with concrete walls stained by oil and grime. The air smells of diesel, metal, and damp earth.

The main generator hums, connected by thick cables to circuit breakers and a cluttered panel with switches and gauges. A flickering display shows power levels. The cracked floor is littered with puddles. Shelves hold spare parts and manuals, and a workbench sits next to a grease canister.

The room is the carnival's power source, hidden but essential.

The backstage area continues north and south of here.

Nearby an indigo colored door leads west.

>west
(first opening the indigo colored door)
(first unlocking the indigo colored door)
(with the silver key)

As you enter the room, you can see Mr Whidbey across the way. He seems to be doing something around the guillotine platform. You walk closer to see what he is doing and startle him. Mr Whidbey spins around and glares at you. As he turns and walks out of the room, you think you saw him drop something.

Guillotine Room
The public square hums with tension under gray skies. A wooden platform stands at the center, a grim focal point.

A lone figure, hands bound and head bowed, stands on the scaffold. Their tattered clothes reveal a once-gilded past.

The crowd jeers while children watch wide-eyed. The town crier proclaims, "High treason against the crown!"

The condemned remains silent as the executioner, robed in black, stands beside the guillotine. The blade gleams in the dim light. The crowd's murmurs die, replaced by silence.

As the condemned approaches, the guillotine's timing falters. Instead of falling on the scaffold, the blade swings over the cars, threatening any unlucky passenger who passes beneath.

There is just one problem: the guillotine is being raised and lowered by some mechanism. It appears that the timing of the guillotine is off and it is being lowered onto the cars instead of between them. If a person were to be in a car as it passed under the guillotine, they would be seriously injured.

You're glad you're not in one of those cars now. You must do something to stop it before someone gets hurt! 

Nearby a wooden door leads east to the Generator Room.

You can also see a guillotine platform here.

>look at platform
At the center of the square stands a raised wooden platform, stark and imposing, where the grim sentence is to be carried out. You can just make out something underneath the platform in the dark.

>look under platform
You find the pliers!

>get pliers
(putting the notebook into the fanny pack to make room)
You're carrying too many things already.

Mr Whidbey arrives from the Dungeon.

>show pliers to whidbey
(first taking the pliers)
(putting the wallet into the fanny pack to make room)
"Oh! I thought I lost... I mean those belong to the janitor. Where did you find them?" asks Mr Whidbey.

Mr. Whidbey's eyes dart up and to the left.

You've collected some new evidence.

You've discovered some evidence. To see a list and weighting of the evidence you've collected, type "SHOW EVIDENCE". To collect more evidence, try to ASK someone ABOUT something. Or SHOW something TO someone.

[Your score has just gone up by five points.]

>north
Dungeon
The dungeon is dark and damp, the air thick with sweat, blood, and mildew. Lanterns flicker on rusted sconces, casting twisted shadows.

Chains rattle, mixed with distant moans and screams. Water drips from a cracked ceiling, pooling on the blood-dark floor.

Instruments of torture clutter the room: a broken rack, a brazier with bloodstained tools, and a spiked chair. Prisoners endure all these things, bound or writhing in agony.

The torturer moves with cold precision, ignoring the suffering. Above, rats scurry in the shadows, and the heavy, oppressive air thickens with despair.

Nearby a wooden door leads east to the Mechanical Room South.

You can also see an iron chair, a splintered rack, and a glowing brazier here.

>north
Stake Room
The public square is silent, broken only by crackling flames. At its center, three women are bound to wooden stakes, their faces showing defiance, resignation, and terror.

A crowd watches, some jeering, others praying or looking away. Torch in hand, the executioner steps forward igniting the pyre. Flames roar as the women cry out, their voices lost in the heat.

Gray clouds loom above as a raven caws. Church bells toll, marking the tragedy. Some onlookers stay, others quietly leave.

Nearby a wooden door leads east to the Mechanical Room North.

The flames of the pyre burn ever brighter and rise ever higher engulfing the victims.

>look in pyre
In the pyre is a quartz colored fuse.

>get fuse
(the quartz colored fuse)
(putting the dime into the fanny pack to make room)
Taken.

>north
Gallows Room
The public square, wet from morning drizzle, lies under a dark sky. At its center, the gallows loom, ropes swaying. Their eyes fixed on the scene, the crowd stands in silence.

A hooded executioner, cold and focused, adjusts the noose. Pale and bound, the condemned man trembles as his eyes dart around the crowd. Sweat and rain mix on his face as he breathes shallowly.

Vendors shout, children push forward, and an old man whispers prayers. Above, the bell tolls, marking the man's final moments. A raven watches from the gallows beam. The air is heavy as distant thunder rumbles.

Nearby a wooden door leads east to the Crawl Space.

You can also see a gallows platform here.

>north
Stocks Room
The public square is a cobblestone stretch surrounded by weathered buildings. The air smells of smoke, damp earth, and a nearby smithy. At the center, old stocks stand with iron clasps holding captives in shameful positions. Their tattered clothes offer little against the cold wind.

The animatronics are lifelike, enhancing the grim atmosphere. The crowd mocks the prisoners, hurling insults and rotten food. Jeers mix with their laughter. The square hums with noise. Unnoticed by the crowd, the sky darkens as the spectacle continues.

Nearby a wooden door leads east to the Maintenance Office.

You can also see a wooden stocks here.

>east
(first opening the wooden door)
(first unlocking the wooden door)
(with the silver key)

Maintenance Office
Nearby an aqua colored door leads west to the Stocks Room.

Nearby a ladder leads up.

You can also see a worn photo and a desk (on which are a coffee mug and a radio) here.

>north
Dark Passage

>west
Ride Entrance
You can see a Hell Ride car (empty) here.

>north
Head of the Line
You can see a Hell Ride attendant here.

>north
Ticket Booth
You can see a janitor and a cashier here.

The janitor heads to the Bumper Cars.

>northwest
Bumper Cars
The bumper cars are a lively scene of flashing lights and vibrant decorations. The arena is surrounded by padded barriers, ensuring the rider's safety. Cars in faded reds, blues, yellows, and greens glide across the slick floor, each equipped with a steering wheel and padded bumper. Riders maneuver their cars with intensity, creating a din of bumps and laughter. Overhead, electric poles hum with energy. While onlookers cheer from the sidelines, the bumper cars offer playful competition and nostalgic fun for all. The Ticket Kiosk is southeast of here.

You can see a janitor and a Bumper Cars attendant here.

>look at janitor
The janitor looks at you expectantly.

The janitor is a portly gentleman wearing dirty overalls, leaning on a broom. The janitor is wearing a brass ring with a key on it. He complains that he's missing his flashlight. He also mentions that his pliers are missing.

>give flashlight to janitor
"Hey! Thanks. I really appreciate it. I've been lost without my flashlight," says the janitor.

>give pliers to janitor
The janitor says, "Thanks for returning my pliers and flashlight. Here, take this key."
Taken.

>give wrench to the attendant
Hey! Thanks, I really appreciate it. Usually no one ever responds to the radio in the Control Room. Here, take this fuse.

Taken.

The janitor heads to the Ticket Booth.

[Your score has just gone up by five points.]

[Your score has just gone up by ten points.]

>southeast
Ticket Booth
You can see a janitor, Mr Whidbey, and a cashier here.

>east
High Striker
You can see a High Striker attendant, a bullseye, and some High Striker prizes here.

Over the loudspeaker, an announcement blares: Attention please. There is a vehicle being towed from the parking lot for parking illegally. The license plate of the car is "862901". You breathe a sigh of relief as you realize that's not your license plate. I guess it's a good thing you remembered to place the parking stub on the dashboard.

>hit bullseye with sledgehammer
As you swing, you feel the extra weight from the sledgehammer. As it comes down on the bullseye, you can't help but feel like the extra weight gives you an edge. The bell rings as the striker reaches the top of the pole. The attendant says, "You're a Muscle Man. Here's a prize for you."

Which prize would you like? 1) a teddy bear, 2) a knock-off Swiss Army knife, 3) a magenta colored fuse, 4) a poster of Taylor Swift?

* * *

>2
You are now holding a knock-off Swiss Army knife.

[Your score has just gone up by five points.]

>hit bullseye with sledge
As you swing, you feel the extra weight from the sledgehammer. As it comes down on the bullseye, you can't help but feel like the extra weight gives you an edge. The bell rings as the striker reaches the top of the pole. The attendant says, "You're a Muscle Man. Here's a prize for you."

Which prize would you like? 1) a teddy bear, 3) a magenta colored fuse, 4) a poster of Taylor Swift?

>3
You are now holding a magenta colored fuse.
(putting the dime into the fanny pack to make room)

[Your score has just gone up by five points.]

>hit bullseye with sledge
The High Striker attendant takes the sledgehammer away from you exclaiming, "Hey! What are you doing? I'm not going to let you cheat again!"

>west
Ticket Booth
You can see a cashier here.

>west
In front of the tent, the barker gestures excitedly, calling out:

Ladies and gentlemen, boys and girls, gather 'round! 
Step right up and witness the spectacle that's taken the world by storm! 
She walks, she talks, she crawls on her belly like a reptile. 
Behold the one, the only Little Egypt, performing her legendary Dance of the Pyramids - a dazzling display of mystery, grace, and allure! 
For just a dime, a mere one tenth of a dollar, prepare to be transported to the sands of Cairo, where enchantment and wonder await!

Show Facade
As you walk west through the midway, the lights fade to a soft glow, leading you to a tent. A sign reads "Little Egypt Show - A Journey Into the Mysterious and Unknown!" The barker, wearing a fez and smiling, points to another sign: "Little Egypt - Dime Admission." The ticket kiosk is behind you to the east.

There is a stage in front of the tent. The Barker is encouraging you to step up and enjoy.

You can see a Barker here.

>give dime to barker
You hand over a dime, and the barker nods, waving you through. As you step up to the entrance, the air feels thicker and the sounds of the carnival fade away. You've entered an entirely different world now. Before you, there is a tent. Intrigued, you take your first step towards the Little Egypt Show. You can now head west into the show.

>ask barker about hell ride
"Hell Ride is our most popular attraction but there always seems to be something wrong with it," says the Barker.

You've collected some new evidence.

>ask barker about accidents
The Barker says "Things sure seem vulnerable at this time."

You've collected some new evidence.

>west
Show Tent
You are inside the Little Egypt Show. The attraction's facade is to the east. There are folding chairs standing vigil in neat in rows. The show should start soon.

>get lantern
Taken.

[Your score has just gone up by five points.]

* * *

>turn it on
You flip a switch. A strong, narrow beam of light shines from the lit lantern.

>wait
Time passes.

>wait
Time passes.

The tent is dimly lit, the stage is a fully decorated representation of some Middle Eastern palace, featuring rich, colorful fabrics, brass ornaments, and lanterns casting a warm, flickering glow. Heady incense wafts through the air, softening everything around the edges. Enhancing the mystique, the backdrop displays painted scenes of pyramids, desert landscapes, and domed structures. The colorful onion topped buildings and jewel tones set to the sepia colored landscape have you transported far away.

>wait
Time passes.

Little Egypt emerges, draped in flowing silken veils. Skillfully she twirls using them as part of the dance. A sparkling, sequined bodice opens into a gauze skirt, adorned with jingling coin belts and jewelry that accentuate her dance.

>wait
Time passes.

The performance begins with slow, undulating movements, drawing you into the rhythm of the music. Traditional instruments like the oud, darbuka, or zurna are an accompanying chorus. As the tempo builds, her hips, torso, and hands twist in an intricate and mesmerizing pattern. Little Egypt demonstrates remarkable control and fluidity. She dramatically spins, drops, and shimmies, often punctuating the beat with a quick jingle of her coin belt.

>wait
Time passes.

Little Egypt makes eye contact with you and smiles enigmatically. In her performance she balances a fine silver sword on her head and accents her dance with tinkling finger cymbals.

>wait
Time passes.

The music oscillates between hauntingly slow melodies and rapid, energetic drum beats, a roller coaster of emotion that leaves you entranced. Little Egypt relies on the music's dynamic changes to tell a story with movements reflecting joy, sorrow, seduction, and celebration.

>wait
Time passes.

The performance concludes with a dramatic flourish, an energetic shimmy, a bold spin, and Little Egypt casts off her veils. The dancer takes a bow to thunderous applause, leaving you spellbound by the sensual display.

You applaud until your hands are sore. Did she just wink at you?

As she leaves the stage, Little Egypt tosses one of her veils to you!

>wear veil
You wrap the veil around your head, shrouding your eyes. The world is a lovely color pink as you look through the veil while her perfume fills your nostrils in the most delightful way. You look pretty!

[Your score has just gone up by five points.]

>east
Show Facade
You can see a Barker here.

>east
Ticket Booth
You can see a cashier here.

>southwest
Concession Stand
Nearby a sturdy door leads south.

You can also see a concession attendant and a menu here.

>south
(first opening the sturdy door)
(first unlocking the sturdy door)
(with the brass key)

Carnival Office
Dim, yellow light from an overhead bulb casts long shadows over the room, A single desk lamp, flickering provides additional light. A few carnival-themed knick-knacks sit atop the desk. A framed photograph hangs askew on the wall.

The desk is covered in stacks of paperwork, old receipts, invoices, and faded carnival brochures. A locked cabinet is tucked away against one wall. Next to it, there's a small, heavy safe.

Nearby a sturdy door leads north to the Concession Stand.

On the messy desk are a mini Ferris wheel and a mini carousel.

You can also see a safe (closed), a filing cabinet (closed), and a framed photograph here.

As you enter the room, you see Mr Whidbey with his back to the door. He's talking on the telephone.

"Hello? Oh, it's you." says Mr. Whidbey.

>wait
Time passes.

Mr. Whidbey listens to the other end of the conversation.

>wait
Time passes.

"I know, I know, but what am I supposed to do. We have to get that Needleman kid more money. Another $15,000 ought to do it."

>wait
Time passes.

Isn't this why I buy insurance? Don't worry. You'll get your piece. Everyone will get their piece.

>wait
Time passes.

Mr. Whidbey says "I need that money in a hurry though before anyone gets suspicious. If anything happens then you'll go down too."

>wait
Time passes.

"Ok, I'll try to stall for a bit but I won't be able to do it for long."

>wait
Time passes.

"Hey! What are you doing here? This is area is for employees only," Mr. Whidbey shouts at you. "Get out of here. Now!"

Concession Stand
The concession stand is a destination for many along the midway. Twinkling lights frame the stand making it glow amid the carnival's buzz.

Behind the counter, popcorn churns in the machine, candy apples gleam, and cotton candy spins in clouds. Warm pretzels sit under a heat lamp, while sodas chill in a frosted cooler. The counter is cluttered with bags, napkins, and sprinkle cups. Kids tug at parents, teens share pretzels, and the crowd buzzes with energy.

There is a menu to the right of the window. You can see the treats inside the stand. There are exits to the south, west, and northeast.

Nearby a sturdy door leads south to the Carnival Office.

You can also see a concession attendant and a menu here.

You suddenly find yourself escorted outside the Carnival Office unceremoniously only to find yourself in the Concession Stand.

>south
Carnival Office
Nearby a sturdy door leads north to the Concession Stand.

On the messy desk are a mini Ferris wheel and a mini carousel.

You can also see a safe (closed), a filing cabinet (closed), and a framed photograph here.

>look at photo
This appears to be a photo of the carnival's opening night, a once proud moment lost in time. On the back reads a date: "03/22/62". This looks like the same photo you found in the Maintenance Office.

>turn dial to 62
You turn the knob to 62.

>set dial to 22
You turn the knob to 22.

>spin dial to 3
You turn the knob to 3, and you hear a click.

>open safe
You open the safe, revealing an indigo colored fuse, a gold key, and an insurance policy.

>get all from safe
indigo colored fuse: Taken.
gold key: (putting your keys into the fanny pack to make room)
Taken.
insurance policy: (putting the 14" long piece of string (tied to some chewed bubblegum) into the fanny pack to make room)
Taken.

[Your score has just gone up by five points.]

[Your score has just gone up by ten points.]

>open filing cabinet
(first unlocking the filing cabinet)
(with the gold key)
You open the filing cabinet, revealing an envelope, a Cash 'N' Carry invoice, a Frank's Market invoice, an Oriental Trading invoice, and a Mystic Industries invoice.

>get all from cabinet
Cash 'N' Carry invoice: (putting the parking ticket into the fanny pack to make room)
Taken.
envelope: (putting the Fortune Teller ticket into the fanny pack to make room)
Taken.
Frank's Market invoice: (putting the Bumper Cars ticket into the fanny pack to make room)
Taken.
Oriental Trading invoice: (putting the Carousel ticket into the fanny pack to make room)
Taken.
Mystic Industries invoice: (putting the mallet into the fanny pack to make room)
Taken.

[Your score has just gone up by five points.]

[Your score has just gone up by five points.]

[Your score has just gone up by five points.]

[Your score has just gone up by five points.]

>open envelope
You open the envelope, revealing a check stub.

>look at check stub
This check stub is for a check made payable to "Fred Needleman". The amount is $10,000 and the memo line reads "For services rendered."

>north
Concession Stand
Nearby a sturdy door leads south to the Carnival Office.

You can also see a concession attendant and a menu here.

>ask attendent about hell ride
"Hell Ride is so old that It's falling apart. I wouldn't ride it." says the concession attendant.

You've collected some new evidence.

>ask attendant about accidents
The concession attendant says "The fire, the Ferris wheel, the Bumper Cars... That seems like a lot!"

You've collected some new evidence.

>northeast
Ticket Booth
You can see a cashier here.

>south
Head of the Line
You can see a janitor and a Hell Ride attendant here.

>south
Ride Entrance
You can see a Hell Ride car (empty) here.

>east
Dark Passage

>south
Maintenance Office
Nearby an aqua colored door leads west to the Stocks Room.

Nearby a ladder leads up.

You can also see a worn photo and a desk (on which are a coffee mug and a radio) here.

>up
Dark Hallway
This is a poorly lit hallway. Ahead to the west you can see a closed door.

Nearby a ladder leads down to the Maintenance Office.

Nearby a metal door leads west.

>west
(first opening the metal door)
(first unlocking the metal door)
(with the brass key)

Control Room
The backstage control room is a functional space with gray, scuffed walls. A large monitor shows live feeds while control panels with dials, buttons, and lights manage the rides and systems. The panels remain oddly dark.

The hum of electronics is interrupted by a crackling radio: "Maintenance to Bumper Cars - wrench needed!" Papers, tools, and coffee cups clutter the floor. A desk holds logs and schedules, and a corkboard displays charts and red-marked notes, including one that says "Check Zipper circuit breakers."

A single light casts harsh shadows, and the air smells of lubricant and burnt wires, mingling with dampness. The room is hidden but vital, keeping the carnival running. On one wall, a switch sparks with blue and white arcs.

On one wall is a large switch with sparks arcing out from it.

Nearby a metal door leads east to Dark Hallway.

Currently there are sparks arcing out from the switch. It looks dangerous.

[Your score has just gone up by five points.]

>flip switch
You switch the big switch off.

[Your score has just gone up by five points.]

>east
Dark Hallway
Nearby a metal door leads west to Control Room.

Nearby a ladder leads down to the Maintenance Office.

>down
Maintenance Office
Nearby a ladder leads up to Dark Hallway.

Nearby an aqua colored door leads west to the Stocks Room.

You can also see a worn photo and a desk (on which are a coffee mug and a radio) here.

>south
Crawl Space
Nearby a crimson colored door leads west to the Gallows Room.

>south
Mechanical Room North
Nearby an emerald colored door leads west to the Stake Room.

You can also see a toolbox (in which are some channel locks and a hammer) here.

>south
Mechanical Room South
Nearby a gray colored door leads west to the Dungeon.

You can also see a grate (empty) here.

>south
Generator Room
Nearby an indigo colored door leads west to the Guillotine Room.

>south
Electrical Room
The electrical room is small, hidden behind the carnival's attractions. The air smells of overheated wires and metal.

A central breaker panel dominates one wall, with labels like "Ferris Wheel Lights" and "Carousel Motors." Indicator lights blink intermittently. Thick cables hang from the ceiling, connected to the carnival's power network.

A junction box spills wires, and a workbench holds tools and a smudged wiring diagram. The floor is scratched and stained. A faint vibration pulses in the air.

An emergency shutdown panel and fire extinguisher sit nearby. Fluorescent lights cast shifting shadows. The room is raw and essential, a behind-the-scenes look at the carnival's power.

This room is eerily quiet, missing the ever present buzz of electricity. There are exits in all directions.

>south
Storage Room
The storage room is cramped and hidden, with rusted walls and peeling wood. The air smells of dust, damp canvas, and stale popcorn.

Shelves are packed with light bulbs, wire, and old ride parts. Flags, lights, and crates of toys clutter the space. In one corner, tarps and tent poles are stacked.

Spare ride seats and an old carousel horse sit under tarps in the center. A cluttered desk holds schedules and coffee cups, with a bulletin board full of flyers.

The concrete floor is littered with scraps and dirt. Rats scurry and cobwebs move. This forgotten room stores the remnants of the carnival, waiting to be revived.

There is an exit to the north.

Nearby a khaki colored door leads west.

>west
(first opening the khaki colored door)
(first unlocking the khaki colored door)
(with the silver key)

Ride Exit
The exit of Hell Ride leaves you unsettled. You emerge from a dark corridor, the walls peeling and streaked with black and red. Flickering lights cast shifting shadows on the sloped floor, and the air is damp with a metallic tang. Whispers and distant screams echo softly in the background.

In a small courtyard, a rusted fence draped with cobwebs and plastic bones encloses the area. A worn sign reads, "You've Survived? For Now." Nearby, carnival workers in tattered costumes watch quietly, muttering, "Not everyone makes it out."

The nearby gift shop glows red. The bright lights and sounds of the carnival feel distant and jarring after the oppressive atmosphere of the ride.

The exit ensures Hell Ride isn't just an experience - it lingers, blurring the line between thrill and fear.

There is a price list next to the cash register. An attendant is here to assist you with your purchases. The stand has aqua colored fuse, Plastic Bones, Devil Horns, Key Chains, and T-Shirts for sale.

Nearby a wooden door leads east to the Storage Room.

You can also see a merchandise attendant here.

>read sign
$2.00 Key Chains
$3.50 Aqua Colored Fuse
$2.00 Devil Horns
$1.00 Plastic Bones
$7.50 T-Shirts

>buy aqua fuse
You fork over $3.50 for the aqua colored fuse, leaving yourself with $13.50.
(putting the horseshoe magnet into the fanny pack to make room)

[Your score has just gone up by ten points.]

>east
Storage Room
Nearby a khaki colored door leads west to the Ride Exit.

>north
Electrical Room

>northeast
Electrical Closet One
This is Electrical Closet One. There's an electrical panel here and an exit to the southwest.

>open panel
(first unlocking Electrical Panel 1)
(with the knock-off Swiss Army knife)
Using the screwdriver on the knock-off Swiss Army knife, you remove the screws holding the electrical panel shut.

You open Electrical Panel 1.

>put aqua fuse in socket
You hear a satisfying snick as the aqua fuse slides into place.

>flip switch
You switch Electrical Panel 1's switch on.

The aqua indicator's light goes on.

[Your score has just gone up by five points.]

>southwest
Electrical Room

>east
Electrical Closet Three
This is Electrical Closet Three. There's an electrical panel here and an exit to the west.

>open panel
(first unlocking Electrical Panel 3)
(with the knock-off Swiss Army knife)
Using the screwdriver on the knock-off Swiss Army knife, you remove the screws holding the electrical panel shut.

You open Electrical Panel 3.

>put crimson fuse in socket
You hear a satisfying snick as the crimson fuse slides into place.

>flip switch
You switch Electrical Panel 3's switch on.

The crimson indicator's light goes on.

[Your score has just gone up by five points.]

>west
Electrical Room

>southeast
Electrical Closet Five
This is Electrical Closet Five. There's an electrical panel here and an exit to the northwest.

>open panel
(first unlocking Electrical Panel 5)
(with the knock-off Swiss Army knife)
Using the screwdriver on the knock-off Swiss Army knife, you remove the screws holding the electrical panel shut.

You open Electrical Panel 5.

* * *

>flip switch
You switch Electrical Panel 5's switch on.

The emerald indicator's light goes on.

[Your score has just gone up by five points.]

>northwest
Electrical Room

>southwest
Electrical Closet Seven
This is Electrical Closet Seven. There's an electrical panel here and an exit to the northeast.

>open panel
(first unlocking Electrical Panel 7)
(with the knock-off Swiss Army knife)
Using the screwdriver on the knock-off Swiss Army knife, you remove the screws holding the electrical panel shut.

You open Electrical Panel 7.

>put gray fuse in socket
You hear a satisfying snick as the gray fuse slides into place.

>flip switch
You switch Electrical Panel 7's switch on.

The gray indicator's light goes on.

[Your score has just gone up by five points.]

>northeast
Electrical Room

>west
Electrical Closet Nine
This is Electrical Closet Nine. There's an electrical panel here and an exit to the east.

>open panel
(first unlocking Electrical Panel 9)
(with the knock-off Swiss Army knife)
Using the screwdriver on the knock-off Swiss Army knife, you remove the screws holding the electrical panel shut.

You open Electrical Panel 9.

>put indigo fuse in socket
You hear a satisfying snick as the indigo fuse slides into place.

>flip switch
You switch Electrical Panel 9's switch on.

The indigo indicator's light goes on.

[Your score has just gone up by five points.]

>east
Electrical Room

>northwest
Electrical Closet Eleven
This is Electrical Closet Eleven. There's an electrical panel here and an exit to the southeast.

>open panel
(first unlocking Electrical Panel 11)
(with the knock-off Swiss Army knife)
Using the screwdriver on the knock-off Swiss Army knife, you remove the screws holding the electrical panel shut.

You open Electrical Panel 11.

>put khaki fuse in socket
You hear a satisfying snick as the khaki fuse slides into place.

>flip switch
You switch Electrical Panel 11's switch on.

The khaki indicator's light goes on.

[Your score has just gone up by five points.]

>southeast
Electrical Room

>north
Generator Room
Nearby an indigo colored door leads west to the Guillotine Room.

>north
Mechanical Room South
Nearby a gray colored door leads west to the Dungeon.

You can also see a grate (empty) here.

>north
Mechanical Room North
Nearby an emerald colored door leads west to the Stake Room.

You can also see a toolbox (in which are some channel locks and a hammer) here.

>north
Crawl Space
Nearby a crimson colored door leads west to the Gallows Room.

>north
Maintenance Office
Nearby a ladder leads up to Dark Hallway.

Nearby an aqua colored door leads west to the Stocks Room.

You can also see a worn photo and a desk (on which are a coffee mug and a radio) here.

>north
Dark Passage

* * *

>north
Head of the Line
You can see a Hell Ride attendant here.

>north
Ticket Booth
You can see a janitor and a cashier here.

The janitor heads to the Head of the Line.

>south
Head of the Line
You can see a janitor and a Hell Ride attendant here.

>ask janitor about himself
The janitor looks at you and waits for you to proceed.

The janitor says, "I'm the maintenance engineer for the carnival. I've been working here for the past four years."

>ask janitor about whidbey
The janitor looks bored as he waits for you to speak.

The janitor says , "Mr. Whidbey? He creeps me out. It always seems like he's hiding something. Just yesterday I caught him sneaking around the guillotine room in Hell Ride."

You've collected some new evidence.

>ask janitor about hell ride
The janitor looks at you expectantly.

"Hell Ride is a finicky ride. I'm fixing something there every week. Last week, Mr. Whidbey asked me to skip Hell Ride's maintenance slot. There was a real fire in the Stakes Room last month. And just yesterday I caught him creeping around the guillotine room" says the janitor.

You've collected some new evidence.

>ask janitor about accidents
The janitor looks at you and waits for you to proceed.

The janitor says "The fire, the Ferris wheel, the Bumper Cars... That's a lot of suspicious accidents."

You've collected some new evidence.

>ask janitor about fire
The janitor looks at you expectantly.

"The very real fire in the Stakes Room in Hell Ride was a scary event. I couldn't put it out with a fire extinguisher. We had to wait for the fire department and by then there was a lot of damage done" says the janitor.

You've collected some new evidence.

>show cash 'n' carry to janitor
The janitor says, "Man, this doesn't look good for the carnival."

You've collected some new evidence.

>show frank's to janitor
The janitor says, "Looks like the carnival is in some financial trouble."

You've collected some new evidence.

>show oriental trading to janitor
The janitor says, "These prizes are cheaper and flimsier than usual."

You've collected some new evidence.

>north
Ticket Booth
You can see a cashier here.

>northwest
Bumper Cars
You can see a janitor and a Bumper Cars attendant here.

>show mystic to janitor
The janitor says, That fire in Hell Ride was really bad. It took almost two weeks to get it fully repaired. But it shouldn't have cost this much. I think Mr Whidbey got ripped off. Or, he got it fixed on the cheap and pocketed the rest."

You've collected some new evidence.

>ask janitor about ferris wheel
The janitor looks at you and waits for you to proceed.

The janitor remarks, "The other day, I found a bolt on one of the gondolas so loose it had almost come off. That would have been a tragedy!"

You've collected some new evidence.

>ask janitor about bumper cars
The janitor looks at you expectantly.

The janitor says, "That reminds me. Not long ago, one of the bumper cars was shorting out and electrifying the car. A visitor got hurt. A young lad, what was his name? Fred something, I think."

You've collected some new evidence.

>show check stub to janitor
(first taking the check stub)
The janitor says "What?! That's the name of the kid who got hurt in the Bumper Cars incident."

You've collected some new evidence.

The janitor heads to the Ticket Booth.

[Your score has just gone up by ten points.]

>southeast
Ticket Booth
You can see a janitor, Mr Whidbey, and a cashier here.

>southeast
Fortune Teller
Approaching the fortune teller's booth, you are drawn in by its mysterious allure and inky softness. Draped in deep purple curtains adorned with golden moons and stars, the booth is lit only with the flickering of candles. The air is heavy with the scent of incense, mingling with and then overpowering the ever-present sugary odor of carnival treats. A sign sways slightly in the evening breeze.

You can see Esmeralda here.

>ask esmeralda about accidents
Esmeralda says "Things sure seem vulnerable at this time."

You've collected some new evidence.

>ask esmeralda about fire
"There was a fire in one of the rooms in Hell Ride," says Esmeralda.

You've collected some new evidence.

>ask esmeralda about hell ride
"Hell Ride is the flagship ride at Whidbey Amusements. It's always made me feel nervous," says Esmeralda.

You've collected some new evidence.

* * *

>ask esmeralda about whidbey
Esmeralda says , "Mr. Whidbey? He creeps me out. He's up to something."

You've collected some new evidence.

>show insurance policy to esmeralda
"An insurance policy? For a million dollars? Something is fishy for sure!" Esmeralda says.

You've collected some new evidence.

>give ticket
(the Fortune Teller ticket to Esmeralda)
(first taking the Fortune Teller ticket)
You give the Fortune Teller ticket to Esmeralda.

Stepping inside, you're greeted by Esmeralda, a figure cloaked in flowing robes with a jeweled headpiece catching the flickering light. Her piercing eyes seem to look right through you as they gesture for you to sit at a small round table. At its center rests a glowing crystal ball, surrounded by tarot cards and mysterious trinkets.

Esmeralda's voice is low and melodic, weaving an air of intrigue as they ask you to focus on a question and offer you a tarot reading. The room seems to shrink, the bustling carnival outside fading into the background as she reveals your fate. Each card turned feels significant, as though unlocking a secret you didn't know you carried.

Past: Eight of Cups (reversed)
Eight of Cups reversed indicates suggests that you may be clinging tightly to your comfort zone, even if it no longer serves your best interests. This card urges you to examine whether you are avoiding necessary growth or ignoring your true desires. It may be tempting to remain in familiar territory, but by doing so, you risk missing out on the opportunities that lie ahead. Now is the time to summon the courage to explore new horizons and embrace the unknown.

>wait
Time passes.

Present: Knight of Swords (reversed)
Knight of Swords reversed signifies a lack of strategy, where actions are taken without much thought or consideration for the consequences. It suggests a tendency to rush into situations without a clear plan, leading to hasty decisions and potential conflicts. This reversed Knight warns against reckless behavior and encourages the need for patience and careful deliberation. It serves as a reminder to slow down, reflect, and align actions with a well-thought-out strategy in order to avoid unnecessary conflicts and achieve the desired outcomes.

>wait
Time passes.

Challenge: The Devil (reversed)
Devil reversed indicate temptations resisted, stricter moral kept and an escape from the chains from the devil. It offers hope and liberation. The Devil reversed brings the strength and self awareness to confront your inner demons and break free from the suffocating bonds that have kept you trapped in patterns of self-destruction. It is a powerful call to examine your attachments, whether they be toxic relationships, harmful habits, or limiting beliefs.

>wait
Time passes.

Opportunity: The Fool (upright)
Fool represents new beginnings and feeling carefree. It may indicate a new phase in your life such as starting a new job, moving to a new city, or beginning a new relationship. Embrace this new chapter with optimism and an open heart. The Fool reminds you that it's never too late to start fresh and that you can always take a leap of faith towards your dreams.

>wait
Time passes.

Future: The Devil (upright)
Devil symbolizes primal behaviors, desires and addictions and materialism. It represents the fears that causes obsession and compulsive behavior. Its ominous appearance serves as a reminder that you may find yourself caught in the snare of worldly desires and unhealthy patterns. This card is a wake-up call to face your fears and conquer them. This is a card of temptation, and it's warning you to be careful of what you allow to control you.

As the reading concludes, Esmeralda gazes into your eyes with a cryptic smile and delivers their final words of wisdom: "The order of things is important. Alphabetically and numerically; one follows another and provides the link between the two. If you will learn, think on this carefully. Also, don't trust Whidbey. He's up to something."

Whether you leave with a sense of wonder or unease, the encounter lingers with you - it's a touch of magic amid the bustling carnival, as if you've glimpsed something beyond the ordinary.

>northwest
Ticket Booth
You can see a janitor and a cashier here.

>south
Head of the Line
You can see a Hell Ride attendant here.

>south
Ride Entrance
You can see a Hell Ride car (empty) here.

>east
Dark Passage
You can see Mr Whidbey here.

>ask whidbey about himself
Mr Whidbey looks at you expectantly.

"I've been at the helm of Whidbey Amusements since 1991. We've seen a lot of changes in that time," says Mr Whidbey.

>ask whidbey about hell ride
Mr Whidbey waits for you to speak.

"Hell Ride is the premier attraction here at Whidbey Amusements. It's both spooky and fun! The visitors love it! The fire last month was unfortunate and expensive" says Mr Whidbey.

>ask whidbey about fire
Mr Whidbey nervously shifts his weight from one foot to the other.

The fire was most unfortunate. It put Hell Ride out of commission for two weeks. Not only did it cost me $22,500 to repair but I lost revenue while it was closed.

You've collected some new evidence.

>ask whidbey about indigo fuse
Mr Whidbey waits for you to speak.

"Where did you get that?" Mr Whidbey asks.

Mr. Whidbey's eyes dart up and to the left.

You've collected some new evidence.

>ask whidbey about pliers
Mr Whidbey looks at you expectantly.

"Oh! I thought I lost... um, those belong to the janitor. Where did you find them?" asks Mr Whidbey.

You've collected some new evidence.

>ask whidbey about bumper cars
Mr Whidbey nervously shifts his weight from one foot to the other.

"That incident the other week with that Needleman kid was unfortunate" says Mr Whidbey.

You've collected some new evidence.

>show check stub to whidbey
Mr Whidbey says "Uh, Fred is a special... contractor... We paid him. For services rendered."

You've collected some new evidence.

Mr Whidbey heads to the Stocks Room.

>south
Maintenance Office
Nearby a ladder leads up to Dark Hallway.

Nearby an aqua colored door leads west to the Stocks Room.

You can also see a worn photo and a desk (on which are a coffee mug and a radio) here.

>west
Stocks Room
Nearby a wooden door leads east to the Maintenance Office.

You can also see Mr Whidbey and a wooden stocks here.

>ask whidbey about needleman
Mr Whidbey waits for you to speak.

Mr Whidbey says "Uh, Fred is a special... contractor... We paid him. For services rendered."

Mr. Whidbey quickly changes the subject
You've collected some new evidence.

>show mystic to whidbey
Mr Whidbey says, "That fire in Hell Ride was very expensive to repair. And it put the ride out of commission for two weeks."

You've collected some new evidence.

>show evidence
Weight   Evidence collected:
  ------   --------------------------------------------------------
•    62    Evidence concerning accidents with the attractions
•    16    Evidence concerning insurance
•     6    Evidence concerning Mr Whidbey
•     5    Evidence concerning fuses
•     3    Evidence concerning past due invoices
  ------   --------------------------------------------------------
•    92    Total Weighted Evidence

You've got enough evidence for a conviction.

>east
Maintenance Office
Nearby an aqua colored door leads west to the Stocks Room.

Nearby a ladder leads up to Dark Hallway.

You can also see a worn photo and a desk (on which are a coffee mug and a radio) here.

>up
Dark Hallway
Nearby a ladder leads down to the Maintenance Office.

Nearby a metal door leads west to Control Room.

>west
Control Room
Nearby a metal door leads east to Dark Hallway.

You can also see a big switch here.

>turn aqua dial to 1
The aqua colored dial is now set to 1.

* * *

>turn emerald dial to 5
The emerald colored dial is now set to 5.

>spin gray dial to 7
The gray colored dial is now set to 7.

>set indigo dial to 9
The indigo colored dial is now set to 9.

>set khaki dial to 11
The khaki colored dial is now set to 11.

>push indigo button
You switch the indigo button on.

The monitor flickers for a second and the scene it displays changes to something different.
The monitor now shows a tableau of a guillotine rising and falling over the ride exit.
The indigo light is now on.

As you push the indigo button, the monitor switches to a view of the guillotine room. You still see the blade rising and falling over the cars. Suddenly, the blade starts slowing down, taking longer and longer to fall. Until it finally comes to a complete rest.

The room is heavy with uneasy silence. Hell Ride, once a thrilling spectacle, now looms motionless, as the guillotine blade is frozen halfway down its track. Moments ago, chaos erupted as the malfunctioning mechanism sent the blade crashing unpredictably, ripping through the roofs of cars on the track.

A single car, its roof gashed open, sits under the still blade - a grim reminder of the disaster narrowly averted. Above, a black crow lands on the guillotine's frame, its sharp caw cutting through the murmurs of anger and fear.

Two mechanics climb the scaffolding with tools in hand, their appearance met with wary hope. A crowd has gathered and is watching, holding their breath, as the cursed ride's fate hangs in the balance. After a moment, applause rises from the assembled crowd, cheering your accomplishment.

Mr. Whidbey, the Mayor, the Chief of Police, and the janitor arrive on the scene and extend their gratitude for saving the day, not to mention lives!

"But wait", you say, "There is more afoot here than meets the eye. I think we need to talk to Mr Whidbey some more... confront him about a few things. Accusations might be made."

Mr Whidbey exclaims, "Accusations? What accusations?"

The Police Chief listens with interest to what you have to say.