The carnival is in town and you and your sweetie had a date to visit it. After dinner and just as you arrive at the carnival, you and your date have a terrible fight. They storm off leaving you alone at the carnival. You decide to stay at the carnival anyway.

Hell Ride
The ride of a lifetime... by No Shoes
Release 111 / Serial number 241219 / Inform 7 v10.1.2 / D

Parking Lot
The carnival parking lot stretches across an open field, its gravel crunching under arriving cars. Temporary floodlights and the carnival's colorful glow light the area, while distant laughter, music, and the hum of rides fill the air.

Cars park haphazardly, guided by makeshift signs and fluttering flags. Families unload strollers and blankets, their chatter mixing with the carnival sounds. Others linger in vehicles, preparing for the chilly evening.

Shadows from nearby trees create dark pockets pierced by the occasional flashlight. Near the entrance, an attendant collects fees at a weathered booth, coins jingling in the cash box.

Puddles from recent rain shimmer with reflected lights, while patches of mud cling to unwary shoes. At the far end, RVs and trailers sit quietly, their occupants watching the Ferris wheel spin lazily against the sky.

Alive with anticipation, the parking lot marks the transition from the ordinary to the magic of the carnival.

The midway is to the south. There is a blueberry bush here. There are blueberries on the bush. 

Your car is here. It's a bit of a beater. Inside the car, you can see the dashboard, the seat, and the glove box.

You can see a Parking Attendant here.

>give coupon to attendant
(first taking the coupon)
Given. The price of a parking ticket is now $3.00.

>buy parking ticket
The attendant says, "Don't forget to leave the parking stub on your dashboard".

You fork over $3.00 for the parking ticket, leaving yourself with $27.00.

>get in car
You get into the beater car.

In the beater car you can see an air freshener.

* * *

>l at air freshener
This is one of those air fresheners that are shaped like a pine tree and smell like one too. You bought it the last time you went to the car wash.

>put parking stub on dashboard
You put the parking stub on the dashboard.

>l under seat
You find your keys and the dime!
Taken.

[Your score has just gone up by five points.]

>open glove box
(first unlocking the glove box)
(with your keys)
You open the glove box, revealing a gloves.

* * *

>wear gloves
You put on the gloves.

>exit car
You get off the beater car.

Parking Lot
The carnival parking lot stretches across an open field, its gravel crunching under arriving cars. Temporary floodlights and the carnival's colorful glow light the area, while distant laughter, music, and the hum of rides fill the air.

Cars park haphazardly, guided by makeshift signs and fluttering flags. Families unload strollers and blankets, their chatter mixing with the carnival sounds. Others linger in vehicles, preparing for the chilly evening.

Shadows from nearby trees create dark pockets pierced by the occasional flashlight. Near the entrance, an attendant collects fees at a weathered booth, coins jingling in the cash box.

Puddles from recent rain shimmer with reflected lights, while patches of mud cling to unwary shoes. At the far end, RVs and trailers sit quietly, their occupants watching the Ferris wheel spin lazily against the sky.

Alive with anticipation, the parking lot marks the transition from the ordinary to the magic of the carnival.

The midway is to the south. There is a blueberry bush here. There are blueberries on the bush. 

Your car is here. It's a bit of a beater. Inside the car, you can see the dashboard, the seat, and the glove box.

You can see a Parking Attendant here.

>l at bush
In the blueberry bush is blueberries.

* * *

>eat blueberries
The blueberries were delicious. A true taste of summer.

>s
Ticket Kiosk
The ticket kiosk stands at the carnival entrance, a compact booth painted in bright red and yellow stripes with bold letters above the window reading "Tickets Here!" Twinkling lights outline its edges, blinking rhythmically to draw attention.

A single window serves visitors, where a smiling attendant dispenses colorful tickets from neatly arranged rolls. Beside the tickets, a cash drawer jingles as change is counted, and a digital payment system glows faintly for modern convenience. Too bad you don't have a debit card.

Next to the kiosk, a vibrant signboard lists ticket prices with playful illustrations of rides and treats. Pennant flags flutter from the kiosk's roof, adding to the festive atmosphere, while the smell of popcorn and fried dough wafts from nearby stalls.

The worn ground around the kiosk shows the passage of eager carnival-goers. Families, couples, and friends form a buzzing line, their excitement building as they approach this first step into the magic of the carnival.

The midway continues in all directions from here. There is a cashier here. The prices of ride tickets are on the signboard. The cashier has Hell Ride ticket, Fortune Teller ticket, Ferris Wheel ticket, Bumper Cars ticket, and Carousel ticket.

>buy hell ride ticket
You fork over $3.00 for the Hell Ride ticket, leaving yourself with $24.00.

* * *

>buy ferris wheel ticket
You fork over $2.00 for the Ferris Wheel ticket, leaving yourself with $16.00.

>nw
Bumper Cars Ride
The bumper cars is a bustling hub of excitement and laughter, set beneath a canopy of flashing lights and colorful decorations. The rectangular arena is surrounded by padded barriers, ensuring a safe yet thrilling experience for riders. The floor, slick and metallic, allows the brightly colored cars-painted in shades of red, blue, yellow, and green-to glide effortlessly in all directions.

Each car is equipped with a steering wheel and a padded bumper, designed to absorb the impact of playful collisions. As the ride begins, drivers of all ages eagerly maneuver their cars, aiming for friends, family, or strangers with mischievous grins. The air is filled with the sound of bumpers colliding, laughter, and the occasional squeal of surprise.

Overhead, a web of electric poles connects the cars to the ceiling, sparking faintly as they supply power to the vehicles. The ride operator watches from a booth, ensuring everyone enjoys the chaos safely. Surrounding the bumper cars are cheering onlookers, carnival lights, and the lively hum of the fairground.

The bumper cars perfectly captures the playful spirit of the carnival, offering a mix of harmless competition, shared laughter, and nostalgic fun for all ages.

>give bumper cars ticket to bumper cars attendant
You give the Bumper Cars ticket to the Bumper Cars Attendant.

Sliding into the snug seat of the bumper car, your hands grip the steering wheel, anticipation buzzing in the air. Around you, the arena is alive with flashing lights, bursts of laughter, and the hum of electric currents running through the overhead poles. A quick glance shows other riders locking eyes, playful grins spreading as everyone braces for the chaos about to unfold.

As the ride starts, your car jolts forward, and you steer into the fray. The slick metal floor beneath makes every turn feel smooth yet unpredictable. Suddenly, bam!-another car collides into you from the side, sending your car into a spin. You laugh, recovering quickly to aim your vehicle at a friend or an unsuspecting rider across the arena.

The thrill of the bumper cars is in the collisions-every thud and jolt accompanied by squeals of delight or mock indignation. The impact is cushioned by the padded bumpers, keeping the fun safe but exhilarating. You swerve, dodge, and sometimes reverse in a desperate attempt to avoid being cornered, all while plotting your next playful crash.

The ride is a whirlwind of laughter, harmless competition, and shared joy. As the music fades and the cars slow to a stop, you climb out with a wide grin, already looking forward to your next turn in the driver's seat.

>se
Ticket Kiosk
The ticket kiosk stands at the carnival entrance, a compact booth painted in bright red and yellow stripes with bold letters above the window reading "Tickets Here!" Twinkling lights outline its edges, blinking rhythmically to draw attention.

A single window serves visitors, where a smiling attendant dispenses colorful tickets from neatly arranged rolls. Beside the tickets, a cash drawer jingles as change is counted, and a digital payment system glows faintly for modern convenience. Too bad you don't have a debit card.

Next to the kiosk, a vibrant signboard lists ticket prices with playful illustrations of rides and treats. Pennant flags flutter from the kiosk's roof, adding to the festive atmosphere, while the smell of popcorn and fried dough wafts from nearby stalls.

The worn ground around the kiosk shows the passage of eager carnival-goers. Families, couples, and friends form a buzzing line, their excitement building as they approach this first step into the magic of the carnival.

The midway continues in all directions from here. There is a cashier here. The prices of ride tickets are on the signboard. The cashier has nothing.

You can see a cashier here.

>ne
Carousel Ride
The carousel is a timeless carnival attraction, radiating charm and nostalgia with its brightly painted horses, vibrant lights, and cheerful music. The circular platform is adorned with a canopy of swirling colors, gold trim, and decorative mirrors that reflect the flickering bulbs lining its edges.

Rows of hand-carved animals, most often horses with flowing manes, are arranged in a circle. Each is painted in vivid colors, detailed with golden saddles and ribbons. Some carousels also feature exotic creatures like lions, tigers, or sea dragons, adding whimsy to the ride. The animals rise and fall gently as the carousel spins, mimicking a galloping motion.

The carousel's warm, playful tunes drift across the midway, inviting riders of all ages to enjoy its simple delight. Children laugh as they choose their favorite animals, while adults savor the nostalgia of the spinning ride. As it rotates, the carousel becomes a moving work of art, blending motion, color, and music into an enchanting centerpiece of the carnival. The Ticket Kiosk is back the way you came.

>give carousel ticket to carousel attendant
You give the Carousel ticket to the Carousel Attendant.

Stepping onto the carousel's spinning platform, you're greeted by a kaleidoscope of color-brightly painted horses, glittering lights, and golden trim. The cheerful melody of calliope music fills the air as you choose your mount, perhaps a galloping horse with a flowing mane, a majestic lion, or a whimsical giraffe. Gripping the polished pole, you settle onto the saddle, feeling the smooth rise and fall as the carousel begins to turn.

As the ride picks up speed, the world outside becomes a blur of glowing carnival lights and swirling colors. The gentle up-and-down motion mimics a playful gallop, and the rhythmic whir of the carousel's machinery adds a soothing backdrop to the cheerful atmosphere. Laughter and the sound of children's chatter mix with the music, creating a sense of nostalgia and joy.

For a few moments, you're transported into a magical world, the worries of the day fading away with each graceful rotation. Whether you're enjoying the ride alone, with friends, or sharing a special moment with family, the carousel's charm captures a timeless blend of whimsy and wonder. As it slows to a stop, you step off with a smile, the music lingering in your ears as you rejoin the bustling carnival.

>sw
Ticket Kiosk
The ticket kiosk stands at the carnival entrance, a compact booth painted in bright red and yellow stripes with bold letters above the window reading "Tickets Here!" Twinkling lights outline its edges, blinking rhythmically to draw attention.

A single window serves visitors, where a smiling attendant dispenses colorful tickets from neatly arranged rolls. Beside the tickets, a cash drawer jingles as change is counted, and a digital payment system glows faintly for modern convenience. Too bad you don't have a debit card.

Next to the kiosk, a vibrant signboard lists ticket prices with playful illustrations of rides and treats. Pennant flags flutter from the kiosk's roof, adding to the festive atmosphere, while the smell of popcorn and fried dough wafts from nearby stalls.

The worn ground around the kiosk shows the passage of eager carnival-goers. Families, couples, and friends form a buzzing line, their excitement building as they approach this first step into the magic of the carnival.

The midway continues in all directions from here. There is a cashier here. The prices of ride tickets are on the signboard. The cashier has nothing.

You can see a cashier here.

>se
Fortune Teller Room
Approaching the fortune teller's booth, you're drawn in by its mysterious allure. Draped in deep purple curtains adorned with golden moons and stars, the booth glows with the soft, inviting light of lanterns. The air is heavy with the scent of incense, mingling with the sweet aroma of carnival treats. A sign reading "Fortunes Told-What Does Your Future Hold?" sways slightly in the evening breeze.

>give fortune teller ticket to mysterious woman
You give the Fortune Teller ticket to the Mysterious Woman.

Stepping inside, you're greeted by the fortune teller, a figure cloaked in flowing robes with a jeweled headpiece catching the flickering light. Their piercing eyes seem to look right through you as they gesture for you to sit at a small round table covered in an ornate cloth. At its center rests a glowing crystal ball, surrounded by tarot cards and mysterious trinkets.

The fortune teller's voice is low and melodic, weaving an air of intrigue as they ask you to focus on a question or offer your palm for a reading. The room seems to shrink, the bustling carnival outside fading into the background as they reveal your fate. Each card turned or line traced feels significant, as though unlocking a secret you didn't know you carried.

As the reading concludes, the fortune teller gazes into your eyes with a cryptic smile and delivers their final words of wisdom. Whether you leave with a sense of wonder, excitement, or unease, the encounter lingers with you-a touch of magic amid the carnival's chaos, as if you've glimpsed something beyond the ordinary.

>nw
Ticket Kiosk
The ticket kiosk stands at the carnival entrance, a compact booth painted in bright red and yellow stripes with bold letters above the window reading "Tickets Here!" Twinkling lights outline its edges, blinking rhythmically to draw attention.

A single window serves visitors, where a smiling attendant dispenses colorful tickets from neatly arranged rolls. Beside the tickets, a cash drawer jingles as change is counted, and a digital payment system glows faintly for modern convenience. Too bad you don't have a debit card.

Next to the kiosk, a vibrant signboard lists ticket prices with playful illustrations of rides and treats. Pennant flags flutter from the kiosk's roof, adding to the festive atmosphere, while the smell of popcorn and fried dough wafts from nearby stalls.

The worn ground around the kiosk shows the passage of eager carnival-goers. Families, couples, and friends form a buzzing line, their excitement building as they approach this first step into the magic of the carnival.

The midway continues in all directions from here. There is a cashier here. The prices of ride tickets are on the signboard. The cashier has nothing.

You can see a cashier here.

>w
Show Facade
You head west through the midway, the bright lights of the carnival fading behind you as you approach a wooden booth. A sign above the entrance reads "Little Egypt Show - A Journey Into the Mysterious and Exotic!" A rotund barker, wearing a fez and a dazzling smile, gestures to a small sign beside him that says "Dime Admission."  The Ticket Kiosk is back the way you came.

You are standing in front of a dark and mysterious tent filled with illusions and exotic performers. Perhaps there's a fortune teller inside, offering cryptic clues about your journey or a hidden artifact that can be collected. There is a stage in front of the tent. The Barker is encouraging you to step up, pay for, and enjoy the Little Egypt Show.The barker cries:

Ladies and gentlemen, boys and girls, gather 'round! 
Step right up and witness the spectacle that's taken the world by storm! 
She walks, she talks, she crawls on her belly like a reptile. 
Behold the one, the only Little Egypt, performing her legendary Dance of the Pyramids-a dazzling display of mystery, grace, and exotic allure! 
For just a dime, a mere one tenth of a dollar, prepare to be transported to the sands of Cairo, where enchantment and wonder await!

You can see a Barker here.

* * *

>z
Time passes.

The music alternates between hauntingly slow melodies and rapid, energetic drum beats, creating an emotional arc that keeps you entranced. Little Egypt relies on the music's dynamic changes to tell a story with movements reflecting joy, sorrow, seduction, and celebration.

>z
Time passes.

The performance concludes with a dramatic flourish of a fast-paced shimmy, a bold spin, and Little Egypt dramatically casts off her veils. The dancer takes a bow to enthusiastic applause, leaving you spellbound by the sensual yet artful display.

You applaud until your hands are sore. Did she just wink at me?

As she leaves the stage, Little Egypt tosses one of her veils to you!

[Your score has just gone up by five points.]

>get lamp
Taken.

[Your score has just gone up by five points.]

>turn it on
You flip a switch. The lit lantern is lit.

>e
(first getting off the folding chair)

Show Facade
You head west through the midway, the bright lights of the carnival fading behind you as you approach a wooden booth. A sign above the entrance reads "Little Egypt Show - A Journey Into the Mysterious and Exotic!" A rotund barker, wearing a fez and a dazzling smile, gestures to a small sign beside him that says "Dime Admission."  The Ticket Kiosk is back the way you came.

You are standing in front of a dark and mysterious tent filled with illusions and exotic performers. Perhaps there's a fortune teller inside, offering cryptic clues about your journey or a hidden artifact that can be collected. There is a stage in front of the tent. The Barker is encouraging you to step up, pay for, and enjoy the Little Egypt Show.

You can see a Barker here.

>e
Ticket Kiosk
The ticket kiosk stands at the carnival entrance, a compact booth painted in bright red and yellow stripes with bold letters above the window reading "Tickets Here!" Twinkling lights outline its edges, blinking rhythmically to draw attention.

A single window serves visitors, where a smiling attendant dispenses colorful tickets from neatly arranged rolls. Beside the tickets, a cash drawer jingles as change is counted, and a digital payment system glows faintly for modern convenience. Too bad you don't have a debit card.

Next to the kiosk, a vibrant signboard lists ticket prices with playful illustrations of rides and treats. Pennant flags flutter from the kiosk's roof, adding to the festive atmosphere, while the smell of popcorn and fried dough wafts from nearby stalls.

The worn ground around the kiosk shows the passage of eager carnival-goers. Families, couples, and friends form a buzzing line, their excitement building as they approach this first step into the magic of the carnival.

The midway continues in all directions from here. There is a cashier here. The prices of ride tickets are on the signboard. The cashier has nothing.

You can see a cashier here.

>e
High Striker
This area features a tall, eye-catching machine adorned with bright, colorful lights, typically red, yellow, and blue. A large sign at the top reads "Test Your Strength!" in bold, playful lettering. The machine's base is made of polished wood, with a polished, vintage appearance. At the center is a sturdy metal pole, with a large bell hanging at the top, signaling when a successful attempt has been made. Along the length of the pole are markings indicating how strong you are.  A nearby sign says, "Buy a mallet, strike the bell, win a prize."

Spectators gather around, cheering on participants and offering lighthearted jabs and encouragement, creating a lively, competitive atmosphere. The sound of the mallet hitting the target is followed by the resonant clang of the bell (if struck), alongside the buzz of carnival music in the background. The Ticket Kiosk is back the way you came.

You can see a Strongman Attendant and a lever here.

>buy mallet
You fork over $2.00 for the mallet, leaving yourself with $14.00.

* * *

>g
You lift the mallet high and bring it down on the lever with all your might! The striker rises towards the bell stopping at "Getting Stronger".  C'mon! You can do better than that!

>g
You lift the mallet high and bring it down on the lever with all your might! The striker rises towards the bell stopping at "Weakling".  C'mon! You can do better than that!

>g
You lift the mallet high and bring it down on the lever with all your might! The striker rises towards the bell stopping at "Weakling".  C'mon! You can do better than that!

You swing the mallet one more time. The bell rings as the striker reaches the top of the pole. The attendant says, "You're a Muscle Man. Here's a prize for you."
Which prize would you like? 1) a teddy bear, 2) a Swiss Army knife, 3) a poster of Taylor Swift, or 4) a magenta fuse?

>2
You are now holding a Swiss Army knife.

>e
Ferris Wheel
The Ferris wheel is the towering centerpiece of the carnival, its vibrant lights and graceful rotations drawing the attention of visitors from every corner of the fairgrounds. The wheel's massive steel frame arches high into the sky, its intricate network of beams glinting under the colorful glow of bulbs strung along its circumference. Each gondola, painted in bright hues like red, yellow, and blue, dangles from the wheel, swaying gently as it turns.

At night, the Ferris wheel transforms into a dazzling spectacle, with hundreds of synchronized lights creating patterns and ripples that pulse outward like waves. The bulbs flash in bursts of red, green, and white, casting playful reflections on nearby attractions and the surrounding crowd.

The air around the wheel is filled with a mix of excited chatter, the hum of its motor, and the occasional squeal of laughter or nervousness from riders high above. The ride operator, standing in a small booth at the base, keeps a steady rhythm of loading and unloading passengers, their voice occasionally calling out, "Step right up! The best view of the carnival awaits!"

The Ferris wheel offers an ever-changing perspective of the carnival below. From its peak, riders can see the entire fairground: the spinning lights of the rides, the colorful stripes of game booths, and the winding paths of visitors navigating the midway. Beyond the carnival, the view stretches to the horizon, with city lights or rolling countryside adding to the magical experience.

Whether it's a romantic ride for couples, a thrilling adventure for friends, or a calming retreat for families, the Ferris wheel captures the spirit of the carnival-an iconic blend of excitement, wonder, and timeless charm.

[Your score has just gone up by five points.]

>give ferris wheel ticket to ferris wheel attendant
You give the Ferris Wheel ticket to the Ferris Wheel Attendant.

As you step into the gently swaying gondola, a faint creak accompanies the safety bar locking into place. The Ferris wheel begins its slow ascent, the hum of its machinery blending with the distant sounds of carnival games and laughter below. A soft breeze brushes against your face as the gondola rises higher, offering an ever-expanding view of the fairgrounds.

With each rotation, the world transforms. At the peak, the carnival sprawls beneath you like a miniature village, its vibrant lights twinkling against the twilight sky. The sound of the midway fades into a soft murmur, replaced by the serene quiet of being high above the bustling crowd. Beyond the fair, the horizon stretches endlessly, framed by the glow of distant city lights or rolling countryside.

The gondola sways gently, adding a hint of thrill to the tranquil ride. You exchange smiles with your companions, pointing out tiny figures darting between booths or the dizzying motion of other rides below. The Ferris wheel begins its descent, and the lively carnival sounds grow louder once again, bringing you back into the heart of the action.

Whether you're seeking a moment of calm, a romantic view, or the sheer wonder of seeing the world from above, the Ferris wheel delivers an unforgettable ride that captures the magic of the carnival.

>w
High Striker
This area features a tall, eye-catching machine adorned with bright, colorful lights, typically red, yellow, and blue. A large sign at the top reads "Test Your Strength!" in bold, playful lettering. The machine's base is made of polished wood, with a polished, vintage appearance. At the center is a sturdy metal pole, with a large bell hanging at the top, signaling when a successful attempt has been made. Along the length of the pole are markings indicating how strong you are.  A nearby sign says, "Buy a mallet, strike the bell, win a prize."

Spectators gather around, cheering on participants and offering lighthearted jabs and encouragement, creating a lively, competitive atmosphere. The sound of the mallet hitting the target is followed by the resonant clang of the bell (if struck), alongside the buzz of carnival music in the background. The Ticket Kiosk is back the way you came.

You can see a Strongman Attendant and a lever here.

>w
Ticket Kiosk
The ticket kiosk stands at the carnival entrance, a compact booth painted in bright red and yellow stripes with bold letters above the window reading "Tickets Here!" Twinkling lights outline its edges, blinking rhythmically to draw attention.

A single window serves visitors, where a smiling attendant dispenses colorful tickets from neatly arranged rolls. Beside the tickets, a cash drawer jingles as change is counted, and a digital payment system glows faintly for modern convenience. Too bad you don't have a debit card.

Next to the kiosk, a vibrant signboard lists ticket prices with playful illustrations of rides and treats. Pennant flags flutter from the kiosk's roof, adding to the festive atmosphere, while the smell of popcorn and fried dough wafts from nearby stalls.

The worn ground around the kiosk shows the passage of eager carnival-goers. Families, couples, and friends form a buzzing line, their excitement building as they approach this first step into the magic of the carnival.

The midway continues in all directions from here. There is a cashier here. The prices of ride tickets are on the signboard. The cashier has nothing.

You can see a cashier here.

>sw
Concession Stand
The concession stand, perched along the midway, is a colorful and bustling hub. Painted in bright reds, blues, and yellows, it features bold lettering announcing treats like "SODA! POPCORN! CANDY APPLES!" Strings of twinkling lights frame the stand, making it a glowing beacon amid the carnival excitement.

Behind the counter, a popcorn machine churns out golden kernels, filling the air with a buttery aroma. Candy apples gleam under the lights, and cotton candy machines spin fluffy clouds of pink and blue. Warm pretzels sit under a heat lamp, their buttery, salted scent mingling with the sugary treats. A cooler holds sodas, their colorful labels visible through the frosted glass.

The counter is lively with stacks of paper bags, napkins, and cups of cheese and sugar sprinkles. A handwritten chalkboard menu lists prices in playful lettering. Workers in colorful aprons quickly hand out snacks, their movements efficient amid the cheerful chaos.

In front of the stand, kids tug at their parents, teens share pretzels, and the crowd buzzes with energy. More than just a snack stop, the stand is a sensory delight, adding flavor and charm to the carnival experience.

There is a menu to the right of the window. You can see the treats inside the stand.

You can see a menu, a can of Cola, a bucket of popcorn, a candy apple, cotton candy, and a soft pretzel here.

>read menu
$2.00 Cola 
$2.50 Popcorn 
$1.50 Candy Apple 
$1.50 Cotton Candy 
$1.50 Soft Pretzel

>buy cola
You fork over $2.00 for the can of Cola, leaving yourself with $12.00.

>drink cola
You gulp down some Cola.

* * *

>g
You tip the can again only to find it empty.

>buy popcorn
You fork over $2.50 for the bucket of popcorn, leaving yourself with $9.50.

>buy candy apple
You fork over $1.50 for the candy apple, leaving yourself with $8.00.

>buy cotton candy
You fork over $1.50 for cotton candy, leaving yourself with $6.50.

>buy pretzel
You fork over $1.50 for the soft pretzel, leaving yourself with $5.00.

>ne
Ticket Kiosk
The ticket kiosk stands at the carnival entrance, a compact booth painted in bright red and yellow stripes with bold letters above the window reading "Tickets Here!" Twinkling lights outline its edges, blinking rhythmically to draw attention.

A single window serves visitors, where a smiling attendant dispenses colorful tickets from neatly arranged rolls. Beside the tickets, a cash drawer jingles as change is counted, and a digital payment system glows faintly for modern convenience. Too bad you don't have a debit card.

Next to the kiosk, a vibrant signboard lists ticket prices with playful illustrations of rides and treats. Pennant flags flutter from the kiosk's roof, adding to the festive atmosphere, while the smell of popcorn and fried dough wafts from nearby stalls.

The worn ground around the kiosk shows the passage of eager carnival-goers. Families, couples, and friends form a buzzing line, their excitement building as they approach this first step into the magic of the carnival.

The midway continues in all directions from here. There is a cashier here. The prices of ride tickets are on the signboard. The cashier has nothing.

You can see a cashier here.

>s
Head of the Line
You are standing in front of a ticket taker with his hand open waiting for your ticket. The entrance to the ride is south of here. The ride attendant tells you that you're lucky you showed up when you did because this will be the last trip through Hell Ride. You notice that all the other cars are empty. The Ticket Kiosk is back the way you came.

You can see a Hell Ride Attendant here.

>give hell ride ticket to hell ride attendant
You give the Hell Ride ticket to the Hell Ride Attendant.

>s
Ride Entrance
The cars that will take you into the fearsome Hell Ride stop here for you to board.  To the south is the track that will take you into the ride. The safety bar is raised allowing you to enter the car. To one side the darkness looks just a little bit darker.

You can see a Hell Ride car (empty) here.

* * *

>get flashlight
Taken.

>s
Maintenance Office
The maintenance office, hidden behind the carnival's bright facade, is a dim and cluttered space reeking of grease, sweat, and faint traces of popcorn from the midway. The air hangs heavy with oil and stirred-up dust.

The walls are lined with shelves holding tools and parts in disarray-rusty wrenches, screws, and mismatched containers with faded labels. Paint cans and grease jars clutter the workbenches, many left half-open. In the center, a battered desk is strewn with wires, gears, and springs, a bent piece of metal held in a vise. Overhead, a single flickering fluorescent light struggles to illuminate the room.

In one corner, a disassembled ride mechanism lies exposed, chains and pulleys dangling from hooks above, faintly clinking with the vibrations of the rides. A grease-stained manual and a half-drained mug of coffee sit abandoned on a nearby stool.

The walls display faded safety posters, a corkboard with maintenance schedules and notes, and a worn photo of the carnival in its prime. A clock ticks faintly, its hands out of sync with reality. The floor, gritty with dust and scattered nails, adds to the room's chaotic charm.

Despite the mess, the room buzzes with purpose-a hidden hub where the carnival's magic is sustained through sweat, ingenuity, and the hum of machinery.

>l at desk
It's a desk. There are coffee stains and cigarette burns from years of abuse. The single drawer is shut.

On the desk are a coffee mug and a radio.

>turn on radio
You flip a switch. Through the static, you pick up hear bits of the latest Taylor Swift song.

The radio plays "Stairway to Heaven" by Led Zeppelin.

>l at mug
Who knows how long this has been sitting here. I wouldn't drink it if I were you.

The DJ just cued up Pink Floyd's "Comfortably Numb".

>drink coffee
That looks nasty. You decide against drinking the coffee.

Pharell's "Happy" is playing now.

>s
Crawl Space
The crawl space beneath the carnival ride is a tight, claustrophobic tunnel shrouded in darkness and filled with the hum of machinery above. The air is stale and heavy, carrying the sharp metallic scent of oil and the faint tang of rust. Every sound is amplified in the confined space-the groaning of steel beams, the clanking of chains, and the rhythmic thrum of motors driving the ride above.

The ground is uneven, a mix of packed dirt and loose gravel scattered with forgotten tools, scraps of metal, and tangled wires. Overhead, a network of pipes and cables crisscross the space, some wrapped in fraying insulation that crackles faintly as you crawl past. Small puddles of murky water collect in dips on the floor, their surfaces rippling with vibrations from the ride's movement.

You can see crimson colored door here.

"Folsom Prison Blues" by Johnny Cash is on the air.

>s
Mechanical Room North
The north mechanical room is compact and specialized, housing auxiliary systems that keep the ride running smoothly. A subdued hum of capacitors and relays fills the space, its quiet rhythm broken only by the occasional hiss of hydraulic fluid.

Electrical panels line the walls, labeled for functions like "Lighting Controls," "Brake Systems," and "Emergency Shutdown." Smaller cables and conduits snake along the walls, linking these systems to the main hub. In one corner, a hydraulic pump and reservoir manage lifting arms and rotating platforms, their gauges flickering as they work.

A small workbench against the eastern wall is cluttered with tools and coiled wires, while shelves above hold neatly labeled spare parts-fuses, cables, and hydraulic tubing. A faded ride diagram pinned nearby is marked with red annotations from past repairs.

Dimly lit by a single hanging bulb, the room feels cooler and slightly damp, the metallic tang of machinery mixing with a hint of mildew. Though quieter and less prominent than the south mechanical room, this space plays a vital role in supporting the ride's operation and ensuring its emergency systems are always prepared.

You can see emerald colored door and a toolbox (closed) here.

* * *

>s
Electrical Room
The electrical room is a small but essential space hidden behind the carnival's bright attractions. The air vibrates with electric energy, carrying the acrid scent of overheated wires and metal. Metal panels line the walls, some polished, others worn and streaked with grease.

A central breaker panel, labeled with destinations like "Ferris Wheel Lights" and "Carousel Motors," dominates one wall. Colored indicator lights blink intermittently, reflecting off steel surfaces. Overhead, thick cable bundles snake across the ceiling, connecting to the carnival's power network.

In a corner, an open junction box spills wires onto the wall, while a workbench holds scattered tools and a smudged wiring diagram pinned above. The dirt floor bears scratches, oil stains, and wire clippings. A faint vibration, carried from the generator or nearby rides, pulses through the room.

An emergency shutdown panel painted bright red stands near a fire extinguisher and a faded safety poster. A small fan on the workbench oscillates weakly, barely cooling the room's warmth. Flickering fluorescent tubes overhead cast harsh, shifting shadows.

The electrical room is raw and utilitarian, revealing the fragile systems behind the carnival's magic-a humbling reminder of the power sustaining the midway's enchantment. This room is oozing with electromagnetic energy. You can feel your hair stand on end and all your nerves twitching. This feels dangerous! There are exits in all directions.

>ne
Electrical Closet One
This is Electrical Closet One. There's an electrical panel here and an exit to the south west.

You can see a silver key here.

* * *

>get key
(the silver key)
Taken.

>sw
Electrical Room
The electrical room is a small but essential space hidden behind the carnival's bright attractions. The air vibrates with electric energy, carrying the acrid scent of overheated wires and metal. Metal panels line the walls, some polished, others worn and streaked with grease.

A central breaker panel, labeled with destinations like "Ferris Wheel Lights" and "Carousel Motors," dominates one wall. Colored indicator lights blink intermittently, reflecting off steel surfaces. Overhead, thick cable bundles snake across the ceiling, connecting to the carnival's power network.

In a corner, an open junction box spills wires onto the wall, while a workbench holds scattered tools and a smudged wiring diagram pinned above. The dirt floor bears scratches, oil stains, and wire clippings. A faint vibration, carried from the generator or nearby rides, pulses through the room.

An emergency shutdown panel painted bright red stands near a fire extinguisher and a faded safety poster. A small fan on the workbench oscillates weakly, barely cooling the room's warmth. Flickering fluorescent tubes overhead cast harsh, shifting shadows.

The electrical room is raw and utilitarian, revealing the fragile systems behind the carnival's magic-a humbling reminder of the power sustaining the midway's enchantment. This room is oozing with electromagnetic energy. You can feel your hair stand on end and all your nerves twitching. This feels dangerous! There are exits in all directions.

>n
Generator Room
 The generator room is a compact, utilitarian space where the lifeblood of the carnival's power is produced. Its reinforced concrete walls bear grime, oil streaks, and faint graffiti from past workers. The air carries a mix of diesel, hot metal, ozone, and damp earth, creating a distinctly industrial scent.

At the center, the main generator hums steadily, its scuffed steel casing evidence of years of service. Thick rubberized cables extend from it like veins, connecting to junction boxes and circuit breakers along the walls. A large panel nearby is cluttered with buttons, switches, and gauges, many with faded labels like "Fuel Intake" and "Emergency Shutoff." A flickering display screen shows power levels and load distribution.

The rough concrete floor is uneven, marked by small puddles of spilled fuel or condensation. Shelves along the walls hold spare parts-filters, spark plugs, and wire coils-while tools lie scattered on a workbench beside a grease canister and a worn maintenance manual.

A single industrial bulb in a protective cage casts harsh light, leaving deep shadows across the machinery. In the corner, a vent fan whirs faintly, struggling to cool the warm, vibrating air. A row of diesel canisters gleams beneath a faded safety poster that warns, "Fuel Safely-No Open Flames!"

Though isolated and utilitarian, the generator room is the carnival's heartbeat, powering its lights, rides, and sounds. Its quiet separation from the carnival's chaos serves as a stark reminder of the machinery driving the magic.

You can see indigo colored door here.

* * *

>n
Crawl Space
The crawl space beneath the carnival ride is a tight, claustrophobic tunnel shrouded in darkness and filled with the hum of machinery above. The air is stale and heavy, carrying the sharp metallic scent of oil and the faint tang of rust. Every sound is amplified in the confined space-the groaning of steel beams, the clanking of chains, and the rhythmic thrum of motors driving the ride above.

The ground is uneven, a mix of packed dirt and loose gravel scattered with forgotten tools, scraps of metal, and tangled wires. Overhead, a network of pipes and cables crisscross the space, some wrapped in fraying insulation that crackles faintly as you crawl past. Small puddles of murky water collect in dips on the floor, their surfaces rippling with vibrations from the ride's movement.

You can see crimson colored door here.

"Peace Train" by Cat Stevens can be heard playing on the radio.

>n
Maintenance Office
The maintenance office, hidden behind the carnival's bright facade, is a dim and cluttered space reeking of grease, sweat, and faint traces of popcorn from the midway. The air hangs heavy with oil and stirred-up dust.

The walls are lined with shelves holding tools and parts in disarray-rusty wrenches, screws, and mismatched containers with faded labels. Paint cans and grease jars clutter the workbenches, many left half-open. In the center, a battered desk is strewn with wires, gears, and springs, a bent piece of metal held in a vise. Overhead, a single flickering fluorescent light struggles to illuminate the room.

In one corner, a disassembled ride mechanism lies exposed, chains and pulleys dangling from hooks above, faintly clinking with the vibrations of the rides. A grease-stained manual and a half-drained mug of coffee sit abandoned on a nearby stool.

The walls display faded safety posters, a corkboard with maintenance schedules and notes, and a worn photo of the carnival in its prime. A clock ticks faintly, its hands out of sync with reality. The floor, gritty with dust and scattered nails, adds to the room's chaotic charm.

Despite the mess, the room buzzes with purpose-a hidden hub where the carnival's magic is sustained through sweat, ingenuity, and the hum of machinery.

The radio burbles on.

On the desk is a coffee mug.

You can also see a ladder and aqua colored door here.

You hear Bob Seger singing "Old Time Rock'N'Roll".

>open door
You can't see any such thing.

* * *

>l under stocks
You find aqua colored fuse!
Taken.

[Your score has just gone up by five points.]

>e
Maintenance Office
The maintenance office, hidden behind the carnival's bright facade, is a dim and cluttered space reeking of grease, sweat, and faint traces of popcorn from the midway. The air hangs heavy with oil and stirred-up dust.

The walls are lined with shelves holding tools and parts in disarray-rusty wrenches, screws, and mismatched containers with faded labels. Paint cans and grease jars clutter the workbenches, many left half-open. In the center, a battered desk is strewn with wires, gears, and springs, a bent piece of metal held in a vise. Overhead, a single flickering fluorescent light struggles to illuminate the room.

In one corner, a disassembled ride mechanism lies exposed, chains and pulleys dangling from hooks above, faintly clinking with the vibrations of the rides. A grease-stained manual and a half-drained mug of coffee sit abandoned on a nearby stool.

The walls display faded safety posters, a corkboard with maintenance schedules and notes, and a worn photo of the carnival in its prime. A clock ticks faintly, its hands out of sync with reality. The floor, gritty with dust and scattered nails, adds to the room's chaotic charm.

Despite the mess, the room buzzes with purpose-a hidden hub where the carnival's magic is sustained through sweat, ingenuity, and the hum of machinery.

The radio burbles on.

On the desk is a coffee mug.

You can also see aqua colored door and a ladder here.

The Eagles' "Hotel California" is now playing.

>s
Crawl Space
The crawl space beneath the carnival ride is a tight, claustrophobic tunnel shrouded in darkness and filled with the hum of machinery above. The air is stale and heavy, carrying the sharp metallic scent of oil and the faint tang of rust. Every sound is amplified in the confined space-the groaning of steel beams, the clanking of chains, and the rhythmic thrum of motors driving the ride above.

The ground is uneven, a mix of packed dirt and loose gravel scattered with forgotten tools, scraps of metal, and tangled wires. Overhead, a network of pipes and cables crisscross the space, some wrapped in fraying insulation that crackles faintly as you crawl past. Small puddles of murky water collect in dips on the floor, their surfaces rippling with vibrations from the ride's movement.

You can see crimson colored door here.

The radio plays "Stairway to Heaven" by Led Zeppelin.

>w
(first opening crimson colored door)
(first unlocking crimson colored door)
(with the silver key)

Gallows Room
The public square, slick with morning drizzle, lies under a brooding, overcast sky. At its center looms the gallows, a weathered wooden platform with thick ropes swaying ominously. The crowd stands in somber silence, broken by the shuffle of feet or faint murmurs, their eyes fixed on the grim scene.

A hooded executioner, cloaked in black, adjusts the frayed noose with practiced precision, his cold presence exuding purpose. Beside him stands the condemned man, pale and trembling, his bound hands behind him. Beads of sweat mix with rain on his haunted face as his darting eyes search the indifferent crowd. Each shallow breath forms a fleeting cloud in the chilly air-a fragile reminder of his fleeting life.

Vendors hawk bread and cider, while children strain for a better view. An old man clutches a rosary, whispering prayers, as others smirk and place bets. Above, the bell tower tolls, its mournful chime marking the passage of the man's final moments. A raven perches on the gallows" beam, its unblinking gaze fixed on the scene below.

As the executioner adjusts the noose around the man's neck, the crowd falls silent, the air thick with dread. Distant thunder rumbles faintly, as if the heavens themselves await the inevitable.

You can see crimson colored door and a gallows platform here.

>l under platform
You find crimson colored fuse!
Taken.

[Your score has just gone up by five points.]

>e
Crawl Space
The crawl space beneath the carnival ride is a tight, claustrophobic tunnel shrouded in darkness and filled with the hum of machinery above. The air is stale and heavy, carrying the sharp metallic scent of oil and the faint tang of rust. Every sound is amplified in the confined space-the groaning of steel beams, the clanking of chains, and the rhythmic thrum of motors driving the ride above.

The ground is uneven, a mix of packed dirt and loose gravel scattered with forgotten tools, scraps of metal, and tangled wires. Overhead, a network of pipes and cables crisscross the space, some wrapped in fraying insulation that crackles faintly as you crawl past. Small puddles of murky water collect in dips on the floor, their surfaces rippling with vibrations from the ride's movement.

You can see crimson colored door here.

The DJ just cued up Pink Floyd's "Comfortably Numb".

>s
Mechanical Room North
The north mechanical room is compact and specialized, housing auxiliary systems that keep the ride running smoothly. A subdued hum of capacitors and relays fills the space, its quiet rhythm broken only by the occasional hiss of hydraulic fluid.

Electrical panels line the walls, labeled for functions like "Lighting Controls," "Brake Systems," and "Emergency Shutdown." Smaller cables and conduits snake along the walls, linking these systems to the main hub. In one corner, a hydraulic pump and reservoir manage lifting arms and rotating platforms, their gauges flickering as they work.

A small workbench against the eastern wall is cluttered with tools and coiled wires, while shelves above hold neatly labeled spare parts-fuses, cables, and hydraulic tubing. A faded ride diagram pinned nearby is marked with red annotations from past repairs.

Dimly lit by a single hanging bulb, the room feels cooler and slightly damp, the metallic tang of machinery mixing with a hint of mildew. Though quieter and less prominent than the south mechanical room, this space plays a vital role in supporting the ride's operation and ensuring its emergency systems are always prepared.

You can see emerald colored door and a toolbox (closed) here.

* * *

>l under stakes
You find nothing of interest.

Over the loud speaker, an announcment blares: Attention please. There is a vehicle being towed from the parking lot for parking illegally. The license plate of the car is "862901". You breathe a sigh of relief as you realize that's not your license plate. I guess it's a good thing you remembered to place the parking stub on the dashboard.

>l in pyre
In the pyre is emerald colored fuse.

>get emerald
You find the pyre!
Taken.

[Your score has just gone up by five points.]

>e
Mechanical Room North
The north mechanical room is compact and specialized, housing auxiliary systems that keep the ride running smoothly. A subdued hum of capacitors and relays fills the space, its quiet rhythm broken only by the occasional hiss of hydraulic fluid.

Electrical panels line the walls, labeled for functions like "Lighting Controls," "Brake Systems," and "Emergency Shutdown." Smaller cables and conduits snake along the walls, linking these systems to the main hub. In one corner, a hydraulic pump and reservoir manage lifting arms and rotating platforms, their gauges flickering as they work.

A small workbench against the eastern wall is cluttered with tools and coiled wires, while shelves above hold neatly labeled spare parts-fuses, cables, and hydraulic tubing. A faded ride diagram pinned nearby is marked with red annotations from past repairs.

Dimly lit by a single hanging bulb, the room feels cooler and slightly damp, the metallic tang of machinery mixing with a hint of mildew. Though quieter and less prominent than the south mechanical room, this space plays a vital role in supporting the ride's operation and ensuring its emergency systems are always prepared.

You can see emerald colored door and a toolbox (closed) here.

* * *

>l under chair
You find gray colored fuse!
Taken.

[Your score has just gone up by five points.]

>e
Mechanical Room South
The south mechanical room is the operational core of the carnival ride, a bustling, noisy space dominated by a massive motor. Its steady hum drives the thick belts, pulleys, and gears that work in perfect unison to power the ride.

Heavy-duty electrical panels line the walls, adorned with warning labels like "High Voltage" and blinking indicator lights in an array of colors. Overhead, labeled conduits and wires snake across the ceiling, connecting systems with meticulous precision.

A cluttered workbench holds tools and spare parts-wrenches, bolts, and lubricants-alongside open maintenance logs marked with greasy fingerprints. The air is thick with the smell of oil, metal, and a faint trace of ozone from the electrics.

A cooling fan spins in the corner, barely cutting through the room's warmth. The hum of machinery is occasionally punctuated by clinking chains and the sharp hiss of hydraulic fluid. The floor, a mix of metal grates and worn concrete, reflects years of use and maintenance.

Bright fluorescent lights in wire cages illuminate the space, highlighting the intricate systems at work. The south mechanical room is the ride's powerhouse, where every movement is controlled with precision to deliver its thrilling experience.

You can see gray colored door here.

* * *

>l under platform
You find indigo colored fuse!
Taken.

[Your score has just gone up by five points.]

>e
Generator Room
 The generator room is a compact, utilitarian space where the lifeblood of the carnival's power is produced. Its reinforced concrete walls bear grime, oil streaks, and faint graffiti from past workers. The air carries a mix of diesel, hot metal, ozone, and damp earth, creating a distinctly industrial scent.

At the center, the main generator hums steadily, its scuffed steel casing evidence of years of service. Thick rubberized cables extend from it like veins, connecting to junction boxes and circuit breakers along the walls. A large panel nearby is cluttered with buttons, switches, and gauges, many with faded labels like "Fuel Intake" and "Emergency Shutoff." A flickering display screen shows power levels and load distribution.

The rough concrete floor is uneven, marked by small puddles of spilled fuel or condensation. Shelves along the walls hold spare parts-filters, spark plugs, and wire coils-while tools lie scattered on a workbench beside a grease canister and a worn maintenance manual.

A single industrial bulb in a protective cage casts harsh light, leaving deep shadows across the machinery. In the corner, a vent fan whirs faintly, struggling to cool the warm, vibrating air. A row of diesel canisters gleams beneath a faded safety poster that warns, "Fuel Safely-No Open Flames!"

Though isolated and utilitarian, the generator room is the carnival's heartbeat, powering its lights, rides, and sounds. Its quiet separation from the carnival's chaos serves as a stark reminder of the machinery driving the magic.

You can see indigo colored door here.

>s
Electrical Room
The electrical room is a small but essential space hidden behind the carnival's bright attractions. The air vibrates with electric energy, carrying the acrid scent of overheated wires and metal. Metal panels line the walls, some polished, others worn and streaked with grease.

A central breaker panel, labeled with destinations like "Ferris Wheel Lights" and "Carousel Motors," dominates one wall. Colored indicator lights blink intermittently, reflecting off steel surfaces. Overhead, thick cable bundles snake across the ceiling, connecting to the carnival's power network.

In a corner, an open junction box spills wires onto the wall, while a workbench holds scattered tools and a smudged wiring diagram pinned above. The dirt floor bears scratches, oil stains, and wire clippings. A faint vibration, carried from the generator or nearby rides, pulses through the room.

An emergency shutdown panel painted bright red stands near a fire extinguisher and a faded safety poster. A small fan on the workbench oscillates weakly, barely cooling the room's warmth. Flickering fluorescent tubes overhead cast harsh, shifting shadows.

The electrical room is raw and utilitarian, revealing the fragile systems behind the carnival's magic-a humbling reminder of the power sustaining the midway's enchantment. This room is oozing with electromagnetic energy. You can feel your hair stand on end and all your nerves twitching. This feels dangerous! There are exits in all directions.

>w
Electrical Closet Nine
This is Electrical Closet Nine. There's an electrical panel here and an exit to the east.

* * *

>s
You can't go that way.

>e
Electrical Room
The electrical room is a small but essential space hidden behind the carnival's bright attractions. The air vibrates with electric energy, carrying the acrid scent of overheated wires and metal. Metal panels line the walls, some polished, others worn and streaked with grease.

A central breaker panel, labeled with destinations like "Ferris Wheel Lights" and "Carousel Motors," dominates one wall. Colored indicator lights blink intermittently, reflecting off steel surfaces. Overhead, thick cable bundles snake across the ceiling, connecting to the carnival's power network.

In a corner, an open junction box spills wires onto the wall, while a workbench holds scattered tools and a smudged wiring diagram pinned above. The dirt floor bears scratches, oil stains, and wire clippings. A faint vibration, carried from the generator or nearby rides, pulses through the room.

An emergency shutdown panel painted bright red stands near a fire extinguisher and a faded safety poster. A small fan on the workbench oscillates weakly, barely cooling the room's warmth. Flickering fluorescent tubes overhead cast harsh, shifting shadows.

The electrical room is raw and utilitarian, revealing the fragile systems behind the carnival's magic-a humbling reminder of the power sustaining the midway's enchantment. This room is oozing with electromagnetic energy. You can feel your hair stand on end and all your nerves twitching. This feels dangerous! There are exits in all directions.

>s
Storage Room
The carnival storage room is a cramped yet essential space, tucked away from the bustling grounds. Its rusted metal and peeling wooden walls bear the marks of years of use, while the air hangs heavy with grease, dust, damp canvas, and a faint trace of stale popcorn.

Shelves overflow with supplies-boxes of lightbulbs, spools of wire, and assorted ride parts-piled without order. Tangled flags and strings of lights dangle from hooks, while crates labeled "GAME PRIZES" and "RIDE PARTS" hold items like stuffed animals and plastic toys. Folded tarps and tent poles teeter in one corner.

The room's center is dominated by larger objects: spare ride seats, unassembled booths, and faded attraction pieces like a scratched carousel horse, all hidden beneath protective tarps.

Near the entrance, a battered desk is cluttered with maintenance logs, tools, and empty coffee cups. Above it, a corkboard brims with ride schedules, repair requests, and notes. A flickering fluorescent bulb casts uneven shadows, adding an eerie atmosphere.

The floor, a rough blend of concrete and dirt, is littered with bolts, screws, and wire scraps. In the dim corners, the scuttle of rats and the glint of cobwebs underline the room's gritty nature.

Chaotic yet indispensable, this hidden space powers the carnival's magic, ensuring every ride and booth runs seamlessly.

You can see khaki colored door here.

* * *

>l in stand
In the merchandise stand is khaki colored fuse.

>get fuse
(khaki colored fuse)
You find nothing!
Taken.

[Your score has just gone up by five points.]

>n
Guillotine Room
The public square buzzes with tense anticipation, a crowd gathered under gray skies that cast a somber light on the cobblestones. At the center, a stark wooden platform looms, its purpose grim and unavoidable.

A lone figure stands on the scaffold, bound hands behind their back and head bowed low, avoiding the crowd's gaze. Their tattered clothing, once fine, reflects the fall that led them to this moment.

The crowd encircles the platform, emotions ranging from jeers and curses to silent, grim observation. Children sit on shoulders, their curious eyes unaware of the event's gravity. Near the edge of the platform, the town crier proclaims the crime: "High treason against the crown. Let this be a warning to all who defy the realm!"

The condemned flinches but remains silent as the executioner-a hooded figure in black-stands ready beside the guillotine, its blade gleaming faintly in the dim light. The murmurs of the crowd fall into silence at the executioner's signal, leaving only the rustle of wind and the creak of the scaffold.

As the condemned approaches the guillotine, a crow caws sharply from a nearby rooftop, its cry echoing through the square like an omen. The crowd leans forward, breath held, as justice and mortality converge on the scene.

There is just lone problem: the guillotine is being raised and lowered by some mechanism. It appears that the timing of the guillotine is off and it is being lowered onto the cars instead of between them. If a person were to be in a car as it passed under the guillotine, they would be decapitated.

You can see indigo colored door and a guillotine platform here.

* * *

>ne
Electrical Closet One
This is Electrical Closet One. There's an electrical panel here and an exit to the south west.

>open panel
(first unlocking Electrical Panel 1)
(with the Swiss Army knife)
Using the screwdriver on the Swiss Army knife, you remove the cover to the electrical panel.

You open Electrical Panel 1.

>put aqua in socket
You hear a satisfying snick as the aqua fuse slides into place.

>push switch
The indicator light goes on.

[Your score has just gone up by five points.]

>sw
Electrical Room
The electrical room is a small but essential space hidden behind the carnival's bright attractions. The air vibrates with electric energy, carrying the acrid scent of overheated wires and metal. Metal panels line the walls, some polished, others worn and streaked with grease.

A central breaker panel, labeled with destinations like "Ferris Wheel Lights" and "Carousel Motors," dominates one wall. Colored indicator lights blink intermittently, reflecting off steel surfaces. Overhead, thick cable bundles snake across the ceiling, connecting to the carnival's power network.

In a corner, an open junction box spills wires onto the wall, while a workbench holds scattered tools and a smudged wiring diagram pinned above. The dirt floor bears scratches, oil stains, and wire clippings. A faint vibration, carried from the generator or nearby rides, pulses through the room.

An emergency shutdown panel painted bright red stands near a fire extinguisher and a faded safety poster. A small fan on the workbench oscillates weakly, barely cooling the room's warmth. Flickering fluorescent tubes overhead cast harsh, shifting shadows.

The electrical room is raw and utilitarian, revealing the fragile systems behind the carnival's magic-a humbling reminder of the power sustaining the midway's enchantment. This room is oozing with electromagnetic energy. You can feel your hair stand on end and all your nerves twitching. This feels dangerous! There are exits in all directions.

>e
Electrical Closet Three
This is Electrical Closet Three. There's an electrical panel here and an exit to the west.

>open panel
(first unlocking Electrical Panel 3)
(with the Swiss Army knife)
Using the screwdriver on the Swiss Army knife, you remove the cover to the electrical panel.

You open Electrical Panel 3.

>put crimson in socket
You hear a satisfying snick as the crimson fuse slides into place.

>push switch
The indicator light goes on.

[Your score has just gone up by five points.]

>w
Electrical Room
The electrical room is a small but essential space hidden behind the carnival's bright attractions. The air vibrates with electric energy, carrying the acrid scent of overheated wires and metal. Metal panels line the walls, some polished, others worn and streaked with grease.

A central breaker panel, labeled with destinations like "Ferris Wheel Lights" and "Carousel Motors," dominates one wall. Colored indicator lights blink intermittently, reflecting off steel surfaces. Overhead, thick cable bundles snake across the ceiling, connecting to the carnival's power network.

In a corner, an open junction box spills wires onto the wall, while a workbench holds scattered tools and a smudged wiring diagram pinned above. The dirt floor bears scratches, oil stains, and wire clippings. A faint vibration, carried from the generator or nearby rides, pulses through the room.

An emergency shutdown panel painted bright red stands near a fire extinguisher and a faded safety poster. A small fan on the workbench oscillates weakly, barely cooling the room's warmth. Flickering fluorescent tubes overhead cast harsh, shifting shadows.

The electrical room is raw and utilitarian, revealing the fragile systems behind the carnival's magic-a humbling reminder of the power sustaining the midway's enchantment. This room is oozing with electromagnetic energy. You can feel your hair stand on end and all your nerves twitching. This feels dangerous! There are exits in all directions.

>se
Electrical Closet Five
This is Electrical Closet Five. There's an electrical panel here and an exit to the north west.

>open panel
(first unlocking Electrical Panel 5)
(with the Swiss Army knife)
Using the screwdriver on the Swiss Army knife, you remove the cover to the electrical panel.

You open Electrical Panel 5.

>put emerald in socket
You hear a satisfying snick as the emerald fuse slides into place.

>push switch
The indicator light goes on.

[Your score has just gone up by five points.]

>nw
Electrical Room
The electrical room is a small but essential space hidden behind the carnival's bright attractions. The air vibrates with electric energy, carrying the acrid scent of overheated wires and metal. Metal panels line the walls, some polished, others worn and streaked with grease.

A central breaker panel, labeled with destinations like "Ferris Wheel Lights" and "Carousel Motors," dominates one wall. Colored indicator lights blink intermittently, reflecting off steel surfaces. Overhead, thick cable bundles snake across the ceiling, connecting to the carnival's power network.

In a corner, an open junction box spills wires onto the wall, while a workbench holds scattered tools and a smudged wiring diagram pinned above. The dirt floor bears scratches, oil stains, and wire clippings. A faint vibration, carried from the generator or nearby rides, pulses through the room.

An emergency shutdown panel painted bright red stands near a fire extinguisher and a faded safety poster. A small fan on the workbench oscillates weakly, barely cooling the room's warmth. Flickering fluorescent tubes overhead cast harsh, shifting shadows.

The electrical room is raw and utilitarian, revealing the fragile systems behind the carnival's magic-a humbling reminder of the power sustaining the midway's enchantment. This room is oozing with electromagnetic energy. You can feel your hair stand on end and all your nerves twitching. This feels dangerous! There are exits in all directions.

>sw
Electrical Closet Seven
This is Electrical Closet Seven. There's an electrical panel here and an exit to the north east.

>open panel
(first unlocking Electrical Panel 7)
(with the Swiss Army knife)
Using the screwdriver on the Swiss Army knife, you remove the cover to the electrical panel.

You open Electrical Panel 7.

>put gray in socket
You hear a satisfying snick as the gray fuse slides into place.

>push switch
The indicator light goes on.

[Your score has just gone up by five points.]

>ne
Electrical Room
The electrical room is a small but essential space hidden behind the carnival's bright attractions. The air vibrates with electric energy, carrying the acrid scent of overheated wires and metal. Metal panels line the walls, some polished, others worn and streaked with grease.

A central breaker panel, labeled with destinations like "Ferris Wheel Lights" and "Carousel Motors," dominates one wall. Colored indicator lights blink intermittently, reflecting off steel surfaces. Overhead, thick cable bundles snake across the ceiling, connecting to the carnival's power network.

In a corner, an open junction box spills wires onto the wall, while a workbench holds scattered tools and a smudged wiring diagram pinned above. The dirt floor bears scratches, oil stains, and wire clippings. A faint vibration, carried from the generator or nearby rides, pulses through the room.

An emergency shutdown panel painted bright red stands near a fire extinguisher and a faded safety poster. A small fan on the workbench oscillates weakly, barely cooling the room's warmth. Flickering fluorescent tubes overhead cast harsh, shifting shadows.

The electrical room is raw and utilitarian, revealing the fragile systems behind the carnival's magic-a humbling reminder of the power sustaining the midway's enchantment. This room is oozing with electromagnetic energy. You can feel your hair stand on end and all your nerves twitching. This feels dangerous! There are exits in all directions.

>w
Electrical Closet Nine
This is Electrical Closet Nine. There's an electrical panel here and an exit to the east.

>open panel
(first unlocking Electrical Panel 9)
(with the Swiss Army knife)
Using the screwdriver on the Swiss Army knife, you remove the cover to the electrical panel.

You open Electrical Panel 9.

>put indigo in socket
You hear a satisfying snick as the indigo fuse slides into place.

>push switch
The indicator light goes on.

[Your score has just gone up by five points.]

>e
Electrical Room
The electrical room is a small but essential space hidden behind the carnival's bright attractions. The air vibrates with electric energy, carrying the acrid scent of overheated wires and metal. Metal panels line the walls, some polished, others worn and streaked with grease.

A central breaker panel, labeled with destinations like "Ferris Wheel Lights" and "Carousel Motors," dominates one wall. Colored indicator lights blink intermittently, reflecting off steel surfaces. Overhead, thick cable bundles snake across the ceiling, connecting to the carnival's power network.

In a corner, an open junction box spills wires onto the wall, while a workbench holds scattered tools and a smudged wiring diagram pinned above. The dirt floor bears scratches, oil stains, and wire clippings. A faint vibration, carried from the generator or nearby rides, pulses through the room.

An emergency shutdown panel painted bright red stands near a fire extinguisher and a faded safety poster. A small fan on the workbench oscillates weakly, barely cooling the room's warmth. Flickering fluorescent tubes overhead cast harsh, shifting shadows.

The electrical room is raw and utilitarian, revealing the fragile systems behind the carnival's magic-a humbling reminder of the power sustaining the midway's enchantment. This room is oozing with electromagnetic energy. You can feel your hair stand on end and all your nerves twitching. This feels dangerous! There are exits in all directions.

>nw
Electrical Closet Eleven
This is Electrical Closet Eleven. There's an electrical panel here and an exit to the south east.

>open panel
(first unlocking Electrical Panel 11)
(with the Swiss Army knife)
Using the screwdriver on the Swiss Army knife, you remove the cover to the electrical panel.

You open Electrical Panel 11.

>put khaki in socket
You hear a satisfying snick as the khaki fuse slides into place.

>push switch
The indicator light goes on.

[Your score has just gone up by five points.]

>se
Electrical Room
The electrical room is a small but essential space hidden behind the carnival's bright attractions. The air vibrates with electric energy, carrying the acrid scent of overheated wires and metal. Metal panels line the walls, some polished, others worn and streaked with grease.

A central breaker panel, labeled with destinations like "Ferris Wheel Lights" and "Carousel Motors," dominates one wall. Colored indicator lights blink intermittently, reflecting off steel surfaces. Overhead, thick cable bundles snake across the ceiling, connecting to the carnival's power network.

In a corner, an open junction box spills wires onto the wall, while a workbench holds scattered tools and a smudged wiring diagram pinned above. The dirt floor bears scratches, oil stains, and wire clippings. A faint vibration, carried from the generator or nearby rides, pulses through the room.

An emergency shutdown panel painted bright red stands near a fire extinguisher and a faded safety poster. A small fan on the workbench oscillates weakly, barely cooling the room's warmth. Flickering fluorescent tubes overhead cast harsh, shifting shadows.

The electrical room is raw and utilitarian, revealing the fragile systems behind the carnival's magic-a humbling reminder of the power sustaining the midway's enchantment. This room is oozing with electromagnetic energy. You can feel your hair stand on end and all your nerves twitching. This feels dangerous! There are exits in all directions.

>n
Generator Room
 The generator room is a compact, utilitarian space where the lifeblood of the carnival's power is produced. Its reinforced concrete walls bear grime, oil streaks, and faint graffiti from past workers. The air carries a mix of diesel, hot metal, ozone, and damp earth, creating a distinctly industrial scent.

At the center, the main generator hums steadily, its scuffed steel casing evidence of years of service. Thick rubberized cables extend from it like veins, connecting to junction boxes and circuit breakers along the walls. A large panel nearby is cluttered with buttons, switches, and gauges, many with faded labels like "Fuel Intake" and "Emergency Shutoff." A flickering display screen shows power levels and load distribution.

The rough concrete floor is uneven, marked by small puddles of spilled fuel or condensation. Shelves along the walls hold spare parts-filters, spark plugs, and wire coils-while tools lie scattered on a workbench beside a grease canister and a worn maintenance manual.

A single industrial bulb in a protective cage casts harsh light, leaving deep shadows across the machinery. In the corner, a vent fan whirs faintly, struggling to cool the warm, vibrating air. A row of diesel canisters gleams beneath a faded safety poster that warns, "Fuel Safely-No Open Flames!"

Though isolated and utilitarian, the generator room is the carnival's heartbeat, powering its lights, rides, and sounds. Its quiet separation from the carnival's chaos serves as a stark reminder of the machinery driving the magic.

You can see indigo colored door here.

* * *

>n
Crawl Space
The crawl space beneath the carnival ride is a tight, claustrophobic tunnel shrouded in darkness and filled with the hum of machinery above. The air is stale and heavy, carrying the sharp metallic scent of oil and the faint tang of rust. Every sound is amplified in the confined space-the groaning of steel beams, the clanking of chains, and the rhythmic thrum of motors driving the ride above.

The ground is uneven, a mix of packed dirt and loose gravel scattered with forgotten tools, scraps of metal, and tangled wires. Overhead, a network of pipes and cables crisscross the space, some wrapped in fraying insulation that crackles faintly as you crawl past. Small puddles of murky water collect in dips on the floor, their surfaces rippling with vibrations from the ride's movement.

You can see crimson colored door here.

Pharell's "Happy" is playing now.

>n
Maintenance Office
The maintenance office, hidden behind the carnival's bright facade, is a dim and cluttered space reeking of grease, sweat, and faint traces of popcorn from the midway. The air hangs heavy with oil and stirred-up dust.

The walls are lined with shelves holding tools and parts in disarray-rusty wrenches, screws, and mismatched containers with faded labels. Paint cans and grease jars clutter the workbenches, many left half-open. In the center, a battered desk is strewn with wires, gears, and springs, a bent piece of metal held in a vise. Overhead, a single flickering fluorescent light struggles to illuminate the room.

In one corner, a disassembled ride mechanism lies exposed, chains and pulleys dangling from hooks above, faintly clinking with the vibrations of the rides. A grease-stained manual and a half-drained mug of coffee sit abandoned on a nearby stool.

The walls display faded safety posters, a corkboard with maintenance schedules and notes, and a worn photo of the carnival in its prime. A clock ticks faintly, its hands out of sync with reality. The floor, gritty with dust and scattered nails, adds to the room's chaotic charm.

Despite the mess, the room buzzes with purpose-a hidden hub where the carnival's magic is sustained through sweat, ingenuity, and the hum of machinery.

The radio burbles on.

On the desk is a coffee mug.

You can also see aqua colored door and a ladder here.

"Folsom Prison Blues" by Johnny Cash is on the air.

>u
Dark Hallway
This is a poorly lit hallway. Ahead you can see the glow of an open door.

You can see a ladder here.

"Peace Train" by Cat Stevens can be heard playing on the radio.

>w
Control Room
The backstage control room is a plain, functional hub where the carnival's rides, lights, and attractions are managed. Gray industrial walls, scuffed and greasy, surround rows of monitors streaming live carnival feeds-the Ferris Wheel, Carousel, and Hell Ride. Beneath them, a control panel with labeled dials, colored buttons, and lights oversees the systems.

The hum of electronics fills the air, punctuated by the crackle of a radio: "Maintenance to Bumper Cars-wrench needed!" The worn floor is scattered with papers, tools, and coffee cups. A cluttered desk holds logs and schedules, while a corkboard above displays charts and red-marked notes like "Check Zipper circuit breakers."

A flickering light casts cold shadows as the metallic tang of machinery mixes with dampness. Functional yet essential, this hidden space ensures the carnival's magic runs seamlessly.

You can see a cluttered desk and a Control Panel here.

You hear Bob Seger singing "Old Time Rock'N'Roll".

[Your score has just gone up by five points.]

>l at panel
The control panel is populated with a row of colored lights. From left to right, the colors are aqua, crimson, emerald, gray, indigo, and khaki. Below the lights is a row of similarly colored dials and below that is a row of buttons. (The poorly generated AI & human image is meant for comparison purposes only. LOL) The control panel is lit up like a Christmas tree.

The Eagles' "Hotel California" is now playing.

>turn aqua dial to 1
The aqua colored dial is now set to 1.

The radio plays "Stairway to Heaven" by Led Zeppelin.

>turn crimson dial to 3
The crimson colored dial is now set to 3.

The DJ just cued up Pink Floyd's "Comfortably Numb".

>turn emerald dial to 5
The emerald colored dial is now set to 5.

Pharell's "Happy" is playing now.

>turn gray dial to 7
The gray colored dial is now set to 7.

"Folsom Prison Blues" by Johnny Cash is on the air.

>turn indigo dial to 9
The indigo colored dial is now set to 9.

"Peace Train" by Cat Stevens can be heard playing on the radio.

>turn khaki dial to 11
The khaki colored dial is now set to 11.

You hear Bob Seger singing "Old Time Rock'N'Roll".

>push aqua button
The monitor flickers for a second and the scene it displays changes to something different.
The monitor now shows a tableau of poor unfortunate townsfolk locked in stocks.
The aqua light is now on.

The Eagles' "Hotel California" is now playing.

>push crimson button
The monitor flickers for a second and the scene it displays changes to something different.
The monitor now shows a scene of someone waiting to be hanged.
The crimson light is now on.

The radio plays "Stairway to Heaven" by Led Zeppelin.

>push emerald button
The monitor flickers for a second and the scene it displays changes to something different.
The monitor now displays a scene of witches being burned at the stake.
The emerald light is now on.

The DJ just cued up Pink Floyd's "Comfortably Numb".

>push gray button
The monitor flickers for a second and the scene it displays changes to something different.
The monitor now shows the implements of torture in the dungeon.
The gray light is now on.

Pharell's "Happy" is playing now.

>push khaki button
The monitor flickers for a second and the scene it displays changes to something different.
The monitor shows a the gift shop located at the Hell Ride exit.
The khaki light is now on.

"Folsom Prison Blues" by Johnny Cash is on the air.

>push indigo button
The monitor flickers for a second and the scene it displays changes to something different.
The monitor now shows a tableau of a guillotine. It has stopped rising and falling over the ride exit. The ride is safe again!
The indigo light is now on.

    *** You have won! ***

In that game you scored 100 out of a possible 100, in 172 turns.

Would you like to RESTART, RESTORE a saved game, QUIT, or UNDO the last command?

* * *

>help
> Introduction to Hell Ride
   Instructions for Play

* * *

>push indigo button
The monitor flickers for a second and the scene it displays changes to something different.
The monitor now shows a tableau of a guillotine. It has stopped rising and falling over the ride exit. The ride is safe again!
The indigo light is now on.

    *** You have won! ***

In that game you scored 100 out of a possible 100, in 205 turns.

Would you like to RESTART, RESTORE a saved game, QUIT, or UNDO the last command?

* * *

>test misc
(Testing.)

>[1] brief
Hell Ride is now in its "brief" printing mode, which gives long descriptions of places never before visited and short descriptions otherwise.

>[2] xyzzy
A voice nearby says "Plugh".

>[3] hello sailor
Nothing happens here.

>[4] please get the dime
Please do not say "please."

>[5] i
You are carrying:
  a wallet
    $30.00 in cash
    a coupon

>[6] score
You have so far scored 0 out of a possible 100, in 4 turns.

* * *

>test parking
(Testing.)

>[1] brief
Hell Ride is now in its "brief" printing mode, which gives long descriptions of places never before visited and short descriptions otherwise.

>[2] get blueberries
Good Job!

[Your score has just gone up by five points.]

>[3] eat blueberries
The blueberries were delicious. A true taste of summer.

>[4] give coupon to attendant
(first taking the coupon)
Given. The price of a parking ticket is now $3.00.

>[5] buy ticket
The attendant says, "Don't forget to leave the parking stub on your dashboard".

You fork over $3.00 for the parking ticket, leaving yourself with $27.00.

>[6] get in car
You get into the beater car.

In the beater car you can see an air freshener.

>[7] l at car
Car Interior
This is your car. It's a 2002 Honda Civic and it's seen better days.

You're sitting inside your car. Even though it's old, it feels like an old friend. From the faux leather seats to the crack in the windshield. It's familiar and comforting. There's old fast food wrappers on the floor, clothes and text books in the back seat. There is an air freshener hanging from the rear view mirror. You see the dashboard, the seat, and the glove box.

In the beater car is an air freshener.

>[8] l at seat
A faux leather seat that looked great when it was new.

>[9] l under seat
You find your keys and the dime!
Taken.

[Your score has just gone up by five points.]

>[10] open glove box
(first unlocking the glove box)
(with your keys)
You open the glove box, revealing a gloves.

>[11] get gloves
Taken.

>[12] wear gloves
You put on the gloves.

>[13] l at dashboard
It looks like you could set something there.

>[14] set stub on the dashboard
You put the parking stub on the dashboard.

>[15] l at the dashboard
It looks like you could set something there.

On the dashboard is a parking stub.

>[16] exit
You get out of the beater car.

Parking Lot
You can see a Parking Attendant here.

>test grues
(Testing.)

>[1] s

Ticket Kiosk
The ticket kiosk stands at the carnival entrance, a compact booth painted in bright red and yellow stripes with bold letters above the window reading "Tickets Here!" Twinkling lights outline its edges, blinking rhythmically to draw attention.

A single window serves visitors, where a smiling attendant dispenses colorful tickets from neatly arranged rolls. Beside the tickets, a cash drawer jingles as change is counted, and a digital payment system glows faintly for modern convenience. Too bad you don't have a debit card.

Next to the kiosk, a vibrant signboard lists ticket prices with playful illustrations of rides and treats. Pennant flags flutter from the kiosk's roof, adding to the festive atmosphere, while the smell of popcorn and fried dough wafts from nearby stalls.

The worn ground around the kiosk shows the passage of eager carnival-goers. Families, couples, and friends form a buzzing line, their excitement building as they approach this first step into the magic of the carnival.

The midway continues in all directions from here. There is a cashier here. The prices of ride tickets are on the signboard. The cashier has Hell Ride ticket, Fortune Teller ticket, Ferris Wheel ticket, Bumper Cars ticket, and Carousel ticket.

>[2] buy hell ride ticket
You fork over $3.00 for the Hell Ride ticket, leaving yourself with $24.00.

>[3] s

Head of the Line
You are standing in front of a ticket taker with his hand open waiting for your ticket. The entrance to the ride is south of here. The ride attendant tells you that you're lucky you showed up when you did because this will be the last trip through Hell Ride. You notice that all the other cars are empty. The Ticket Kiosk is back the way you came.

You can see a Hell Ride Attendant here.

>[4] give hell ride ticket to ride attendant
You give the Hell Ride ticket to the Hell Ride Attendant.

>[5] s

Ride Entrance
The cars that will take you into the fearsome Hell Ride stop here for you to board.  To the south is the track that will take you into the ride. The safety bar is raised allowing you to enter the car. To one side the darkness looks just a little bit darker.

You can see a Hell Ride car (empty) here.

>[6] e

Dark Passage
This room is backstage at the Hell Ride attraction. The room is littered with bags of trash, piles of junk, and dust bunnies so large they should be paying rent. West is back the way you came from. There an exit to the south.

[Your score has just gone up by five points.]

>[7] s

Darkness
It is pitch black.  You are likely to be eaten by a grue.

>[8] s
Oh no! You walked directly into the slavering fangs of a lurking grue!

    *** You have died! ***

In that game you scored 15 out of a possible 100, in 23 turns.

Would you like to RESTART, RESTORE a saved game, QUIT, or UNDO the last command?